;address;final_balance;n_tx;total_received;total_sent
0;bc1q3huuvtw03pnn6d3ecp6ujfanfugcyr243uxjgf;15158249;114;23518166;8359917
1;3QpNsnamCopc4fTWEE9gWUyNYV7GxiGH8n;323414;5;1533236;1209822
2;bc1qpu3wqxdeaadhmj6lvqm86cfg530hqtqwx08c4n;43652579;131;122392956;78740377
3;bc1qkjag7v0xtu74sp50mz0a0c39wn3g5ncyuezjm6;509441;11;2426925;1917484
4;bc1qgxvt5smy0vfd0kwyvelkdyf5k9cclrm78pzhs3;519998;1;519998;0
5;1J3YLrnVpSmzSJHYhPJAyiDBbFB9LUNztN;425008;13;766450;341442
6;bc1q6m8ch5xwm8x7u6cy0uay00zy3nrt66twhwalac;2991387;6;2991387;0
7;1EMLwt7GgnGcC3XA6sP7qWpEiLXrDchU6u;95298;14;1192840;1097542
8;1FBv6EifiBnqELXW2XLqxGZWAzr3LaJwVd;91692;46;3433026;3341334
9;3CFCW2f1ddUmj8djjvjPXRwptuZ6BWnbGN;7854384;341;197506963;189652579
10;bc1quujyvumskdp5agt6c26c8f02yqwrfa4ctgdkpu;506027;11;3227521;2721494
11;bc1qv8ec8uyz40npq0jlzn62p6v35kw5rdvmkyp8ge;484591;11;3432631;2948040
12;39jkDz99EuTJHQe5r495hPU5sWAsg8zgNk;18478124;832;323228790;304750666
13;bc1qaw2zx3fjxtfph7mdre57353h59x6qldhagcnfd;3129848;10;4706964;1577116
14;1Ezf39r4DEUMPihiwUo8FcBkBnKYwgydpS;70540;19;6122300;6051760
15;3DAcuAS1Z3W1uVpb9WHGVwTyjY2rmbgJ8a;502224;41;5099472;4597248
16;bc1qzn93vvrurfmu0x96gmhsvv5wv6mjmfsdl208zf;101215;26;1402191;1300976
17;bc1qa49pqxq0pqf35cec3tw0lwxrdtsfha0tn568sz;1101572;411;82133730;81032158
18;bc1qqknj45g3mpetgjlca0ppqrhjftlx6flpjmfdhq;13585704;16;13585704;0
19;19W3AqZk1FemmHb94iyhHJYadbb3VR9scx;106665;462;30488137;30381472
20;bc1prefl8fm6wdqqvjpfqdjufmjtjakvq0mlj8lktdx6dctl6ha9n7eqrwnkt7;794163;87;205219331;204425168
21;1PG8b85t6kp6tU7xMkrE4XcZHFdyjuPf3P;763978;4;763978;0
22;bc1q94crz0q4dl4xmnl609ukvq3lrt5kyulepu8vew;1328709;39;23586646;22257937
23;bc1qgdxeurq49e7sh376t78tmh0xkpgtta7nf8er4c;342007;10;2354446;2012439
24;bc1qv9xlrypkfxzx8twxh225esvwu75973grnf5v06;1117585;12;19510378;18392793
25;bc1qjma6xxsdm5pcejmjkp0fr59chcyz2xpv9e22l5;90972;1;90972;0
26;19VspmX3YqMgRLu9U7DpJoq2PPQAu4RU8x;729940;57;65943755;65213815
27;1NAPo9Cu7id52ovb9KbiCui1GXiZUAvGqe;192632;13;76672156;76479524
28;bc1q4cy25rrdusehpjwc644ep94lt5md9a9lxau74e;2291849;21;2986635;694786
29;12jTjXyBJsmhD97CV5WgteshcDuSwhHio9;226819;18;529041;302222
30;1mAHDU6wPaDw8XH6YboeWbisDFCL2BobA;512077;91;295647762;295135685
31;bc1q7l8tr363c0r6m8978rmc32zvuv6u54ytfdcm2v;3956615;13;3956615;0
32;19YzcUfomZKk1FvtBboZ6fpDi1TpiHP9QS;76922;459;22622482;22545560
33;3Ghdt2qPTJiyRwy1UBf9T6Mih9sWRLdvem;637239;42;2565569;1928330
34;bc1qn5l2l073gfz9samkjyhg2kewyzgjyeh647g8xj;612740;5;612740;0
35;3MNBRsKWCzUcFUe7Qp34FMVXqf3jmY3wwa;111558;4;530533;418975
36;bc1q80npz9ndxmclz0kr0m85a5nlm583ldk8lw34h4;657642;19;6979423;6321781
37;bc1qt97xn5qq9rmx8ldluap9vxmv7w8hcm59d8mrtn;3241902;20;12262237;9020335
38;bc1q4t7m5drr64ma3ptux9k37ye93ja76ejgvdm066;514382;10;3501374;2986992
39;bc1qvzclyydkhsnznklj2vntsrtqr33hkyxwwn2pl4;7806316;14;7806316;0
40;1Pxg89uzEDdtDvErZAcKBVYMn3P3NKQ1D5;5159086;27;5159086;0
41;bc1q494r0rcz4zjxn2xlzjg7lf89a7lcahd9062g0s;481659;26;10989535;10507876
42;bc1qklv4t6w7qafeh63llg9xvptalg2dmp6s7f5hn6;47618680;20;47618680;0
43;1KjxmM2hXbL11RZjfYCeAe79WBV5hHvwUY;39618;33;314279;274661
44;bc1qszyar2z6mvkjhnaqty4lpvg0c06nf6zynzuafc;43871363;386;43871363;0
45;bc1qxhfn5gptnqx0p33rxsw62pgfkz5qtul08z974k;8608034;16;8608034;0
46;bc1qz3dg0yjhqs39n3dta869cq3n6q90c6vn32gwdr;28223044;3;28223044;0
47;1BR9UWLdxj4mt5uNed79Uf8AEhV3TMcCnE;398887;1;398887;0
48;bc1qkevdwfkk3muqajt58r05jumaq4wezcr2m6e7he;2049166;4;2049166;0
49;31hEn22qfRov2pf2hvgSiCNWCx5FZZNjpP;1039623;1699;99782896;98743273
50;bc1qya3qwweg6jkjvvd3ukc2ugt7n6p3qet03lctystrme7f5eaa6r0skw6fdk;4470643;104;171646517;167175874
51;1J7Ec4SC7kHEXDD9zswBDUQ7fHc4RwtypA;281463;87;24132050;23850587
52;1LhALw9UPobGzUrBzc2izasARAywHrVAxv;23970889;52;25009506;1038617
53;bc1qpdq700dv535e0538syvz2rrvaugrgzsge2ggje;339037;18;339037;0
54;bc1qzpzqeky6wvgqydqu7w0ctuh0p87hz8et2tpqpu;8400781;8;8400781;0
55;bc1q6h7w4wsel9ae30hxpncualq7a4exn4du22rvgv;19482;1;19482;0
56;1BG7FpmLgjRMKRGnqsFk32ixKaJRKY4brM;128926;205;433098254;432969328
57;1FPq7NJYLqPuuHWr22DzaHCmQpCSF4XT7Z;115600;650;63170101;63054501
58;bc1qjpf9dxz2u45t86ssa6c9kz0886xadfkrg473u0;9824230;10;9824230;0
59;bc1qs6py58n8nwgd03al224uyavh59gd3qva3un550;626228;1;626228;0
60;bc1qeuf2wv4syutsu86272hw7ujan9wwhvdfkk5uvg;27207999;3;27207999;0
61;bc1qs9p7705cpvr8z209rv9dv04mu2357m9yv83max;167231;30;2851899;2684668
62;bc1q7hhk6cvmnmyqy8l0q8d239vrn3ftt30r004lej;89276066;110;89276066;0
63;1G9dwhADdYirGoLq2QZRLqCWxMYB1NFpLA;615453;63;44736041;44120588
64;3JmtEc8ofrw6TWTPiMHEg17S4qgKuBrbKa;1858905;1126;262333282;260474377
65;1CK3GFbHYuqaKPqdb6Qb72dWpsH24viYB6;11037;10;2098175;2087138
66;1NXqXQ1pcciWSG3iki3jNcYbCzgeUbLt6R;98529;17;1024112;925583
67;1HeXKmczG6MdYi6jfs3RYSyBayRBETcFh1;761084464;1;761084464;0
68;1J9uDTdcCJYrwSd6ogzFm6qBWBJ8AowViB;505814;1;505814;0
69;bc1q8at0kqywqftfzerdys4zj6hh0hvpz97a47rmldy3q4pqcn42gr6q8ugx4v;71249555;180;91733693;20484138
70;bc1qpl6v4c9a49qmyrjwwncege44ty2f09lk8wa07m;3148293;51;23388529;20240236
71;3ALekPNCZAcrYrzU1iVtzGNviqvhSDdtBu;208547540;106;208547540;0
72;1NJAcy9iuKQi7YphtoRNfEZttRBzNa6itJ;1893841;5;2511657;617816
73;bc1qx6evppp04vphs0hwecstenzwmxspge6k3cpvl0;608614;1;608614;0
74;3Hj7SyKNpcLBqq92qSzw1dtZWfnaq1pFqK;44585;1;44585;0
75;bc1qpuk45p56awz4crhztdhvag2220krsxwphgar6w;93562;34;2500619;2407057
76;bc1qgyhadszpq0jzgt2let9qavxa0fy5g0wchl6l33;237259281;1;237259281;0
77;3JSTiWkECVmXdGDc5WTWFTBBJy8LEMpQFn;510021;91;11015239;10505218
78;bc1pw6s5jqt4m5s8t0wg86xtfphmu624lcfjnarm6398ne8txv27qw3q59ajne;312574;2;312574;0
79;bc1qrj4jdur5nl9h2m0ctdcer7euacgm6cn6t5uj8z;75417429;527;1487137038;1411719609
80;bc1pjz78l6ngkwv7xpe7t3rkkgjd54nmchd3cyvexn0trnu0djcx6y6snza2se;28573;19;467025;438452
81;bc1qldd05telralwe4wvdk9u4wrveu72969tnmll96;1410478;26;2236855;826377
82;bc1phhvqk9mra3kvzfx90ryu60uny8m9rpsn2y3mjg0zqckw57cznumsjmx9fr;1092;1;1092;0
83;bc1qhkpcrrk586zayvcvxvv33aylesxhddqw670648f9cs3ywl24zdrspjx3v6;632579;16;632579;0
84;3JtGe3NBqtRDRoTFKBd3oC6pULxwBf9kMg;367771;1224;983818048;983450277
85;3HiHTRU2WbHUQJtc96gasGUfxVQTwesPJi;46956785;37;46956785;0
86;1Put7N6nWFuMhb4nYKqCn84GKdb1BDDGwS;199089;179;24177758;23978669
87;bc1qusc3682rgcqa9y9uu569q3hrj70dyp5smymnk3;380118;95;16127160;15747042
88;3Bxk7VqHYt1KdBdv2bgR2jnSCzdWNLixBT;1068677;101;48529003;47460326
89;19U7DuyrFBp7aizYnEP1CZ8Ub6MFCyytz5;11037;7;543273;532236
90;bc1q9xm0q7v099758yu9u6qjvl2d78s0t34w92erc3;1077179;6;2478233;1401054
91;bc1qyr0zqqskrvu65qdx3huf782evc5n74t0jrm9jg;658752;5;2005167;1346415
92;bc1q368znnjxn3epp0ue2vglv5hjehm8rx4y8f9q2x;2101677;17;13678708;11577031
93;1JgmkRXwSdBE1JbTinz8GUsgcjoWFE8Bzg;101225;37;10941152;10839927
94;16ciLf1Ccw1vXh9gmSrRm6bDjZNbYEAxi6;90628;41;1960277;1869649
95;1QHbVg9FECQXW2zcBPciTWj5TMNEtnPiei;509252;477;138663001;138153749
96;bc1q3xeum83rnrx82rcxdmsdk7ghe5jxrd0alpmjsa;139461495;85;139461495;0
97;15GjLyZARv3hBbt7iF5WX1GT9QwZwJa14r;21766;103;23878455;23856689
98;bc1qtm297ltvqgpnnlt6jd7m8pzjexh2r03960fape;2158805;4;2158805;0
99;bc1q6r4m8rshpqcj9um66heldkqw9uvc6acg7v8mgd;1182614;10;2764548;1581934
100;bc1qh2g42vclpp9e6yy32r8larj9khysdwq4np5mgm;346732;243;22319552;21972820
101;bc1q3my38em3gjkj8y8tetawapt8hezagczcjz6a7l;15525760;11;15525760;0
102;37BkWhwBUnuW5YDVbbJ76bAg89FLQQjyYS;90301;213;12620154;12529853
103;bc1qwc7vlc3aacx0nczmr0h7c8pdalkacxv7z76ywm;434398;70;7284798;6850400
104;bc1qx44uplrp24la0j96tcw43xmg0wtkxkq3jseml2;229760;114;11023095;10793335
105;1JqhBoBfofvxKxLxbSiekZifUfLsP9B1Li;5133967;42;470918307;465784340
106;bc1qwca4pp3zs9zg5dts9whftl3k8tafjhrj5w6a4p;1249354;449;81018951;79769597
107;bc1qamksg2pl20szzzdq2fv3ssvnmqm9zkesk4lt5f;2045079978;1;2045079978;0
108;bc1qkp8l9nk7q6m5mvu05kkax493rqp8kgxe0hngxx;2591293;114;8785242;6193949
109;1JvpSk5bUfPfCmryjoJU3zGUav8pFoJRK;471908;25;3599520;3127612
110;bc1qssqts9vjnvh7h9u0ctwhqag9earzx0eh7a5cet;2062855;3;2062855;0
111;3JNDDEecDHHXvM5tx4kSvjbFjZSXRBfjX3;91732;2035;103278526;103186794
112;19fCv28sS8r9by15Q38AaWVrhvBLp1hgYi;20339;13;2355156;2334817
113;bc1qwn857sskhku63n85kpum35cur2zz67mphsxuv0;5457642;10;5457642;0
114;3GAuthZnMuk7vyBwWkH3RKiaM3P16SQG4G;15104373;128;217054726;201950353
115;1EXVUnsjthbu4uavULrArvYZiShLxwwBQB;674311;554;65637728;64963417
116;17ysDfL4WPiVikr7unxmbL8r4foeE99Nyx;149868;4;658614;508746
117;bc1qxlhgx95jrekc5kkxgup2d892a3d4ey5et7s0xy;12537070;3;12537070;0
118;bc1q80q3979fra40mfghrenp8aljrz7jdsdgmadlv49j65mjnu72v5lsq8rl25;5235374;39;5235374;0
119;bc1q3m382hlvqyg8z5pt0jhmf7036xuyuen5j93v23l37vkpzrydq8eqswyvuv;3191279;70;7348389;4157110
120;37deidMaSRoZHt8omzh4BKZXjUXUr7hqQK;90309;325;20892580;20802271
121;1NRBu87cbHh7f8x8LS2ygGanYervvHqqzH;507272;9;63306813;62799541
122;bc1q03pdu3nhez7e6aarcm4q6szhe64dayne06a0eg;210866;8;210866;0
123;18ryCBeB3YAeYvGHYfXGfskWQfTT9aUX6q;318738;3;686763;368025
124;13TTQvnYuKT3JHMDk4BTWptirsYxtjigFx;6917308;27;9429915;2512607
125;3EgKRs1woTkFJwRfwuj8PEJXdJWEQrgmji;629871;28;127385348;126755477
126;3PGPbVo2SToaDCSKBZmgxTZ2Dyq76HFH8S;224688201;365;4234477491;4009789290
127;1ExF6JzKP7V6UHhZAk96hokuKgda9v7gP7;168553;362;32953698;32785145
128;13wrZZVKrLFFvNxCaPjWnE6nGsU4AE1UDM;26331;1;26331;0
129;bc1qms86mtavk404r6ahhpl5zgc4tfuyjvnfvlsmes;343837;5;686821;342984
130;3CRPrqroXmdR83q4fBJNS1NR7LB9qYcMFW;516461;48;22825289;22308828
131;19CcmFR1ZZeBL5Gc53NVdM1rRS3NdvSEtr;646695;96;18069102;17422407
132;bc1qwaxn5mrx9eq9x0xw43esgp90acng44l4dax6tm;144203;70;10713779;10569576
133;bc1qd86z3d9lzz7mspn3ach0kq249vwvsrpdff40ch;114653983;1880;2599441938;2484787955
134;bc1qhd8nf7a0lz2r8mafnccyqy4qmrhqm78txk0qfc;2726805;83;58648720;55921915
135;12k2Cw8HqrR46pwQ5bMRM1bib1xhTmy2vm;13446;218;23615909;23602463
136;3NiZr7kHEtDxb7NxFga88oWLr8fR3wq2UT;100884919;394;319488259;218603340
137;3KQa2rGh8aL9Vd62bk2tU7MGfiJTo8SB3U;11890760;1352;83056599;71165839
138;35exHeTbDHtq2u7fd5uSbPowXZQMix2BLx;183945;576;38492285;38308340
139;bc1qjzslmnl2wapx5rg82px9cn5zxp9td2lm324p7v;1899557;88;29011591;27112034
140;3MHTjUbmdFVYVAeTzEiVs3NMTR1XPLwuN1;92923;192;15159950;15067027
141;bc1qn3x0vkwre3tkm7s0c7rqvg78ymjfhwgvk6ypf9;50148888;13;208237224;158088336
142;bc1qhlpd40792wlkll8th7jnds5anxxvtypzs3unlz;99266976;21;99266976;0
143;32fXz7MpHcFnYrfgZpe5kc6wwNPiPsiT1C;365566;25;5399044;5033478
144;1MtUVtg5gd9o4u5v5ZEMNRGdkXmTWVJxpG;91978;27;4660945;4568967
145;1K3jqKQ3AMzRm4ZDnM6ts3ogYDgAtbc3As;8753005;86;23954928;15201923
146;bc1q23fufasww50yuay7uz5zssxu4a9uu93tfxn302;4608110;9;4608110;0
147;bc1qk0ye2rqd42rfdkearcyqq8pyfhxlkvzusy8qjl;25396809;26;25396809;0
148;bc1qqzfypuefvzs36uc90g547h893clxjnp477tzs8;90118;11;540479;450361
149;3F98xK2gvVVopz7cG1vTCe5uuabRNfwu9R;10338;15;2130166;2119828
150;1PDf9r32wQg5S6Kggh1VfHjHqLHZyojucF;90630;44;3922271;3831641
151;bc1qe9mzlefjl2erh3emce4cdq27t3ckfgu3ssarhx;748245;2;748245;0
152;bc1qqhzj7kzcaxskv5vxnnftzks4klwlgcxhs55dc9;371302;6;14142625;13771323
153;bc1qhxk7cxk9xpd3xx9gpjz30uaagevfrcata2yzyf;289592;3;289592;0
154;bc1qkxxksx46jpl98pkmvhkpz2kduzj8fdxm5jrkj2;5349896;10;5349896;0
155;bc1q5aer7g0lll0rhx3apkt8p35nuzhgkzc9mptln5;5646583;50;19557025;13910442
156;3ER3vCXubFZFhu8yjrjF1TTQYr69RqZXvM;6644867;33;19772852;13127985
157;bc1qj30egmuvzreewz7z6vx424sa9vm3ljmnrdex6u;756280;1;756280;0
158;1A77fThnoijUgpP2yaE6C1sCq7G59suvs;100204;219;18319216;18219012
159;1Pejcjsh5fzj8B4pj1sCumbf779rnUqPc3;2696830;6;2696830;0
160;bc1q3uwqv35cm7ysruy9r35akredrt0y9v42m6mjhz;4745687;1;4745687;0
161;3AC1AQcN1ydy2Y8ePzBmXXXuJMCbU9tFZk;602319;593;29442359;28840040
162;3J44YZUzeCbew5gTmSMpRdER7vYychMpNv;104006;17;922877;818871
163;bc1qutp337nrh0z256amz7lng2vvnyqlqhhp7nathn;0;38;10795474;10795474
164;184iLVBExH2dvSpisfvStXacU6U96gGZuv;501806;522;49325912;48824106
165;1MCZ4ehQaTTJ6kxxPPsnG7kKfAaq4fKcM2;517345;189;47917727;47400382
166;1Gk6U5VCBqvjXixYRFdG6Z5Wt1RpZZejL7;20968;97;4245433;4224465
167;bc1qjw8f88kqn8e4c5vrvyn07y900xrstcnsemanyg;584223341;1006;904205654;319982313
168;bc1q8m8464eshw2ucdexk0q2nl8f005axqklpj97fd;2851021;81;42538771;39687750
169;bc1qtqzgfeyzfkkfxespl0mjvj458v0trgzgz8fa58;213283;5;213283;0
170;bc1qsag854kfwy56fnf0epxp0lltymtfhhkh4w66c2;810139;254;16919991;16109852
171;bc1qr683qt3az4c7vhxyzlyrdscjsygdt2ggtzwvg9;1035939;2;1035939;0
172;3Mc6SNEzWLjbtjieXCL2tGJsSyrhzvwb5R;1536233;5;43023566;41487333
173;1cWUjK8VVve7W4ovzLJP6KQeGXLf3jNTb;91725;306;36502353;36410628
174;bc1qerylmm7pkw3r5j6fn6x6kdk5kwyzdrkneak3l2;78297194;8;78297194;0
175;bc1qz5sjq0u7t8ajdmt2unvs376rqxfsdf0zaymj6x;507443;12;7995975;7488532
176;3LcUJZ1G7tEbbZSJZ7s59ckV4sqz29ef79;646754;148;12746201;12099447
177;bc1qq2lwmu9k6zecledpmwweyse5cytl28lu6glrfd;1819730;18;1819730;0
178;32PLNbqCs7kQccTWDeYBuyWCuuENHW3Nc1;8145019;98;9132167;987148
179;3HNb8Vp1uoiGoTMJJHStZBazh5kCAnWeXb;3827976;519;132515598;128687622
180;1EwMLjzU6xuccf8VJDLhAxVrK2iWkMKmSE;129207;287;31354784;31225577
181;bc1q0l2xrf5u6tclghnrn74hy8awdr0328muqv4gmy;2090749;22;8870371;6779622
182;1FG3JSChte2nhfBdmowfKaVzfeBvRynXMd;90405;949;50005152;49914747
183;3PMwrXQrc1VdF4yrCtJRmsXkwbrrocXxmz;3306539519;374;38085101683;34778562164
184;1Kn5L62Msw3EH6puj3ietXVVX39Df9gSQJ;7581858;252;22836728;15254870
185;bc1q7td85yevxnvew664z5tsvnhsdhs8xwnjlt78ag;15446467;19;15446467;0
186;bc1q4gj80ke5u0vjs5dqw7ew84q3a4hnj9xsl2epr3;695192;115;22221349;21526157
187;bc1qlk6m9c70tl5eq2fg3plxyhy02gu948vfcledph7sv0fcl4aypx6szat9ta;748515;87;5487685;4739170
188;bc1qprqmjq55fcfem97mt7gpufq5a84un7qdu0aaws;6323320;12;6323320;0
189;bc1q07wquhtthqwemndlcyzws2pjvgtxdhhnlqple7;659438;139;79431254;78771816
190;1ff52RwtxfnQp25zcpgqUj5xUEs4tKUiA;3132310;11;5226266;2093956
191;3NKsgvDMSYhNzzbz75K2wdFrxnxEbufYKg;510088;21;5105596;4595508
192;bc1qs7jnfw5vcqy22pw9s6fjmpz5gl2tt8tfcwkf44;625282;135;92285426;91660144
193;bc1q0le6a8z6fwm4k09kgqzhzmclrrul48xm4x7gvs;5630208;422;189403801;183773593
194;bc1qnuqwjxsvjcgksujjp9jdugrrnuu5u4pysaju6r;91443;192;15391868;15300425
195;1LMxKGSqCKra4P9ze9eunGHGrnaCHfdGTf;388645;6;897236;508591
196;bc1qyxxtg8xj9g5z5k8nehq9eftjl7uvs2phr8ak4l;1267053;52;34498878;33231825
197;bc1q5hryapkuwspsjyurekrul488236yc2uugax045;425191;3;951605;526414
198;3ED2KvGrvWscHhUBqbeNAZwQaSZVZTRau9;388055;349;20494040;20105985
199;1PguaCTFQ8qNz6e6soWDcH9buVYCuufwz6;118476;195;9801921;9683445
200;1HQocwUrqAyoPm7VP65Shg5zGihSCaerLj;152879;78;76684577;76531698
201;1FszF7PxRg1iZhbygCPDXRFBbeYWHi2Zr4;2618793;5;2618793;0
202;bc1q90vlwqpflrlp9gajnlu7aa5905cr9uqha8ryxg;56456648;29;62339796;5883148
203;bc1q0jrdr4vwyc399z7v2vr3pzszuu9kmmq978rq8z;562655;11;562655;0
204;bc1q50r2xggkqe3flgjldlh038w9flwe6xjcscrf9v;119588;12;8904226;8784638
205;bc1qwr6h2y0ktku8kfsm7wu2mx0x8h5d35turl9ktp;0;2;7738479;7738479
206;bc1qdvn7nndgvhmq2dhhytwpw5623wycjk023k2mau;11154056;31;68628655;57474599
207;bc1qpkmeelp6uuemlkf5l6eqx4sswnxa3ceqejd3k9;50547;38;8472675;8422128
208;18AZQXDAubdaGHQrpUFsMZuxkCsCx1zJbs;655864;7;3001506;2345642
209;3CFS6H1S4M6F6jDAx1ir3Pvt2Cc8t3imgQ;19415892;55;19415892;0
210;bc1qj8w4g33x2f2mn9z5wxfy9nf73h8cwwav8ma7uv;799818;5;2589924;1790106
211;3DkBmeN7C28t2Fss8ScNCVn3Y1sMJRNDqC;375527;36;3073481;2697954
212;bc1qykyzyrtduma0ajdal9wur8kr0gpd8em0mkcepk;3079634;15;31891702;28812068
213;bc1qlp2ncdajtlz77havq0efrczc8a9wuqxff488m0;211628;24;7443405;7231777
214;bc1q80gq7v2zeq7ezpgjpzv55s9h4r9jqyc79gjz5s;444576;4;444576;0
215;bc1qr6pauy5hq07dlfcc6rcpr35u8tkl7qrk3j89fj;265002;1;265002;0
216;1CGyDBngVrksfRm4Kp3VKxMoVuA4pi5dLe;471872;702;162692822;162220950
217;3MX7yDhLxyWMfgaGxk4JrMDcwFKP8cMYBv;5065185;559;55353319;50288134
218;15uV84KFFgFPQth3r5mruGft7mnGfQ8wmK;98594;2;98594;0
219;bc1q8fuqmgc2ywu5k4d5v3je5qapy0e0zxzn8hvjffxl8j6f05lph57qd4vyyu;5245553;38;5245553;0
220;36Z4yJxS4yegwqmPeKzib7AARUDSJcf5Mm;192849;32;3162469;2969620
221;3N2QT9WY8nXKfVqKzGZMP7AkWBT7wM8eZM;517597;11;3162486;2644889
222;3GgvXNzs7qj9q3e3ASAG7XBLmodb45G3Vv;335012;9;1027761;692749
223;35mVhF3BYPttnay6UNmbXkYpWDRMS3SxpT;2043005;839;388816582;386773577
224;bc1q0w5e2m4r0lwwh69nhtnszxl0euy7w2eje9edzc;65411;1;65411;0
225;bc1qudnxk0qdhpt5magauf2mk578hfx899h0jz5stq;1052721;9;1052721;0
226;1BDQkJ3v42nVQYLhWirDfJ1hZy5fyWqxjc;32041;2;32041;0
227;bc1qpr7lf27x6mwdl9waedk3uey0e0e90nskuxdava;20755129;32;20755129;0
228;1PXAnwT5Zj2duiFgLcb7VzsKnPupUpMVm4;510024;83;97434856;96924832
229;1BsYx575Dc67y1t1XEpiiHLgj2bE3yFvsZ;305970;53;49274453;48968483
230;bc1qe452cdv4x56tvxyf5dhjvhhf9yx0js5klj7r49;276338;3;276338;0
231;13Z4MbhhVAtoLj47utuxVeUQd3RfmxM4xb;1432422;115;128315790;126883368
232;3KDpn4KgzUDpjDA5LKjM2rd1bpL8r2pgwe;80141110;922;104238862;24097752
233;39Xad3HVZekZcQd8KtEL5HoyNr3b2WbECu;31600594;219;88139585;56538991
234;bc1qdh6zfm9803eq82dmaj2fh75u6yrxkn4v5hc8hf;2560910;5;2560910;0
235;1Qun9R3A2ETZaKvn4sSP5zpWtgCCYbL4M;93459;133;23233327;23139868
236;bc1qdd27r090h78avmvcpda59a929nv4e758f0zsps;39079;1;39079;0
237;bc1qwyt58lfqqwh6vaqsfaflej563lepehnyv3yzdp;35013859;236;35013859;0
238;bc1qwxpdgvcgdnejdz5ht2csxr0f0gd2vg6zy6f759;8583005;41;12824220;4241215
239;321NrQvgBJbKz61eN9XDxM54CkHgGNotXw;469466199;368;469466199;0
240;bc1qcqurn7lxr4tghd5zhn0vz4d075z2qnkawhk8y4;82173952;92;82173952;0
241;1EcRxhKuRottAZdKohoeiHkd2fQJja9tJs;10118;1;10118;0
242;bc1qrr7ggl98tth0caju5xpyj4m2plv0m0k55t7ea9;3355864;46;32116516;28760652
243;17zZmC4i3XuMVxZdGXFkSSwmWvh62AFHDg;17027;11;73731;56704
244;bc1q83dua30vtagzatwpyhd5v4z2m5rujmd4702sln;3798838;143;13698095;9899257
245;bc1ql4lgmwseh2tmnwx8rxac5c2dathfdzap3ejgt2;472698928;1;472698928;0
246;3FY9ZjyFbSQxCMd7KcapSQZCUmQzFJr3b6;2323208;225;38410058;36086850
247;34JfNwXKy9AaqzLUfacaUa1GVsE2SytdKC;501319;16;61541141;61039822
248;1QHCwiUhhDPNMhMfJW6LRSxMd9rcE7Z6jX;653446;67;50702736;50049290
249;bc1pm9ecqqzlrgvz9tcx6c3lww9q66qwy3khakghre8yt58akhwhkxeq3rygsv;0;2;2605410;2605410
250;32vU2jsNnYB2hJmUPWSwj4dzEPVj3Yndqm;7595270;9;22295905;14700635
251;bc1pmnj06mptk9dm5vlmpzdqscsyqedg4ym0pl0uuxdtzx6wqty4uwasuq758q;10000;1;10000;0
252;bc1qus9j3ye8exa3xjdu9xg6s07hnag5qsju9crwaj;586743;223;783885015;783298272
253;bc1pse842w7tagxgst27pxj7zp2cwfzp369gjgwek8dnsnv8h4hqzw0s0rekgu;275238;179;281244;6006
254;bc1p8zq292cesavzl2ma0cvr2vlcgqed8ems93n2yu0phtyjkzas89aq8vt795;0;2;211546;211546
255;bc1pmpt3je7r0w9khh4glltevgr364fywanzz9k23ujamkkue8mhlypqpatxy0;0;20;21039954;21039954
256;bc1pmmula6ytdnsrdxjvah5m9zqgqqx99rax2ye0cqkd4ahw3t0glvas3jtm6d;10000;1;10000;0
257;bc1p0gcx8dh59vu4l502rg5k43hmqpvlx4zusylnq8ncefh8xezjj39svx3khg;16258;1;16258;0
258;bc1p5njxcmysjgpqzkazcktjr75s5h7kguc65jjnhz6hsrz0pq6u7q6qtn2w7p;176232;1;176232;0
259;bc1pvdpwclwrlsu8lcrzsrr8rj8fhnpaytd8tlky7cmmcql5082xvt7srx7hd8;6388698;21;98998353;92609655
260;bc1pxm8xns9d5nnfuw0cewrrcq47j0gt974nmg620jkksqxdn7uvft7qkmqrmq;2306946;752;731086721;728779775
261;bc1pwazu8tx6vkukjhljtdx5apycs36a7x937xu3cmatgnjpjsgk09eqx948au;10000;1;10000;0
262;bc1pufn70hclzm48mwagwqlh0xwax867hzyvelgm0usada9mh58ju0vq6wm79p;10000;1;10000;0
263;bc1pwhlz6gq34f6tfpgcxa2qvsphslzt7rclkzdtzrqfdfphpkyruzqqqw7qza;3199092;1;3199092;0
264;bc1pxuqj2k8uk86h6pw34d2rf6t6vj3m3826yasphe9t0hwfrylmr8fqql8pgw;10000;1;10000;0
265;bc1p6dc5vknfc2k5na7l567804fwn2xtnvzjyzs8ft4ldgdq7e5geu6s5jv9nn;10000;1;10000;0
266;bc1pemwaqp990ynfcl9r8fam6762jtgp5537vaathns8c978avmf3xcqgy5c9a;152454;1;152454;0
267;bc1p5j3y5rn7t6yk9t4h2k7497cz83knsz279xhcv3d4n3eyxc5kuhvqytt58k;0;2;476345;476345
268;bc1plmhw6ep0ndfy9ksp4nd9s3fq2dkfcdx0kskj60v4wjya2mcg0masv2nkcu;10000;1;10000;0
269;bc1pvr6pvhurhsmfakr2r7a0m8lc3krunghe8lq4vumeprkrqmz8dmlsc5zmev;3684;1;3684;0
270;bc1p4vctj8r7560s8wm7l3z2cml79gj40xh6hz0mky3tf6aqj7ws7pvq394qve;0;2;20000;20000
271;bc1qpd98gf0lukcczs7gr5e0u9qdgqjqlmscau0cgr;6736342;7;16291582;9555240
272;bc1pw8nc665kgr0n5wrfcwv3kup4yakxkqrerdvj9r22vnq7en2f4wzqcppw96;826497;1;826497;0
273;bc1p605y7fau9uhq50rstdwucasnahmatrm5jt2h4x06dwngekjr00es6qphwc;1506092;1;1506092;0
274;bc1pcjjgd9hm9lj0599fdehum4le0y2qg4seup5w448yapfunr6qycyqxz25ys;441846;1;441846;0
275;bc1ppqd66q24cznjls8eh5jdpfvrh69yz5e9sawf548hyyp05zrjdqtqmzdlzc;10000;1;10000;0
276;bc1plz34mrpxqmqv05l766ghw6gvd4g2srlz2dm5zlnh889qaqrw676slmh0np;9655661;3;14655661;5000000
277;bc1pwjna8h2epv73aa4atmqfztm9mj25f957vdemprn7ezukygwcrz3sm5xk49;8470744;235;8470744;0
278;bc1pw7gxvnh88uf2e4tpqt4a9sak5x3j83t3lxuyw5nhraa8j625mzeqxnmljj;212860;3;1060060;847200
279;bc1pnktnd636ekrlwrlzn4vjgswzwtxc4mfkn94yu2xnenrqk7754a3qutv3mc;29454;1;29454;0
280;bc1qlzdswzqyhu0zgh3d3k8mtw7cxyzju6nc40t53f;33200;18;33200;0
281;bc1pwq6xjz5qe6sndemy0462j22k6ntu043qkxcwwu47ukvckduxgljqa4r4tv;0;2;20000;20000
282;39sje8sewoLmE2VoR6WuxUi2mu8kJsLSHq;50960017;235;1286607554;1235647537
283;bc1pj0l23hgzeqk0uygrw4k7eql8g9dndqkhlw8cup9psm83aumkmpqsz8jkqc;6182244;1780;923278861;917096617
284;bc1pxkfdpsavr8e4kmh84va7m9z5jqdt3gnlun7k2vgym76yk8wyj30se388q8;663792;1;663792;0
285;bc1ptw56pzdle8f7egdgd3595qeckza5cd4uhdyje38ycp0l6nzvz84ssultud;20000;1;20000;0
286;bc1p7en40zu9hmf9d3luh8evmfyg655pu5k2gtna6j7zr623f9tz7z0stfnwav;73196389;202848;2865737188;2792540799
287;bc1ppll07xfc4dh9xsy90j7nhpv7j3fxghttmahn73exfqt68yq6rffshm4lm8;0;2;20000;20000
288;bc1ptfrwv9wuaudc8g0y69pqg9qna6uahxheydtgs8qvdn9e2chw220sy8ez04;10000;1;10000;0
289;bc1pfhhrgu4xzzqqlhddv34g32uhdas4h8564gmm6xxzru83yepnnuastk2usn;10000;1;10000;0
290;bc1pqj2eheqq4medcymdpglyhwdf06606acjn2arhk6gh0tj57wanvgqwattc6;756285;385;196556668;195800383
291;bc1p24ktxwaf3nju9swk85jkft5rq295g48j3tk87fq2ed4kp27qqt5q3jm8e0;0;2;144545;144545
292;bc1puev662awla0m57gx9640wr5pf52fqdt7498lkvvx5r577kcdanzqs8yf0z;10000;1;10000;0
293;1BurnchainBurnchainBurnchain6cU7ZK;8588685;33;8588685;0
294;bc1quh9jm6p06nqnvgvvv733pl0g0y6ycxl0aas2t4;8597627;7547;695632675;687035048
295;32eFjhJK89JB7VeBgvjbcQG92bYzqkqyGE;31137;2;4733646;4702509
296;bc1pr4d86gflrf5qdy0xuck7r3p5969xjnzjux5qgwydr525uva5dwkqlgcrzl;390521150;7850;1026187925;635666775
297;bc1pf4anywkly5auucaztpmvqnz7fuynyd8laecfd646hny6m09ql45qp9fsvr;90560769;1017;2888632479;2798071710
298;bc1pp3ra4nleneshutjp4crm8h9xs8t9dqhsvszmx6ck24xu6the7j2sf4d7lp;10000;1;10000;0
299;bc1pp38u9rn202afdwfr3900h32fd83qh7lkv4u7hk8xx3ymkyp7e4mqkwawrr;10000;1;10000;0
300;bc1pn7ac4en7usjn2wrq34wjyqqvhkgjez9nseelel43n8n0wgk5umrsvgjvpn;20000;1;20000;0
301;bc1qvs2hts5u0mk06ayecd3m85ps5w5emuxtlxeg9x;46023462;9570;104455810;58432348
302;bc1qufkh3a2a4exf2064ydqz2u6ykxle5c5utk9pka;1127938;1;1127938;0
303;bc1pmajpes9was3zdysxlw7wra3skfesvv24dk996tum0xcnymcymhls5tf499;6006;11;6006;0
304;bc1pw366rl3yshuaeg3yt4dds3fuyuqvwh7ldhzv3gc6wcvlcxh7kftqdk7ex9;0;2;183000;183000
305;bc1pd8ny43w65apmpp2cyznr2k0lh2avx35f3w9gnf73skv9guglpr6qdy0mjg;4473914;57;324197044;319723130
306;bc1p8kjc6qw3ze2nx74pe5cq76zckc6dfve8pxeudd9vgnsfl5qf9tfssyumh0;10000;1;10000;0
307;bc1pa5l2g5755yn6vqaqr84wj4wm494ye0ekjujls9xjk722hswxa9aqr0ctpl;651680;6;2462470;1810790
308;bc1pjh0a53utdh43pcefezf3ghm9msqp0s9purpqs4gexhh3hg72fnqq33hxch;10000;1;10000;0
309;bc1p8puj4543enssrt9jdwaxhnt365zx2fpjmdw3qalgtwp73yzlfrvq9vu0qk;688546;1;688546;0
310;bc1pxeqf5e07de5ys0744wxlmjpr2070vvgdfr69hx5haew7jf346d3qvd049y;546;5;200546;200000
311;bc1pa3zl8xf807m85gluczmshar6fnl7clycyslgjhz9nrjcp6dq2llqw8tmyh;463549;84;9717155;9253606
312;bc1q7jd477wc5s88hsvenr0ddtatsw282hfjzg59wz;8595557;25;104674735;96079178
313;bc1ple3j9dqtamjlgyvamd0eamzghg74tsc4yrlj9vcr30tzkx44pavsapxedh;1373924;596;147555620;146181696
314;bc1p5a2knc02k233e6n747qtwp3d8zt97qad7dz8kde7wk7malmlplcs3lt3h4;10000;1;10000;0
315;bc1pjcrw5x6v4qnkm0a8u6h076rl3z4t6t888eglr7v28304kjwvlvkqf4elgf;583592;1;583592;0
316;bc1phceshhqh25rks2l9tauzhp5hjjrzwadt46q0jhwe3fxujd3dxxxqx0ucun;152454;1;152454;0
317;33L1eTCVKv3VY8WCWA5mWxR5bMGKrsrnbQ;3098356;111;79005742;75907386
318;bc1qkvstnuauz4q3r5l0p2gd560dzgxn04er9l3xe4;3036671;67;130500575;127463904
319;bc1p7r52z7mj2qahan4esj8ytnrtmnxa7wf4gvey08se9k40ealqfqxqcrtlvy;200546;2;200546;0
320;bc1qzk0sv62qgdyx4aze3cvd9kr7puz9jxj86r7yug;1562500;1;1562500;0
321;bc1pa82xeggdpuqxlpqq60fvh0sjent3p8ngqxe0eusee2xytx0mkjhq4z5ftq;0;5;930984;930984
322;bc1p9srxdqx7u4u48ahj4s5gd3x5m932zm4fc4a4ds5ncm580nh864jqm37k26;117301659;7877;409735757;292434098
323;bc1pz0eqh77r92fctmyp92pltry3fyneujewdzlulqumyp5504jwerxsq56vyf;0;2;166000;166000
324;bc1prkprdv3plrtu42m3qgadr7npnzm5vtwzw0k5d6xyfmrm8ycwtn0qlgazf0;0;2;1018000;1018000
325;bc1pqen08lee7ewydm42aqxq63fgtfjwkv6u3ka9qf43xyx7d5xzpl0stpzhdv;330;1;330;0
326;bc1pgj0r8r38t7me8qxx927zn084afrsy0h3r94zn3d6rrrw37mmmaqqp8w53s;10000;1;10000;0
327;bc1prf246k5w8033dtgy4auenzlul934yejg439peh2dt4km8h46tlhs8yj2sc;10000;1;10000;0
328;bc1pzhpjs3jflvfg729ecc7a24fgf840ktgzhqkf8d0zk3276vefrkxszlkm2z;10000;1;10000;0
329;bc1pamv3qnqnx2dps6ku7c8awa65dn9mw8cjkxhv2yjvm59sjpydck2s5kcv8w;14200;1;14200;0
330;bc1px9z0gsasju9m2d5cm90a2dxx5ky407q46aaf44daxwy3m6nx6neqqnfcv6;10000;1;10000;0
331;39Jdp8oHeue7rjCRVFLgDwh2TGMy9Efbn6;608640;149;61440965;60832325
332;bc1q4tudfx9knj3h48fggmr8vtnmansrt2agn2tmuklamcltmmpkuaksvak8mn;70871765;127;136547169;65675404
333;bc1pwaz26ha9ed5usemf4t3rxax4m0k2q4eerxdkaml6r2xzt6mh8wvss0xsct;235253;1;235253;0
334;bc1p2vuywn8sqpccpa3u37kazjq3kg72mp0cef464xfpdnf7djl6z0uqe67tjq;3268092;1;3268092;0
335;bc1p2x5s47hrle90sdrvypyx3w9euuvc7ja8ftkfzt4fv0de3n489fusdffyda;294938;1;294938;0
336;bc1p62s3kvdaw8dark0zl0mh3gjswfux2cg3umak7a0rr96d6mprp4cqryksje;214484;3;1061684;847200
337;bc1phk6shym9gqhm0jtpg5ey0mrjltacdu5e6h8sxzly8u9jgmer2dcsn9yjka;26200;1;26200;0
338;bc1qm4gngtwm782ynj6nytcpemajjrfcssfca3y4h6;4388485;238;86458453;82069968
339;bc1p0aufgddcs4tgehdsqa9rqe6w5up6klt553amy3ts5nvqj90s9e8qal82p4;10000;1;10000;0
340;34wr4jiRpB34UPTzdip3Hqx6p7qh6hHx2K;5356611;1221;301564425;296207814
341;34Gvz6Nv9VZ6bXPzYACwb7wwwrzXqPVaW7;660719;45;22490974;21830255
342;3BYAqfsZztiB7WMXmqCVyFycdmdJYanKmE;25850;12;4954338;4928488
343;bc1ppfkhmmnalhgf9u0n9x8q5vcpvvfvtr06rfqqqer7ttaz5afdfw8slcsact;0;2;522163;522163
344;bc1pnzu9agqz0zzm4f6ypcmfrrx7pvc09ky87hj5q0kdauy29wejugdsy5z4ze;10000;1;10000;0
345;bc1p3gm835hqedqjwwqneyun9dchawlwy5tsn9zt6mxwgzsggv9wcz3sjs0fxp;3060;10;7535;4475
346;bc1qlywfpc5hmuh5s3ke7zxeeplahqgyvgjvcxy34c;42072288;57;42072288;0
347;bc1pymr2nrtmpz2lkatyw5za75ulx3vpdnayugaxjx2nuz20ef7gfznssyje72;7541608;238;7541608;0
348;bc1putzwk7axcjsm4paj76gu5nwfvrvksypdrpvwmst5h59wa259n6tsrf7zyv;3730089;4103;756681851;752951762
349;bc1ptzlymmpnaj47l8z98mgxpzzr25hwtm5gh09msx4kr64w2sracsdqpdtyla;2144292;1;2144292;0
350;bc1pk95lgnyc9hwhcfw2n9ce23zhkl2p7246lc0xy4lvkctghqr9fywsa8rt20;10000;1;10000;0
351;bc1pffyka85r2swenwc43tecckhhep66pp23ms9mm2qtfetugtj2snjsl9yxqw;0;2;613000;613000
352;bc1p3pn9gp0f0syntt60j6puaax6emt5scm6rx65q28c5wlxp4csajdskvduxw;546;1;546;0
353;bc1qschfcda64ky4mr80fheptj50axekhyacak9kqn;47575791;9582;106742909;59167118
354;bc1pq74j7a9lsfk24g6vgj0xqvmakp4csfll2fm4lrsa5xk3ejwcyqds2zhm65;110081878;10586;3058305725;2948223847
355;bc1pahngm493gudv05tk375eesauyfgut4qh2qer4vrk7dk3kcy6lgfqug3tw8;0;2;20000;20000
356;bc1p43qthsmccq60qz3lwvlmuewvcey70c466u0utg8seg36vmfgthws6f2qvy;10000;1;10000;0
357;bc1qwrtry4d3fatr44l4qxjvs6rh4j8ehumzg8cp0q;51943335;9416;116819558;64876223
358;bc1pyzum5w2ww4vj772flshq8lcjylnrfy2w2g3c7tzwux683s3dv5hsq2xkqq;56220;1;56220;0
359;bc1qgs2qznx2l2fxd8nx0zspp2g2t5t3fm4865phhj;600783;85;42571619;41970836
360;bc1p32nktsuffprllv0j93a2d3q33s0l6rlh598hynkgrt60lf6upqmqasw00d;155310864;8026;623331989;468021125
361;bc1p9e8dyyh59340kf4vmr4fhgqca8jd3fuxtald6w0eu92am5ypw6lqvvuadc;10000;1;10000;0
362;1JQJcA6ZuCesXaiYghEigsUhFyRdWcpwQg;583240;169;171690705;171107465
363;bc1p7d9vulag7z4dr2xcd4c4pqg49zjsfx60eg0z7ddd30vaf5687sdswwpc3v;10600;2;10600;0
364;bc1pzzsxuyfr9qv86h9lhktdwnw49c07pls38jyj4zxyteqzs5awvsaqj0ursm;29454;1;29454;0
365;bc1pcnmr42qyj3q2uan65n24t9x9rrg0jhsglra8ypjdqjdxg82dnrpsyly97m;765744;5;58453488;57687744
366;bc1pgdrveee2v4ez95szaakw5gkd8eennv2dddf9rjdrlt6ch56lzrrsxgvazt;14753;17;11070777;11056024
367;bc1pqv2y48nzjc4jj8r67vlgu6d8lcvsqmd6p0d3mp4ha5d2ftgue7ascv05j6;6345501;11;166504091;160158590
368;bc1pcssfr4x8vvqv59tydn9c3dj0wpvyqtyr77njgv9y88hnt4s87tzshxqesk;152454;1;152454;0
369;bc1p8cjcvdlzg0dfjnkgpg5f4623xcp7xkqxntayfjgwel6zx33vdvgshyskar;152454;1;152454;0
370;3Fctot8fwjCM2vdTubWSsk48Npk8BTmFR6;587421;25;15884196;15296775
371;3M11wuH8LteDDpPTjx7vH2tmERfnkMcohK;2950776;470;826299957;823349181
372;bc1py7tfyl602u6gnstvcy7guw4kp5vpg2jxsw2pzpr5ghg9xx60exxqhtcukp;330;1;330;0
373;bc1pgymjwp65nq8th26hc3s6a4lah53mjtjz2pc7atlf8xkxvjpahkfqqpa6rr;152454;1;152454;0
374;bc1px5v2sd3flnl9wc0s9skeczqe86dk68e7nmrf0ejcw8dyev0m55sqd9jjfp;25408;7;2218376;2192968
375;bc1pht9gfhxclhqlghcf9svyrqtxhsamvf9ka0weq344w4u7ve96c5dsfer7hr;20000;1;20000;0
376;bc1pqhds0stdz4gasmpevclrzg7dy9w3a9tmv6qldwdyhptt0k29d5hse2kpl7;10000;1;10000;0
377;bc1p5sc7jm2ke7u26z4hhgydtewfgj8lvqlfkpmhwgf7tdpxjx5fymnqxmpsxx;10000;1;10000;0
378;37GzyNvuwuvWm41h7F5Wg5DqA4L7wMF4Hn;214582637;926;10573212314;10358629677
379;bc1pchyqqv06yn6lgs4wjq45z24wmlu82rz052h43uwzfm87ms9l87sqjfx75x;69089;10;6309729;6240640
380;3MucBEtjngVYBVsYbkGsnxWvsSvEhhfDAr;4671334;6;16978887;12307553
381;bc1pa4eza4y4cm30wct6jj56s8kkujw2yc0nnc9ftv386grvuace3z0q5rlpg7;10000;1;10000;0
382;bc1pfmkyzmlh5rz0fceuydh378q2h3jh6ppsd3nd4svvpr5znnrxjn8qxj7k36;152454;1;152454;0
383;bc1pcqms2fr4ytkjda0svyrn56h0glpzq64mflerae9ku38rjluxusxqa954sh;7585128;249;7585128;0
384;bc1q07nazxkww70248yaw89uwrn9schs5cpqzz24jk;151686;42;151686;0
385;bc1p6f56n7xam5vfusc0qll6suvmvjfdx4a4rpqnwa9pxr7n4pfjty7qmp0ztl;255354;1;255354;0
386;bc1pmk30th4mxhjs4949jsggc6gn8mvtwsrshfhprqdtxjclrquz9m2ssn5h7l;10000;1;10000;0
387;bc1ppgu70dg6t86xs8n2s5t98h937da8pmy9ft2lnwg5mn8dejllw37qffhyfk;7724240;220;7724240;0
388;bc1qx25dk7rq0tefzyd7p4msdc0xg95yfm5gf0p6xyzw4puzc6eukzmske3d6u;600130;109;71667169;71067039
389;3MUiDJqK3va6k9VLNaUhemc6ayqsWWGcGJ;17525050;14;83411512;65886462
390;1CRJXLgmfp3fdTrMBZCUdMNCnUkjXfWVVP;720398;178;57534395;56813997
391;3A2WKKoHx9YjCDqCJKrvTNReVA7qP7RR8H;1001858;2;6001858;5000000
392;bc1pnqpgwanyxme94jyuh648ad4gxc87smkt05fuufdpg05eln9xlycsp9tykn;1226046;2;2710092;1484046
393;bc1payv3g5mc82snma8kxh8uevnlxnqst9qr5daprergl9v2fjqqkuhqsspdcg;152454;1;152454;0
394;bc1pmvvh5a56rutywg4n00f7k5w3yp0yhpulnd63awn2433pjszl5vns9xvfg2;3119000;1;3119000;0
395;bc1quskgc78df99xhz9yg823699u2u252qgq0fvmjq;2681234;4;2681234;0
396;bc1qmma8k4nsmlclcm2uf99wntlp0faz5uaewz7tx8l74qay2qz98zkswx0h3p;71667169;98;71667169;0
397;3QkcoxsSCtgKGUGbtNRF8TDWj1GeLxgCbL;2264918;214;603509275;601244357
398;bc1p92l0293nd4jmj82sueqsjqrttzcwev9cxcgkp292mc3stmyskq3q97mp3l;10000;1;10000;0
399;bc1pnmfzdvam67qtqrfxlvstyvjgmw3n2ls42j8k5r0gwfjd0arcxl9sa2pgsf;10000;1;10000;0
400;bc1pd3c6c6purcyztxetfcuws8t7qnvnn2csqzyv64ydtrcue9asjg0qxk77gp;7128864;223;7128864;0
401;bc1p6d9j8gv4pkn4dpr4zm6j7c98mtk7syadgkexszqu0zpjpmyg38nsyvjlgx;152454;1;152454;0
402;bc1p9hprrtmml74960uw30nxvn2t6k3hd5027a0mmvfwxym4ca6cv9zsfr36cf;35800;1;35800;0
403;bc1qjkd54fkdllghd5l2uq0atj03ru77rwrzprftvr;591277;1;591277;0
404;bc1phwv2dx28medh7lrcgukkm8r55r00mrgc22uj2eshyrs72nexq9cqzxp4y7;8025384;231;8025384;0
405;bc1pdjlxt7v4572fqkrlzdsx986l6zjtvl9s7ymazc4cv3rpxgqz3wlqhc76uz;115349395;7902;412337889;296988494
406;bc1p0h8v9g9xf9aq07e5n4xvkrtk3a73axr5jda8ufgy2l9s2tft9z6sedewxl;662164;4;1912164;1250000
407;bc1p9sgn9w4vt8wl7vqux58aw5cfre9254297ajua0utjuykrda5vp7q8f9j59;183000;1;183000;0
408;bc1p6dg984kx857n852rf28l2gtj63fvd6m4fm5303ud8jquew4a9twsdrm6z0;1935546;6;19353276;17417730
409;bc1p6re8nagx9vc7h5vhcf2m2tas79zv2cyxak5p8xsx0vxfmjgpg0fq30zzkp;152454;1;152454;0
410;bc1p4rugkccdm646e3aywexfdnfdwrqe3tnu955ktrmxg4hurnxqhytskqqjmn;0;5;1561020;1561020
411;bc1pd0xnnvqpr8rqpz6teprstwghdfajjawjjzwrv0lzxtpsvt7vus2q04yw60;20000;1;20000;0
412;bc1pf3z6f699sfa7z96qc3406twzqa980h805fgamrsh2dpwd59673wsgnkrrf;152454;1;152454;0
413;bc1qwkvz0wl2r99chvyqgnfwww0q8vu5h5z8q2tdwa;56099685;133;126165408;70065723
414;bc1p9kx4nxq3jnahr3ehshz7v9ccws34lxtgysp4nn70pmh5k8vft7ksg7e2xe;0;2;229114;229114
415;bc1phgjd6ksycjzrya8q99ln098kecrpgvq56qgn0dmd837fdyh852csqn3gsx;10000;1;10000;0
416;bc1pkzag24pv9c5rknwfcas7vp6wrkrdzm69fch7d95ht5rk9uzm65mssckwts;152454;1;152454;0
417;bc1puu4eka0pskww6zcfrd4epe9xpulhwd8fpxu4cjr9cwz3q6pddggsfekh5x;2474501;388;95704653;93230152
418;bc1phjlc49qrsqy5l4yhkyvhkzwc22l0qte5p459lavqfrurnxetk0ls9r4apc;330;1;330;0
419;bc1p0zsdhsv378f7c78gwaskcry20ttv6mwp45vy5gpteu00wp7np40ssu8ffx;20000;1;20000;0
420;bc1p96gvr2p3f5cx2csd0ll6pedvuz7vykvehrfyr4p48d7p5kuk0mdql8uwvc;10000;1;10000;0
421;bc1p6m4wcqdnqk2ra2jz3m75frpvdtwp56ctqlhme2yysz8gc95y6rzqqjkw63;6271426;6;51928865;45657439
422;bc1pgmzckcjk406qpt5ldpgrrrw2wdplfnnjtezur0cx9tf8ea9hzeaq8lj83v;0;2;324912;324912
423;bc1pcmst0p9a6d3z99rxrv73gkagn4fn88n9cwn09k0xn9839vdr49ksva2kmg;10000;1;10000;0
424;bc1prxg5u58kgdk858sff48j7l4kwrm34gfgq4ss95c00c6eqm5ns8sq5una3h;81345;1;81345;0
425;bc1pmrcdhvh2mjwv0n7r4skxseukg6457h4kph4ywtxveqzwwmv29p0sz7tpeq;10000;1;10000;0
426;bc1pudy688d9scanw9w0vv6fjx24g74hkg5gzwewlg0rkur89ahyswasz7u36a;10000;1;10000;0
427;bc1pqjd2rsngu5udfgfpa6ndpnmtuhj5fs9gx90lu700p5m2ltsa9pqqaqs2fv;10000;1;10000;0
428;bc1p90zerm439jxkw9qe4dzuh9p4ag2f5u5f9pw5pevm99ctq8a49a8q0qstwu;828600;2;1328600;500000
429;bc1pvdpwclwrlsu8lcrzsrr8rj8fhnpaytd8tlky7cmmcql5082xvt7srx7hd8;6388698;21;98998353;92609655
430;bc1pysg8zaf6zamanwvh2e6gk9sug0ymwprde94thhzkac9nvlr2w95qq72nyk;1403142;31;18278160;16875018
431;bc1p5ne75dfvksq85892nvl9ppxnwq6vedyp4t20388ywyckhd3rhzds8fskax;79000;1;79000;0
432;bc1pxd8nelrquun6kn2przn4je9uc5vy3ygv5w058r7mu8s8yk7p27mq4pjrc4;3272;2;318272;315000
433;bc1pzfdk0e64w46tefnls9hplgfknll59qmvesgquemxcsys3lxas4aq786pfr;10000;1;10000;0
434;bc1puakssd8asqlx4dmpcduttzxssjpxcdrfzlc95d287tjneey0ccdsd22wy7;104500;1;104500;0
435;bc1ptuztutm2p7g5vf07jk4z5094gftvslnu4ywew5cm7fsrj8qvsv9qu0m9dp;10000;1;10000;0
436;3JsrPpxetUJuUdLLg1fVcubMJ575kytqPT;3114306;3;5204352;2090046
437;bc1prxhhsglcpesepzqyvzcr784esdj53a50uyea95nqq3866mxd50qs5ckwgs;10000;1;10000;0
438;bc1pstk3092jmwqpq827j3f5vady3uvx67nz4teyxp9jhqapwqgzm24ql8urmw;10000;1;10000;0
439;bc1pv9jceqcs8rservrq0ldudgzampdfz3l2w68vshjug4elflpmvzhst32tmq;0;2;63165;63165
440;bc1px22dvfpzeanea64aezjhrzqm6t3c63ra9df70kpk365yx5rq5fwscqmmwk;2000;2;2000;0
441;bc1p5zvyazjmw5fktu92udwxsfnewauxhkr6jfe88umps36wgpa0g4tsmpecwt;10000;1;10000;0
442;bc1pzsgpt9vvne5zj2as5r8v57zfm2kdnpfrclc7hyewv23xrd27wgjs3pyhaj;57962;59;5938297;5880335
443;bc1p23ycycznkj9nzppnlrj4kz8njyen36sgtxnvgjt9lwhtcxex2n6q3t6t84;10000;1;10000;0
444;bc1pjn2fpckkkyev0mx0gkyd7vesvn8zufp92p8uvnsdkad2yy6d5ykqywflcq;0;2;110521;110521
445;bc1pnvu93uef5q6hyqq4cfu2ldmux2wky3pszwl5msmmeqrassmlnngsyzaszk;10000;1;10000;0
446;bc1p4xhd0rndkyyn778rtwgn2zxhragpm7jndcxknh7tjvu00xvd8yus56ytj3;0;2;110521;110521
447;bc1p62hctg4wgwmf0va8stzh3lq339f80kfh4gmmal8pxdj7zc08q8xqrcmxcj;204500;1;204500;0
448;bc1pmyy69a4ylpr4syc6l0lprvlpg0sddjt6rnq9plsrwsyp53vdehsqntys0q;197400;1;197400;0
449;bc1pchuythg9ssq0m0ky6yl97r560np6c8gmkpvrmhtd09r9f5y20flq345jt4;1037797;8;5407587;4369790
450;bc1p97tzhadxh5ns7k3jldk5lq7auuhlxnp90rrt84xqwcq2qyal3s7sfjy2uc;8531424;228;8531424;0
451;bc1pldr7hyq9sg84f7hktu44jd9ywjpzv92c45xpkzgly462vglnkfvsj0v9f3;10000;1;10000;0
452;359LjDNWdqmWFjz2rRtt5w6opwgacJG3e7;400208;11;114455135;114054927
453;bc1pkc4snu4rx3jg874n6kdt26h925d5jre0qxk0gm3e8a7nmkt64mrqan7s0n;104500;1;104500;0
454;bc1pf5mlysmfl5m554lazqw84sv949ntlw2ghpdrs0y4m5gyl22nlhhqq6wthj;554750;5;2264158;1709408
455;bc1pfsjapkthehnulagptz4hv3g90wvj95hk8tjjcjtpwda8fggztwls5e0x6r;1476188;348;109274767;107798579
456;bc1ptjc7hjshm3ry20fr35qy5l5gdxu8cv9kcv8w05tv977z47xtuh5qff3523;10000;1;10000;0
457;bc1pxlvmnykdmgrlulfpsf36fwa32k4hept5vqfa8n0kmzylz43gjx0s9skyh9;10000;1;10000;0
458;3Mz34Uvs5DrjjBtSaEEw4JDez7szFaxh59;5408647;46;124823941;119415294
459;bc1pc00vcumpv5nek7h4qkc9nag8lvn2r0wtcs2qfh6taqkr2zq6rlxsah8cuw;58905;1;58905;0
460;bc1pa4gz34rkrvrgtx5aydrw0fnhelvs8ezzzy3u3djfegzneg9za79qjg5atd;9552;30;24036;14484
461;bc1quh9jm6p06nqnvgvvv733pl0g0y6ycxl0aas2t4;8597627;7547;695632675;687035048
462;bc1p2fyfctf54ef62k6697g8yc6q4tk6xe8jj4duzjj5a7d5prllk6hq39upe8;7612047;278;16684589;9072542
463;bc1pqe7r6cehfl4w90nw82pqyu6eyft4qu65wlcfh79mhcx4605zm4ksetlkq5;10000;1;10000;0
464;bc1prt4ctur03tk9r33qp4yscfzslmqgrwmd3ep3hy6elefg8akum85s97d0up;10000;1;10000;0
465;bc1pjmxsc5vmj9xagkxrr2xuc5hy52fu3mqa42k87ctjzzqhwz8y7ukqr3lwnd;33000;3;145000;112000
466;36YLALyzTvbPVZdVykFnnW2sFdcY9koB7T;32048;122;93727513;93695465
467;bc1pkuyj0phamx2c40wsxcnp9wd5mlwxuujnfd2ayeaqnz5h6qcml9dq3cwna2;272932;1;272932;0
468;bc1p3aehyqsjctlfts7futpf9suzstj7dr9tstxpand0vdncwyxrkrzqxkk0ja;10000;1;10000;0
469;bc1qvs2hts5u0mk06ayecd3m85ps5w5emuxtlxeg9x;46023462;9570;104455810;58432348
470;bc1ppg3hpj0pyvzhj3atwkhffpfqj6vmxy9dxzf2t24q033m6yj6p3zq87c4u8;63165;1;63165;0
471;bc1p5rp29s2a0sf4xz9p6y45pr75es5v6tfgqd9vdlv39pv00qmsa0uq3097ax;10000;1;10000;0
472;bc1pnc6c3nck52f30qzcqsslp0vj0sq9hvypyldxdr4zm40xdhyjdnxs2w9g7l;187400;1;187400;0
473;bc1pmd8cdgy6k0gk7w2kt344aqmafygcj7l5f0y48h9z6mn0uamt25rqcxspj8;577300;1;577300;0
474;bc1p4xzj0wpwt8hp9e9camxmynrfvklxa75gxqr6kkku4kgh95rc8dzsq7kzea;0;2;324912;324912
475;bc1pxm2pmmp0smwnz2e6qrz8dq8457tc72mn267trpwratsnmhqc6rssg982vq;7627630;1139;173377886;165750256
476;bc1p0f7dyrae6jeacxk9w6574azjasw8cjalyr0qxvz5tq3j2r59730q60af57;204500;1;204500;0
477;36wSBovCfh7uxfcdKBRsPbhunRPiyMR122;638179;284;46376518;45738339
478;bc1q6t9g4l3s3657xyel5sjnqug0re69r2m6w0n2a7;82102;1;82102;0
479;bc1p7nlk72svwe7zcvqlzrduacnuprng7rlw6mvv4uf5usfnwp2ra6ds6rhmlc;0;2;13000;13000
480;bc1phlrzg8d4pnrquk2e73gmt47x6jqn6hremj5xj58suq3zfztmxx3qz5vx3u;0;2;110521;110521
481;bc1phzhqmr9shs49gx6hyfy3w07efdvw4tuqmxjpt6p7fnrmnq7z2s7s28e6yj;197400;1;197400;0
482;bc1pt60p6dfncgf23ky9960fwhkl5hncnyl3hk8u683crudtt0c9a09qdwcjc3;3348;10;4986;1638
483;bc1pwkdqtqjv0zhd5wmm6vf7vpwzjky7hlqls6hc9efjgmpst4sssx7qt0artv;67178;1;67178;0
484;bc1pynhskqqrslzgd4xdye7e0d9z8rr7xtzlulyu6zz5fe9puqpu8dmq8g236t;16000;7;16000;0
485;bc1prpecz56x7jg2guxegtj99xre3q8pmlc8kcp4ayrf9kcqcl2dq0jqqtsjyq;10000;1;10000;0
486;bc1pfgqdzhl0fuzpzlyz9dqc5et6kgzjssf2lugc8pdpxjvjkgmdxyfqwv7cvg;0;2;139016;139016
487;bc1p8cq8qd06nzk3ttck8lrh0qhh45055yyqpycd9ctm8y66f42pn9qqqsqjk7;0;2;110521;110521
488;bc1pfy7kqy0meeptt65ta4xz0mmh2974gk3pary3es8xhh9z5dvjz3jqfs7eh3;7547080;10;22096744;14549664
489;bc1pyxv0l85rhhvtv5l54els8e22rw75qtg3q82lsckl7jwdwfdqlzns7z257h;0;5;543984;543984
490;bc1pcu54d6hrc90md305jq5df78v9s0az6uqh7wd40mwhqx9xk9027rqylmse0;747046;1;747046;0
491;bc1p9hdtfv49z3eg5mh2cxa8g9urw82vhpqhu68cvwl5mqehpk8t7cpsr6k7tl;10000;1;10000;0
492;bc1pj6l3t0k4j69uc8x0dmhqf8tnl5u6f7fgefd3p082a4dgpcwnltjsg2wulz;0;2;202693;202693
493;bc1pqv0vy24fzku3jptdxycyr380rllvda07gs7uqguejgg0l5qp6j0qdt20jh;10000;1;10000;0
494;bc1pd4swwzg5h3c2v6ed8506fax5fv4vfgl26q8p2g0qhsdxgx5lvduqval2rn;63165;1;63165;0
495;bc1pa82xeggdpuqxlpqq60fvh0sjent3p8ngqxe0eusee2xytx0mkjhq4z5ftq;0;5;930984;930984
496;bc1pcrjhmu028ckj8zz3mqwl88tmudv9x4e86ts826u87tlvmefzvkzs6r63g3;10000;1;10000;0
497;3GCXF8eXbyvHYnqNbqVhBV9YXJJZeT8kYe;25403996;22;456966583;431562587
498;bc1pnnss4e35929rqq9ahny0k5sg98k3qn2a2yrp7awkqkpx3pk2dfhsg8gpqj;214046;1;214046;0
499;bc1pspscm9de4gljeeugghfcswz0q4uckuy0lkts9gm4znvv4447fdlqte2rl9;10000;1;10000;0
500;bc1pet4wj3jhd4akvk8zsp7vel5h43e2lkwelrxl36sjvctkurdftrcq82rz90;149572;1;149572;0
501;bc1ptsyntamu5hzverthy6alxnkfy452p7nvqph34ys7ekvvfpq5vjjqtfmkk7;1417156;339;65377839;63960683
502;bc1prl2j568avetgfey2fjw39fng88s2v37t6d63sgjcclqux9kysqhq3ruzfc;10000;1;10000;0
503;bc1pden8agqzlnxx4dk7ufqug8zy4yp73grtpyek5yj0d958y5ynjjks9k3qsw;0;2;1387400;1387400
504;bc1p8xfnh3rt9tclk4ma0deqpgrclsduknsx74dttqyctfakvfmwe3vqvter8t;197400;1;197400;0
505;bc1q6fmqp3ytm5nzqv00amknm63axjue2ueq3nj90k;59530750;11408;143156319;83625569
506;bc1p4alzsupkmnxx0agu3h2mtjylluurh4v5lvg2laws7934qjlc9rzs8u9yy9;10000;1;10000;0
507;bc1pzl628xpfruvpxzx9xgp3cspuerqg4usaw9atgs7jen2njvee7kyqf3nynd;150402;1;150402;0
508;bc1pkkmv4zxrmm3y7rss73a0e47s63pjq40jznr3kmljm9rrah7kcn9s3ejeev;1856328;15;9681061;7824733
509;bc1pc8zluamk93y0f8qlcerf8unja3674e4c9jqr9w7k84e4m2w6e2ssn7mntu;10000;1;10000;0
510;bc1phfh6879p062e0mav930q44uukwpgm338qw6a7wl042ph9nryezzqkfwxnw;346659;354;348843;2184
511;bc1p57729dhvpxtkldjth0at36hjywwjhjsujctqcr5ww0rjavrq4v5qcne7eu;914082;402;199276265;198362183
512;bc1pzksm9mj4xce33xpp37yfj8x38s7s8crca3j7p6k6te52nruqlp7sgm7vht;10000;1;10000;0
513;bc1pt8rhn6dm6amwjr3tlyzllvy4gtr7uzdenwxa2q3mz54m2pzpevzqkcm58c;113840081;8066;413786453;299946372
514;bc1pjp44cauqhqqq9n3d0lmcwh5hv6084tjx252egrzf4pgxaq9mtq8sskwkjq;1376280;57;13231766;11855486
515;bc1pdwwd6670p0auez32ckhzltmrl7gswn23eaxx4s8xev3pwyaaq5yss2edqp;10000;1;10000;0
516;bc1p3fdr32339vrpg8qfkgnj78sxpr0r0yaysq659q8gzsqa2n9ypuksr5287t;100457;1;100457;0
517;bc1pw9j6k5g5dnxna8ycmmcpc3lwwtdr58hm4xgnmyyml06xgkztvsaqalqrhh;10000;1;10000;0
518;bc1p6q0d8lepg6s33lqymkkdlsc9ru003mm6mld4pwz9lp96f2fx7l4sct4x3n;187400;1;187400;0
519;bc1ppy7svnrwzpujef3gplphefy4nk8xsxyhsgwt03h2vj9u9865y8ysnf3qr9;10000;1;10000;0
520;bc1pmlg27wz8sdgu3s5sef6axh8vjrghaghzetatpda29uc38lhkvs9sp083fk;96789;6;1226376;1129587
521;bc1pf2q3rxg6cg4j0gmmdjzfkz02d0qpk6fy638yzlvq800hja0ur2tsg0dfsf;118092;1;118092;0
522;bc1pf4hwuxp2cp0zg2gwmhg5xx6p8nd6fcgvj7cvam8e5a4fcrwg24qq559f68;0;2;110521;110521
523;bc1p6pvhk7uae6l3uha24hel9987t546pm0dny2sn9ezrhenec82u93svevfyl;197400;1;197400;0
524;bc1p9xptgu6f47dtxc7dpyt0rt6dgduvzmqmvtn59xdcgryyef3l0ffsjhsaw2;10000;1;10000;0
525;bc1pjf3grl3vnht46cnr3h38cufazce6whq4vf7rrp9082yhrpv9nh5qs3l658;187400;1;187400;0
526;bc1pqk3rce3ljqyskaqj03mjgretwmvtje226rlat79ey2h37l6cy67ql5qkfq;10000;1;10000;0
527;bc1p7yv96pxc6qnv63fq3w7g5w0etaypfct07ul3zynjy9qwfvljn6qqlae4c9;204500;1;204500;0
528;3NMmQB6bbWyxTQPjrF4nJhbjQan1uaS8gr;753768;32;12365125;11611357
529;bc1pxsxxp325wcuk23nzh4ves96k3jk2uwl2tz3ezgjejazw5nw9y92sghkmez;10000;1;10000;0
530;bc1pk2je97y3fzs9nn4suy6ccqgp7jj2z59g0zg5dld4gpetu8v36lxsc2k9pz;628370;2;10628370;10000000
531;bc1pdxx7vgc93tmuxx85g59wtrdy7hhfmdal3lq0dyteu8n7drzwvpustesyyh;0;2;202397;202397
532;bc1pcwf8zju25r5lfy3lmvm07hgg5fjgk49cy62usk8kutslg8226dpq6esqf2;104500;1;104500;0
533;bc1pxd5jnnzqlkm3q7a56fzgc8hs0qra42gg4tgv46vk7uvmh0cdfvms768ysl;0;2;63165;63165
534;bc1pq0vxe328f0eft2w4y7q0ws4l2v65tu57p5fugca476ywu86xfyysx4kuk6;65691;2;218242;152551
535;bc1p6d84hl68yaxymdca05zj6epsflfaw78uk2g7ma9f7mjmxrqf4xkqu82f37;11177012;1;11177012;0
536;bc1pwmmt67zgrqlxyh89mg3pz93y8ltwzwckmaxeagwf2rc8c7snvs5s4ghl94;86218;1;86218;0
537;bc1pqaf6segam87p46a944qwcudwtpyw3hwkjvkcvcsm0k048323avpsp5gffm;2463416;18;7216887;4753471
538;bc1p524w8ufsg9kaf3tyamwchxgde090lqqy7895ax5lkw4u883d906slt8prc;197400;1;197400;0
539;bc1pwa3qfkeg4wdszmnclvwnltzk9jkrvaafjftsgyjmfqxpl28fwxfsax4mkp;1274800;1;1274800;0
540;bc1pzj27vdx9me92elezhnl484a3te555h9rzpep5xy7u2wwvktru55q4eppfc;8109870;711;801740330;793630460
541;bc1qlfn4dm78atcnhfn6texzg4pqll4tng6ttugzty;2629238;4484;694561144;691931906
542;bc1qv9h5meuld74a887j6jlzqsmf0sxlrw5295letn;15677470;12346;2397359564;2381682094
543;bc1qp08tq73cge20vrnk9cydhlgcwuuaalm6dsjdcg;1124010;4;5378608;4254598
544;bc1qschfcda64ky4mr80fheptj50axekhyacak9kqn;47575791;9582;106742909;59167118
545;bc1pq74j7a9lsfk24g6vgj0xqvmakp4csfll2fm4lrsa5xk3ejwcyqds2zhm65;110081878;10586;3058305725;2948223847
546;bc1qwrtry4d3fatr44l4qxjvs6rh4j8ehumzg8cp0q;51943335;9416;116819558;64876223
547;bc1p24sh3p7md4u56mrq07nfenrjan0f7zxkhtsmmmcgcaae2vzfmc2qt56xys;131598;1;131598;0
548;bc1q5m8uv6xs6f4qwy4ccqwjyafxfmtljkvzm65kvl;3979840;745;5195434494;5191454654
549;bc1pscr7sgq924vq3zuvjkgesf2cxdknd5cdv2lpkn90drt5vflt9jzqrk6z5h;2466905;11;5124353;2657448
550;bc1pel98vlt4gxtea2maaccdng2htu2rxry5nyfpw8kacak8fmz5mcaq66xscl;346000;1;346000;0
551;bc1pcv70js6gm3yffg26hzchtwrgcta9cszd40vpkqzl3txmnxkcr2vq2a4dtm;211246;3;994938;783692
552;bc1pvnuy80s3a0hep2z6egqv4h3gssrxmhnjag9h7cfhvq0v99q6j9rqpqljq7;187400;1;187400;0
553;bc1p2az0zft8rv3duqlsk0t3v3fnfgpjymj88ywerejr3fgaja5ux9uq4hmft7;0;2;166000;166000
554;bc1pt7uc388nytxassfkzhrqw0yrt04w38xv3chws5yq79wqp32ces2qhdtdk6;92000;1;92000;0
555;bc1p4emxd7l2ss3q6543f42af2c5h0w8tyxhc5mxvfa634wc8f3nuyvsn6u8ul;755569;4;2735569;1980000
556;bc1pe9pwlsxmhtd2htzyq7cxszgxfq0spl3cqaxyf4q7hvtggnafzlhsh0hhfu;131598;1;131598;0
557;bc1pqzgu8nquyvmearjerr2jgqfrtle3h85fd9jh4u7eecf5t2aaztmsa7qqke;330;1;330;0
558;bc1p5y76dmhjefvt30l4mejxwkseqc364nfatcseez4534r6ugrua03qjz69mu;10000;1;10000;0
559;bc1p6q4g07ruw5j98cy5gxjzp7mg452zs9ltvy0286vfx6qumt5j9vkss9u4rl;801830;2;2190123;1388293
560;bc1pf6tpmzq70qyq3e4kxaj2tm9ux95yflew8q03e3j3e4m62723eftqg7u2qj;355469;1;355469;0
561;bc1pnlddm6pyxa9nmj3qxqwynw8q558rvnxkv959lwkqgs2ucw06khuquelkr4;10000;1;10000;0
562;bc1pwxh54xnweqxxhja8r7c4a8auj902kwycz3xkr7rvu3pdky8auzyqs6aqy6;10000;1;10000;0
563;bc1p35dlvfznc9v9ezdc0dr22za39dgputwfd9ke0vkzctruq6nuc5rqnxr8u9;0;2;110521;110521
564;bc1pj5cgnmvv7ykyzzyf7svnt74q6gkcmlma0vkl87h72egcwrh5w5dsjyjl4z;187400;1;187400;0
565;bc1p4z4u3ctdgeqk0854pxuxjclrs6nquhp3f64mft7dsx6h0dhr294q2glu0q;136974;1;136974;0
566;bc1pfyuzfqe890vxnlq6n7hyh0827mvj3jt9u4u2fn0z4llmjezacpcsyvdrnc;23085159;4;105723415;82638256
567;bc1pcqms2fr4ytkjda0svyrn56h0glpzq64mflerae9ku38rjluxusxqa954sh;7585128;249;7585128;0
568;bc1p6ym7jh2qwk8glt5ld0v6cwxhjygwc3jpm2e4sjepl5nkzmp3mwksys3f0c;10000;1;10000;0
569;bc1pgmg6v6vkc3cgdpzpuga6xlzgkpzh8g05v8cqu5ty57knaul8vqlsdrftgz;0;2;143951;143951
570;bc1purq65e4xrdteha5mgx35h5wljx0ffh9yehjxgmnffgfnu42fjx4q05l3af;197400;1;197400;0
571;bc1p9ypkrzlu3urrpcda0rd7w4lahwl9uhvy6v36wwppmsnwa8ev6fcq0u4eng;69709;1;69709;0
572;bc1q9sjlcqvx77h3vgkxf6t37575e8wxnr6exsxxgh;472789922;237;38569946642;38097156720
573;bc1pl35wn7k578zg55exz799m6v6pnu563wg34t7yg7jsnmxpmvw5fdscdsmvu;5783504;209;5783504;0
574;bc1p6a6cr30syyyf6nkwjkawm4c7532my78wjwhp5auj755hle49f7rs50g3q5;126757;10;1439667;1312910
575;bc1pug8f5rdlr96rasrt7favfcjky8k2ds89rdxul6umvuysm2e6dxvqdwwxvk;10000;1;10000;0
576;bc1qnu2ghcxswccw530ng9hcckf2zz93dxkn0pawl5;203936;37;203936;0
577;bc1qqrmk22jmd4s623vfpet5qtgzjdujdwzjxplj6e;241742;117;7677233;7435491
578;bc1pwvyztpewgj7tut96fuf86g6zs5ypp02j0mj9sencm7pf72usr0asuqwgzp;10000;1;10000;0
579;bc1pae56nyxxw9tn7ae7tyjc9y7rfvry5swxhafvyuaxm28whpvgpj2sp8ch8n;10000;1;10000;0
580;bc1p522ewnxrglxpx9wmczuph7j27jhef4d0es3jkylnxaqr7p757asqjpt6vv;10000;1;10000;0
581;bc1p8dn3jqxrz9gqactl6s3dzfqsehz0gvnlp8zy2gzv4ddvfh6u7vds8ypagx;0;16;6506565;6506565
582;bc1pyju4yrk0uats796zc4racaf0rpee0arhfrfcucjefle9k6e6hl4sgf3gsr;0;2;83159;83159
583;bc1pc8xuhjgml4chkrcfd20qm4kaqfty2m2832nf09vnz5d4x7pz0mrswmdukk;10000;1;10000;0
584;bc1p34h896sa530nt007hav5dc6lk2q5l08hgj4xec3z0nghr0ddcwcsl602hf;187400;1;187400;0
585;bc1plfhq93zn7e94rksq2ymruh24r63adp5c5r95tajm2s5q8pq7eyjqwce4ry;3591821;35;119655380;116063559
586;bc1pd3c6c6purcyztxetfcuws8t7qnvnn2csqzyv64ydtrcue9asjg0qxk77gp;7128864;223;7128864;0
587;bc1pvjfyxm4ctccw65xhlj4rsekcxykn8g98n7w7wfjkpfy6emjyumhs0kddlm;471277;4;1423604;952327
588;bc1pj3h72tefnlkheplzedam42dxrwqmx6jgukp7r0aqnmzu7gzgts3qx5lmfz;300788;1;300788;0
589;bc1pgej7rvk2z96g0qv2054uqrrdzudyy5hrzc4hpt0ezpyz8yy2u4hqezfhly;10000;1;10000;0
590;bc1phwv2dx28medh7lrcgukkm8r55r00mrgc22uj2eshyrs72nexq9cqzxp4y7;8025384;231;8025384;0
591;bc1pdjlxt7v4572fqkrlzdsx986l6zjtvl9s7ymazc4cv3rpxgqz3wlqhc76uz;115349395;7902;412337889;296988494
592;bc1qxwrwp3vsl8cuwr7qyd68h2k95q0pnaj5fgc9gp;56930;2;355720;298790
593;bc1pjxax8jf83np6hs4jj45uljuyvag0y4ffvla9gswymxtn22c28lqs44zl04;197400;1;197400;0
594;bc1py7s8el84kkxfner6guw5gg7c64szxl49wyvms5garge0wg0t2qjqnavrdj;10000;1;10000;0
595;bc1p3yhk0jqp7yvwvmlyhkm945gpt0yl2ggymyevr3c0jjunurataayq9q4ahm;2116;2;317116;315000
596;bc1pfzzdztvqpn0wk9feen74z53z5fwz24h70l2hm3364lddu64wvd6qmt9grq;9632663;7;25829483;16196820
597;bc1pqtutp44udxs3gtyr938epduqv994vgx0pfyw426xrnvlc2wr829qyaaeyu;266619;45;6067335;5800716
598;bc1pm705tgud7pyx9z0nqqfp9v00gu9qs33mkwxu58x2s4z7jgsn8l0qk6rt8m;10000;1;10000;0
599;bc1plgy4ccw3artunxkkx7tqs3z8lym3605atak23drqs746vne3ayvs4xj4kx;110521;1;110521;0
600;bc1pgn0e34xcl223z40ftcqr6w48yxkyulah5n26luv4fxke43y7wn7qallcn2;10000;1;10000;0
601;bc1p9yvxfpmkm59m5lj6tmcefyaw4826nwdfwa8gzvjclppmyf99cyrqh0av8p;138504;1;138504;0
602;bc1ppfrf2u2dusxkvykcy2fdwlh5ht3r0mtr4fpa0aw0hjnsmhg4p8vskr7t53;10000;1;10000;0
603;bc1phgn3363pxfq7pcprvjcapxalv24trfxqw3sq55empv7efq90fjzs03jcr5;10000;1;10000;0
604;bc1pf4ngpm4w3ltmmtyeuyjgatnrkck9k89t5apag4kju0u4h23psmqswfq8s3;136974;1;136974;0
605;bc1pgee5fz7vcmc0cjxjdrvk5w7fs4s7vc8yku9rdpvxkzhug5t8hsyqvc0nvw;2279857;185;28781402;26501545
606;bc1pu9c7n7remdqwg9m060gm4d8l6m5lrxhuzg95qlnmf4eds2utnn3qkvzhqm;10000;1;10000;0
607;bc1pfx4mpexsuc5cns33q8n4evawsss6kflxzxqrmrjucdz2368h9s8sugfw3m;0;2;56000;56000
608;bc1pvdkvyvzpzdjqqd3wwq8znmjuxy0uzg468k5vqeh7lel5h6uu89yqjq2zg7;10000;1;10000;0
609;bc1pfsm2u6qg6e7wlxa45pc905fx0jh4pw8yyvschwtufvepjsmxs6dsajtjjr;465118;3;1222345;757227
610;bc1pt956fkpdhlzqf74p2207rx4w7msaq9z6kza5q0ghty6qculqhdtqkdy2qx;10000;1;10000;0
611;bc1pfpdeypw2katsdtzenyf8p89ge7670jquk22wfvz97y5tr0d7sjgq9ffp6j;83848;45;24862095;24778247
612;bc1pgna8v3wnvxzzqh9rt9axmakxwk2q9vt52upfvdyya7xydk3xss5s9ph967;0;2;52146;52146
613;bc1p88ndskx5q9wpx3vughdmcsv2cfjmqrgr0lzwf66k2s5444nq6n7q3u94rl;0;2;722481;722481
614;bc1paqmtuxucnckq9sm6m7hcr5y9xhxywguyyhdk2fr7wstpjx8d72mq3ssnyc;10000;1;10000;0
615;bc1pxzpjsr9txlkf92g5s670uwj4v5zeqyeg466te3czz6rq0r0m7z6qxvp28m;30081;5;7643154;7613073
616;bc1p556adlwvz22mhxg266fq8a7hxhmww0y763fg37dzf690xmdsz9ls3y6qrf;10000;1;10000;0
617;bc1pjfwprqgr429xy0jgzm36wuz3m3z4jy0k9rgw3yhthva70sulgccsa0rkh4;9241736;233;9241736;0
618;bc1ph2t5nh02w0vnzh20ndst4pt5luppqdxr5uv9sadfda5wt62dpsss3jw7n2;10000;1;10000;0
619;bc1prup4tcv9et5w8xpm6m294s3s8u5ufmegfp7gt9p3ywafjjhw3wcsa49xdf;0;2;751952;751952
620;bc1pwh40v66vp5jrwsak3cd9zsnr3mp8p49jz8aqauslq4xh6h3n04gqme902v;10000;1;10000;0
621;bc1punz9avcqzfpes6dra8ycpnn24qpfzlj2xq50fyjzpdydtqxl0flsshl793;2859126;31;131158497;128299371
622;3PtrHnC8kGFscNejhtzT4LHsx1wqS2deD2;177848;10;3014593;2836745
623;bc1pagwfgdf42f77al68mj3nd3tm65h4nz36q62v90dpr649069x48eqcekhuz;104218;1;104218;0
624;bc1p8dpcss0z2psh98fgs4a7pr5992nkmu6xpalrfrmhr5t5tu3n0dpsy72tu4;10000;1;10000;0
625;bc1pnxfn4tu0vp9ue2f37htctkukm7mkp2erl0wvvd9pt8r6zefn2pxqhup2lv;1924466;8;7536878;5612412
626;bc1ppscm9lum8hv5wh854ehrgaw4xas9k8wg0erwj4p640mrxjtrwykst9pd7l;1638;3;1638;0
627;3DtJViEScu9eMq2AiTSPNgt6xfrhFR5HCo;58592393;686;3986746840;3928154447
628;bc1pjxznp99vq2fhgecgv4xkfnxxthtp025u4nldjx0wydh8z6eqn6hsk5vwx0;4494621;175;34920996;30426375
629;bc1qlzdswzqyhu0zgh3d3k8mtw7cxyzju6nc40t53f;29200;16;29200;0
630;bc1p97tzhadxh5ns7k3jldk5lq7auuhlxnp90rrt84xqwcq2qyal3s7sfjy2uc;8990416;225;8990416;0
631;bc1pc905fksgr62chrlwq24yrvrqeemxnf6nyr5tqwy7m3n05z58h3ysjx4sex;0;3;108592;108592
632;bc1p5thl80kpa9kssdsupjte2tj2cqdl57nh5mzra8rt9f232vap2tysmh6fpd;109964;22;109964;0
633;bc1ppgzzes90a9ftkz70yudzfdngxd0psxhwh3uwtqygdj4v7uy28h4szp97su;359112;1;359112;0
634;39y811L2VBtDw3LX7DYSKYLAUvxmC4XL98;1421051;74;53793127;52372076
635;bc1p25mhw6x0lepw6taagyhd9m76almv2znylk9egvksl2d4xqczm44qy7x8cs;10000;1;10000;0
636;bc1p63gqwpyrwh74w4avnrmfltrjug02kltrqf4m4hchmm3gmxtvz0rqmpljcs;694503;156;78996143;78301640
637;bc1pw2hvsr8dul5922lm0smzmxmwqkramdre7cx63fy2wu3nv4lq37zqcvfnjy;395336;342;3756382;3361046
638;bc1pr7dxy3jemgypj9refgu3jqh5nrldc23v56ftew3jnyrrr46r77fsky2tq7;0;2;690652;690652
639;bc1plfa4wywhh4ps3qlqdn8r6s5e2ztt5mx60kd0lj60zj4vz6glpxns9s4r85;0;2;727230;727230
640;bc1p7gp5vqlxcxa94fpfd4064579hu2cx83q9jg90t0kze3t9t3lrm7qgszyfx;546;1;546;0
641;bc1ql8k89mfzqwjaqnq0y9uxummllp6v92fkykkv78;192625;29;2866046;2673421
642;bc1pqrh9u6g65rjkrt0z3duwglzmxgelmjs3xv3hha7knjx32ytrh0hqdtd8t6;10000;1;10000;0
643;bc1pcy9elnscaflq65zepaz3cqn4vummr6tsehhjkpsj58qjsetglwkqr5u68g;10000;1;10000;0
644;bc1p0qk2024a00yy95865wr2npzemsgnxgkztzzyjq5v86xyujj5rfrqmwmnml;10000;1;10000;0
645;bc1quh9jm6p06nqnvgvvv733pl0g0y6ycxl0aas2t4;8583291;7540;695618339;687035048
646;bc1p8ha7gsld9pz8r63wwnz3vclwuj73thqlre7d972ch3adsng00n8qq9wpuj;10000;1;10000;0
647;bc1p9z0ha5ph6sj2r70k2jt927tala5quv8wxqd52qumpyxhmt03h0ksy0jmw5;10000;1;10000;0
648;bc1pxv3r455f0ncw2a6ucz00adcfdd2tx3a56nax7aszd85733lqu0ds670vjl;10000;1;10000;0
649;38oavN2Y7sy1QopD71doNknd54CiYPyYMP;387307;99;29363274;28975967
650;bc1pmsvll4nr36lgkd6pc6t89vsrfyuvgsh2hau6nm5wv985duganrms7jjwqh;0;2;107400;107400
651;bc1plxqz454su7a583egjexhh5mclqeujz7w6uq7lx45pr0khj8q935qs4udk8;2730;5;2730;0
652;bc1pfhmz32mweat7490hcxk8fujk4huyaaqqgn7s6wapfepzyt6y2h4qvyvc45;733730;1;733730;0
653;bc1pfcqlhn52hegqak8hlfq4cl7p7zu2yh0f754d05x2xqh06mkjcveqplwutr;10000;1;10000;0
654;bc1px5nft2rm5js45u4ce7ujfws8jp4jkhjhyu2plvl9rxrwfdknh56q2v0r4h;10000;1;10000;0
655;bc1prsx7l8rveuys9m90jgm453k264u29tc36trca6svvyft7a6v4ftqrsa23g;0;2;751952;751952
656;bc1ps0jmdjpfjna0v2ftmcn0j96luf7f5tcaqy479uq0ew6kc5s4d3vsxp9ncd;0;2;722481;722481
657;bc1php9ys06khkqm35smu5tumv6ws5j5zqjxvdnl5glypfd0cjkr55us6pgydy;722481;1;722481;0
658;bc1puavj3300kn7zctf5rcegmxz4xp4lu6ycvpe2z5rfwuplvvthhysqcytk46;0;2;629352;629352
659;bc1pc86m3g42we9fgnz5kcejgzt78433wqt9lpzfv79prs6g2lpdhcpsvp4djf;0;2;733730;733730
660;bc1pargxq4z5hkm2e6kfghsr7zmpe3m44fx0jwf8rhm24m7f6x8e4d5s40lkch;10000;1;10000;0
661;3C9X2fuuiZePgxZSYWrbWr9xWQVDmKrHLd;7126470;6;33378492;26252022
662;3LsUbRPciqyNcbd3f5sKeFuqZDWgh5x2Lb;605045;4;1455045;850000
663;bc1paezuezn90vzawn4gn2mltytj9j4ccpmpenfyvqnywl2u9uwspzhq5kt3fj;10000;1;10000;0
664;bc1pgmdc8kk0sx3t4sffcejxqd283ptjt72682tyt3xfr80yeaf4zpcq3mlkpk;10000;1;10000;0
665;bc1p5g5nk78zszxwgcwslzm09vea47egswv74ql4vn2v36atnq9zfkcq2e6gak;727730;1;727730;0
666;bc1pn5jw3kvns503f3q5092ceqnuljwcwnczh4uukn7kpun9zed8femsgfz2vu;10000;1;10000;0
667;bc1pt8nqp3tv05pwafchethz46gpz9af2h4zz67f6qd5v58n8yufxxhqfx0wsd;12558;23;12558;0
668;bc1pxc4uxws9chdrurgyk86h8crztzlf7ssf5y980a7tczn4lns9nd5sxfwfz4;0;2;359112;359112
669;bc1pldd2fjl843e0fgmhx5w4j4d660qsacfzlpw07j2cc2axa9z5x8lqln6ns6;722481;1;722481;0
670;bc1p97hsw4rj5jqd3m68y6x7xwvhmdf8yccgdjc3tl8ld9vc9xpvsraskyfdye;0;2;629352;629352
671;bc1pggy8yy2eyv986h2du4mtv7dhs5v6vctjeluf9l6s6x9seg47nf0sdzcrej;0;2;722481;722481
672;bc1p3fg4dmrecwmr5nz4mlmem6q59v2hzwnqy4qnfmnx6hegrldd7kcqafev3k;10000;1;10000;0
673;3KDXBFwbcMCsGE1bEd4XXnhjNtCezuvvwB;1915917;9;13531605;11615688
674;bc1pp3zexdlr424nkqwc6xnfkmjmz985cfzj7tt2rtc8sz4j6ek7n3ysknftmh;704886;4;3087864;2382978
675;bc1pyxv0l85rhhvtv5l54els8e22rw75qtg3q82lsckl7jwdwfdqlzns7z257h;0;5;543984;543984
676;bc1pzj47qpn7lyex9xzhxr8x5yxzwsumu6my0klnu2jyrtc5gq6zjzssjsq5ap;888496;5;5044480;4155984
677;bc1py6y7wzs77k25rtal7zrlzh9raj5697lqcs4uff47u9d8umf04g4qp3uz0s;10000;1;10000;0
678;bc1pyxn9rqp4cwhec9w48d4jqgt5ctkcdvp2ryazk93mdfalfy7rxk4qgtjkdv;116800;1;116800;0
679;bc1p29z5c8m28pdar4v5s8ss26xk90dejuk2hhk3lyaxzr2pg6e3h4sqnq20nh;10000;1;10000;0
680;bc1pzerez5vs0p32q8q8xen85dyzf0d0k9dgcpph78lfvlu7ygjuvffqeu4prq;10000;1;10000;0
681;bc1pmq9v5qdhlr8kn9k73mr54u0nkywhzuhpjuue6thzpn9tw325ftqsyvepne;0;2;629352;629352
682;bc1pafd43gx7072hqsfpt6eqag44qzznmcxuscqdnf9n7t3h5yx8fysq35mgdd;10000;1;10000;0
683;bc1pyz5jgjkp4ekm5y632qjyp4ac0u7mqmpv5tp80j8dx4k0q5nyvq7qywvrc7;10000;1;10000;0
684;bc1p9dx2nnlcz6ttztedms742ep3vjgj6wjn2g02j57q24u5xcha7jxsedrm8c;0;2;690652;690652
685;bc1pumwvf00ds66lm7xezuzne4zv3w057yg9anrsypvzusq0mkyelrvsem964t;0;2;52146;52146
686;bc1pjplnehpry2yef2j7qapk7tq6zyg3eqktr6vatv2px8kzuhwfzhsqwhhkum;105940;3;1283866;1177926
687;bc1pkjmgapztewn6r6lythn9aslkfl3wn55ptlhaj20y4nrudant5ums0hks69;181146;4;1013544;832398
688;bc1p8zjv4zhptcp665545czlvl8aa6dzqpxlych08dhsyt585ckerz2s5vwy9w;10000;1;10000;0
689;bc1p53dqretsycd43fud08sj8fft8r6pcnc3q4x29qgvrdwa65vzsvts9mc3yg;0;2;168700;168700
690;3QXRfzCPruHxBPfJBjuztjUSmoLcHVJzks;469529;10;19743263;19273734
691;bc1p0d4305sh2ef4uncxyhxxwkw00p26pc2v7sv0gqxu9nfdkd4fuxnsupn0sk;359112;1;359112;0
692;bc1p632erzhh0aqmx6nrqsusvesx6guj8sgtylg85n7ekp3p3uq8ky2sxwzc9w;10000;1;10000;0
693;bc1pa6huymju7ue47dahqq5v2dedfhgp5qfnrenkds6nsv7xaje84drsdpyw5p;18276;28;8506902;8488626
694;bc1px46qpecpwskjfd4ql3c96e5pnkrktl5xe6gx2rr50xj3dge3cqts4h65t0;10000;1;10000;0
695;bc1pdas5v0j4h5lv9vyqh34fqgu8xv8frc5kpd5t2rxpp4lakzjg7xnqh8439c;0;3;151592;151592
696;bc1pes09df3szywphk2epra4dvzccndr0mvaz8fsl3xd58dlnssmw6aszptqkq;0;2;248700;248700
697;bc1qm3e2c0zfg5pzhp0dd7rmydz49fld39rgusua58;8000;4;8000;0
698;bc1pmlh42sqkg46hftdtgjchkp0kaw48qhmg28ch7jq4gg9dksln68tsrdgrck;0;2;95671;95671
699;bc1padth3wseagu7cxve07anmwrp26tx5fzhp05d8j0hpmj3jz59apxqrj5c0a;816830;74;38721637;37904807
700;bc1pjp44cauqhqqq9n3d0lmcwh5hv6084tjx252egrzf4pgxaq9mtq8sskwkjq;1376280;57;13231766;11855486
701;bc1pxetw0waxjw2434ew0x2r8xnasr0unsh2zxtgx4qzyk7kufyrtw5q0ztj8w;10000;1;10000;0
702;bc1p9dvnlpucjhqqx4n3hwzxkrfld7cskdlkdd8deq9823jwp5pds2equmhmcv;1638;3;1638;0
703;bc1pkp53q9e3rsfnpelp2snwdyhp82a5vf55n5exuvlnr38v50p9vyxqcskjag;0;10;1843164;1843164
704;bc1pf8ac8w4mcz8qjzks32lc4d5jksywv7d6ca8kt76tzcuqtcps9u0stc7kex;0;2;690652;690652
705;bc1p06gpxnguluv3xlv92f5djgdykjes3efgcd8w389syk8u5m4hye0qyrjjgk;733730;1;733730;0
706;bc1pp364296m6pjryxa7ntapjfluy96u6ayqepmp5xx3zr5r2g55q75smw77lc;10000;1;10000;0
707;bc1pcma20q2pjpw9899r56vchse4k6r4yqp2a86q0cseqlv4e3pgr8qq8z38jx;733730;1;733730;0
708;bc1qh7r0xkzx7dphddnd697ufhhvykw0ptdusyasew;959126;15;12681441;11722315
709;bc1pm089wn4m0zc03kq8p2rlflygmvl4cyg5epq66wctehfrdd07mhhqnkrp83;0;2;538700;538700
710;bc1pzw4nq88jupn4t2sz97he20a0dktn4qylm2rklvfhswc6wj7rtzyqr8fput;0;2;1561000;1561000
711;bc1p96jekn34zv4wqj0p4vfgmqva76xhx0zq7fm67ghhvrerupu63evspkggrw;192146;2;453892;261746
712;bc1pcgh8r79gflq8j3vwp3hf8kp8666dzca2eqlkdaxhnq5es2vwz66swuf355;0;2;751952;751952
713;3Peo2HfF7cJMTCjyrpyWHyDcdkZu1Gcdz1;1129052;8;5105081;3976029
714;bc1pl9pg05eal2xf3fk4cmq9zxmcw0ruhk822j5g8gsgkagrcjs3kjxq7u7xvt;10000;1;10000;0
715;39RuQ3Pkghavrgj3BvG5CzPWhxFwKmX7T1;1148421;13;14051036;12902615
716;3GrzDvtqRXA1SfGJP6WeeWcPmE1SK4hKjh;9133892;4;18401938;9268046
717;bc1pymr2nrtmpz2lkatyw5za75ulx3vpdnayugaxjx2nuz20ef7gfznssyje72;7150400;231;7150400;0
718;bc1pd76tgdqr6syxf5utsfwwfmvmwljdggwr6a9g5x49p2n7r26rputqzvk7z4;0;2;722481;722481
719;bc1p2cqnpz6sjt7yqknwh2d8tjlm0mumnvs0k0zm0azzpu9ywvycpdaqd0x3hf;519922;193;688098;168176
720;bc1pmz7equwaqk0jtxrnc4ggl84ausmn78q80hsa5wp8atd3pkcntllqa0et0z;546;1;546;0
721;bc1prg7g4rwtmjr2wydj5ejfwcwyr78k4ths80xxxzqwdzps5p9vaxtsn0pvaf;10000;1;10000;0
722;bc1peae4z9k334sc9gpu9u7pyv9p8p4yfl3c29vdy8f6vgryfay8evus3s6jyt;722481;1;722481;0
723;bc1qsscx7qhgf9gwksje0zltgyrw3ztvfl9x6zj6m2;49822943;9690;111069831;61246888
724;bc1p5k8w6e0u2ccfqnrr2q6zkfu44esh5r399s7d78ul63em8ltvmynsd675nq;3822;7;3822;0
725;bc1pywgvtnr6vsjanzkk9txxtpgwnpd3j3g36eccscyu8rzt43y6s6aqtjg9ng;0;2;629352;629352
726;bc1pnrr7h34c27vqzfnt3f75zdq6ctwc779k2fegkcdq6y3pgp0wwx2skv86rl;0;2;690652;690652
727;bc1pu6akh9xu7ew5ac9cxl99j4epnuj6rda89w7skpsex28adqvhrm8qykfmx5;0;2;722481;722481
728;bc1p3sasu0afhhkk4yepxv6qvrhrxzgdkxg5eyy7hj2tfggglcqr4w7qfhrg4k;1092;2;1092;0
729;bc1p6a9h634yycfy900ysxacy7t004u0wq4h0e5pat9jh00kfzu70e2qdea9cw;94692;1;94692;0
730;bc1pjjguswg0mvsw5up4j25pd2kqhpnll0serlrwwryhedjdudwcf8eql0rpzx;26684;58;42565;15881
731;bc1phpprua9v6sucaru4dfwd4gey4aspml9vsns5r6m2pg4qurgmk8jqs0czjk;3822;7;3822;0
732;bc1p57pk843l2fq54283dmxusaaptl2l3h9pexsfra4jwmkh6fyarjaqrhcl3p;704886;4;3087864;2382978
733;bc1pq9eqdfkte34qfel5mndej4fhu0ndqp9gzz3e7tg3qqw4lq0g2w0s6utlt6;13963838;3095;2375020823;2361056985
734;39N34eTRX8UaVDU3QfqD2XEg8n31fhnTYA;8800081;7;27756400;18956319
735;bc1p389dtrgk7s68ld9cpt4vxkhzhuthhznlcfyehxmg4td4e6u8sytslxgumx;0;2;231600;231600
736;bc1pq29773c345gn829967qs3qez3fu7eaw8kntqsy0av27qd99ttuksa2l02d;10000;1;10000;0
737;bc1pr35gxuh90xdcz4v7w8paadtegzm8hggq8atpz0gx2uywrkx2n8tq6zaqr6;0;2;10000;10000
738;bc1put52403yu47ltq32t7esn2r620d6mdl7487lhlpdwj4hq72zt3eqr47d88;0;2;751952;751952
739;bc1p6rcgczckyzsx05s5e9qa36nx8xl9za6mmkuk5vjxh7wa5k3vh67qg25an6;31600;1;31600;0
740;bc1pzpcl3eftvefekxhm89uvekt7xfvnz08rzts6nskp56cdcha89uns47yfhv;359112;1;359112;0
741;bc1pnr4j8qsu5s69u25nz5gft0sxt3dm49hzjqyv5685mw05nhgvnxjst2wc97;0;20;7944261;7944261
742;bc1prhhslvh4jz0z463vztvlkcaxlm6wvvnv286uvzncwuzlfrxdm3zskyj556;546;3;10546;10000
743;bc1p3hzukfguqt7zsnxvg8h2zj6s0rgph48c2waftf0v6h4sssqkapxqk7hf6d;359112;1;359112;0
744;bc1pcqms2fr4ytkjda0svyrn56h0glpzq64mflerae9ku38rjluxusxqa954sh;6933056;236;6933056;0
745;bc1px3gjtev2r7x7fevaex6ewnye2czl7chnxrccaka5w52cz0vrlf5qsrtwdf;0;4;272538;272538
746;bc1pp8e29v2jpmzquzdhxqfw0l84495pj83eegec8mcgrc2ycqtdhk0q3dtxrk;0;2;733730;733730
747;bc1ppk6j6wh27g94qp7c5rttcz0ez8ts3cl4tlzqjcuwuaxu63d77e0shkygwh;2730;5;2730;0
748;bc1pqwyf9yhg088aa0f7h67e9y38rf2sv3lp6t83ghqdcy4pwxcqy2lsfavz4u;0;2;538700;538700
749;bc1ppgu70dg6t86xs8n2s5t98h937da8pmy9ft2lnwg5mn8dejllw37qffhyfk;7457640;205;7457640;0
750;bc1p5yf9q8clrz9gxva275m84063vwuf2kk9spuyh8cs98s9pw0dupcqlyvca7;10000;1;10000;0
751;bc1pl35wn7k578zg55exz799m6v6pnu563wg34t7yg7jsnmxpmvw5fdscdsmvu;5864120;198;5864120;0
752;bc1pd43dlnznear0xwsyggrgdkz6ukave5q5d7csjpjyk034f9a75f9qyjzugm;722481;1;722481;0
753;bc1p455e4p8haauxcz5frj55x4anjlex0n5cgar3cxpzhz8cr78zm9ksct747e;10000;1;10000;0
754;bc1py3p76c7m74fpzamef7tcn936fmvjudrfr042jnzgr9td9t8rwxhq0pxdj7;1042175;29;7188627;6146452
755;bc1pfuwsxyc9zg9majha0racpncete6yvt3t2vx5pynwtzf54tnt2k5q4sfl45;0;2;722481;722481
756;bc1p6wa9ef6jmwx2mppdu87ldrp9xv63e6q9k2y6v82265hyl6sdfs0qzlrktd;6760344;216;6760344;0
757;bc1pcj59dhrcxexfs6whuuch3t0f7ps2g2qjcl8qzhfrm4am75v5we4qgyjsry;116146;3;554838;438692
758;bc1pjke4vryfv4mhyt47kha443cweakcd0v0npdq85qqs36z4mw3mjgsx42w2q;9615889;483;348410484;338794595
759;bc1pd3c6c6purcyztxetfcuws8t7qnvnn2csqzyv64ydtrcue9asjg0qxk77gp;8632488;223;8632488;0
760;bc1p4vu8uw0cfm2n57h0hy8tgfe4urgj2vwyj4fnmlnjwnsku5l5ejrsdy44sz;10000;1;10000;0
761;bc1pw302ztwjczua709dpw0zd7gc564qumcrl28euk6jg3dr4mw28ncqs8at58;990179;672;36575032;35584853
762;3K5NVgPzcmfPy1XZwqAwDdwJEAQwC5EDC8;700000;65;54972266;54272266
763;bc1phwv2dx28medh7lrcgukkm8r55r00mrgc22uj2eshyrs72nexq9cqzxp4y7;7992472;233;7992472;0
764;bc1pvpxmvjz4wcsj0etqr2xx5y9te80rvlk77nvzgk5nr6pvrpvreapsquzeyf;10000;1;10000;0
765;bc1pqnwkvz3emgfzdkvs7vl9dx3f0j9zglqcjgvw769neeghkyeqfjus6rkz6x;10000;1;10000;0
766;bc1pm6rzdl4px6ae00v9ppkmqgcpuvkz4hgfrqejhsuy7cfyx6c9yqjq7z765w;10000;1;10000;0
767;bc1pazcemt3kst3lzv4yu5nkwnpj6902n98erdhy5dxedgvd20qla7vqx3fm3m;10000;1;10000;0
768;bc1qczzftt9f63afelmj4trhdtzwfgxlndzxyzjgdg;587647;63;13533657;12946010
769;bc1quc44lrhwst8eyqqpz2rpxv2fej98w64zvcg0y6;60887;32;60887;0
770;3D5JrnjTbURREXP9NcJ99QgWinRAgPExAM;3887579;7;20293570;16405991
771;bc1pufsv223u603w8scwvfrfuc6w4ccvv8rc8veh0ly6wd3f2rwm5ksse74870;10000;1;10000;0
772;bc1pqn478ysl5dftda4y5eahh684g2ld57nd0w7ppwegw9zktjmy8lkst37t9h;0;18;6405532;6405532
773;bc1ptk5pfperp0y3mlqpgg6x49z2d2hj84mxfxs5ggzdv8ejvgsxjvkqkwayru;733730;1;733730;0
774;bc1p63vk0jx6sl58wk3zg27szzeerltapfx38ey8357q3gh2uy8qle4qq6r06y;10000;1;10000;0
775;bc1pvp7pd3f40atvl4nhgyje6nrgd0vefcq6ye5xh4xrp80kwul8r8mqlr8gne;0;2;727230;727230
776;bc1p7yspv97wjaf49sykurce46s8d5pwwq7gf2y6c5hhzflujd8wm4aqrjhpfq;0;2;57845;57845
777;bc1pg53xp3wl7slwxzs8fmdll72gm8n58ugewwxst9860qdvyfehaujqxxquyq;10000;1;10000;0
778;bc1p6256x7zcasns3945t4hkc8c53vkn650p4fpeccrjchykpcekdfnqpwh59k;0;2;10000;10000
779;bc1pxjwwmsgzx3rltczdma9drftk7qrgcegxg4x0yl6z4mazalj99mtqandhm3;707595;4;3099732;2392137
780;3G1KSD5KARBbmxatYdmqKwCxF8DV3bSyG2;574480;128;169723705;169149225
781;bc1pat66l53vu9verww9tequsl9afgp67c244yf8dg04f0xrut0u3z7q80qz9d;0;2;368450;368450
782;3Cn8ajUPSiGiVN3YKAqfPjivfipv6YsVGp;1826177;4;4435048;2608871
783;33Zgtzgoy4rZtQ8nxNR15ajg5UvqtbvKoV;106836;4;2479092;2372256
784;bc1ph6p02yqg923n4grck5zmmztuwpmuss3zj0qt6gcmzrwkd3d87kxqqfye5f;0;10;1468161;1468161
785;bc1ppgar57w30j4jugj7agt2rjdu0trrz3xf9fg95q5t9488fkufrhhs0eyaly;797379;2;1639650;842271
786;bc1q5g57sr0aq3kac0yskzjprrecex2nvm6pn4x4d9;549788;297;358587022;358037234
787;bc1ppyxkv9htc2kf4jyykg5qyg02nhzprhetvl2xa8jkl7ra0pa8e6mqqju3ta;905100;2;1880100;975000
788;bc1pq6t2zyrvzhtr6vydlq6ytaljf2ckpytrthgme59aul3aeuet335qea5f0n;91546;1;91546;0
789;bc1ppg7yy888rwd8la9zkrea8sv8ukcat7uhpxffj3jzhpuryz7a7e4q4z454z;10000;1;10000;0
790;3928ALUXohYrWgakEieTUu6YahJURatEuW;6983;53;4995322;4988339
791;bc1pjfwprqgr429xy0jgzm36wuz3m3z4jy0k9rgw3yhthva70sulgccsa0rkh4;4651648;147;4651648;0
792;bc1ptv03sce23tpp2s2vksgxskhx0yghzvaz8h7yjj9q25hk4qx9y0xs77sf47;44907;116;6245395;6200488
793;bc1p6lydg9jqglyudfyq3qdw9tlg693xpxjdmrvlssa3hyhvzm8u56wqkzg44v;0;2;796590;796590
794;bc1pk5tc2qrp4g5g33608hzzarqa3476luwgnspa07kllgdqwz0p2dmqun5xty;39246;1;39246;0
795;bc1p7csj7gmsatjkz5z5nf3wu6r35hz2sqnfqfzq6nucr4rw76h9yx7qmam5vj;341794;2;727620;385826
796;bc1pwjna8h2epv73aa4atmqfztm9mj25f957vdemprn7ezukygwcrz3sm5xk49;4729664;147;4729664;0
797;bc1p4qaj3jj3sy8ncuaa230zv9nfrnpu3xxlq7x6aqk40vg9ekz049wsm3cdju;546;5;1638;1092
798;bc1p97tzhadxh5ns7k3jldk5lq7auuhlxnp90rrt84xqwcq2qyal3s7sfjy2uc;4305920;139;4305920;0
799;bc1pnv3ptg0h6ze3nlfxn53u9rwjvjfqvp9h5yjmz7k69ds7gtl3zk2q4vl3te;239000;1;239000;0
800;bc1p80y7x5xl54apn0d30gt7n5c5dmv7yr2nvz045u3jqfsfp0rdy9hqt5l94t;10000;1;10000;0
801;bc1plm7jmvw4ts9x7clj5hgfsg7xk60t5lxkq6e0wql70pg76dxzwlvsjh0ks9;7098;40;45094;37996
802;3LWnPNX1U1C2KGs5eRin2Ce1kHv3wh1UAB;2217141;6;12324957;10107816
803;bc1pr4d86gflrf5qdy0xuck7r3p5969xjnzjux5qgwydr525uva5dwkqlgcrzl;390521150;7850;1026187925;635666775
804;bc1p0n8qg77du2xpxjfknmuqxpqfgc2jepwgv9e0lzt25zjtk3c2008qvnw9ea;10000;1;10000;0
805;bc1p6ll3wrhxhsjdhdk8m9hmp8sh7zzn06kmxk3ja28s0769afa3gwqs2g6w97;0;20;6860919;6860919
806;bc1qvs2hts5u0mk06ayecd3m85ps5w5emuxtlxeg9x;46010318;9567;104442666;58432348
807;bc1qj7fx3hy6e57nvkxuehan9ftjfvt64klmexg4ck;387184;93;17237540;16850356
808;bc1ple3rygdvarx2zwx6cp447gcfghkcz5nhpjnyd0qyj3n80jdg2nnsuxg6nt;597858;342;29278067;28680209
809;bc1qlwkzknph2x82s7tv5sg54ac7spz4hc8fkfv8f2;335568;2;377514;41946
810;bc1pmwrylm52y40jq9vpfm73lnqasyha2hjmsjzutpqcammm04ccf39s30trly;162254;1;162254;0
811;bc1pgm4w07z6n5e99sf0s44xrcg5pndf9k0040ahykc4pq5vgrk2ltlqwydv96;772052;14;4527632;3755580
812;3QwnfBkUTJevBXvw6UQGTk1MCUrP2Qv9wh;645734;4;3796288;3150554
813;bc1py97wrxtyuf6qlmzphrsvs7hyzsl6yp90443dm70k2mlxgxq73jaqk3xg07;10000;1;10000;0
814;bc1ps0wjhf8plz5jzym4tmnkxga6ywtyw7pnaxagckxk8nyqqhgqmyjs7z28lg;4003625;1525;415062579;411058954
815;bc1qak0hf9mhqr5flr92cvfdrluv4tccf2ce0kfnyv;810624;1297;266172344;265361720
816;bc1pz0096ngntkahgx3xx0sttr9c60vuqr732937eyddrdeadcjyh44slyg75z;546;1;546;0
817;bc1pxsdlh924tzse7mauj6mltnn7yped4xdl4ncnmrat4j6l0vtv04ks42q45u;4321389;10;21586588;17265199
818;bc1pakp6eqsnt7xefq7cdeym6peq5cfyxw60xsngll4t22r7pwqmu6vqxv7qu3;57745;15;18715548;18657803
819;bc1p0jz7v8m359jsjexrtuu4knq40u4h0u0flgtakp32uef83zuk5lfqhh0mlf;0;2;947554;947554
820;bc1pa7fpqe4nxjz5vmm2sdnhy2rj76d0tlmk37pxfqf9k4qs3n2qpvyqfw5wd8;947554;1;947554;0
821;bc1pyajjh5nnqlqtzcmrrfq0lmm0yc8hu00y98a3xlvw8l9sm6hlw8ksekvx2w;455056940;22;1282139676;827082736
822;bc1przj87p3ckcvjd5su9s5255qz62xkqu60wkkhkgu24skq64h40dfsuhp7d6;5546;2;5546;0
823;bc1pcdh6la39z3lyy80c4k0urc9avzu9sx96za6pt0je44rlxea08guqhs7vrj;10000;1;10000;0
824;3FETze14Fco1ZiYZcBEVortGi9n2US2kZJ;3086070;10;18139264;15053194
825;bc1pynhskqqrslzgd4xdye7e0d9z8rr7xtzlulyu6zz5fe9puqpu8dmq8g236t;14000;5;14000;0
826;3GxXRaPBnMYKLDjRaXhpJeAhT1eB6tXkjL;42090;13;824574;782484
827;bc1p9wtcefrs3952twptfkqnrlgstrxjl2z2lh9h8uc5drcjezrxk44qcay4m6;121161;3;495063;373902
828;bc1pfzlffkxptdd2wwmkde5z2ylryy33percpuw3pp4awywdjpukxlyshz2t4a;752487;3;2392137;1639650
829;3QZxZaihVdw6zbymEyj2JqTwURVEfwF9DB;8413828;3;14888828;6475000
830;bc1p9z3c0e74gv0hzjaxannvmzen3v5ze8989wual8put5uzxklgqj3qr4aent;30448357;5827;9369852958;9339404601
831;bc1pcgk6mnlyzj8c5tsca7j0xfgcrgqy7p95tj9uxrea72vyrjntc36qwdkqpf;1638;3;1638;0
832;bc1p3rds0g2t8f0lz88r5admt8cy8m9clpsyt7r3uryfe7es0550hulscz4zk0;247796;3;872388;624592
833;bc1p9srxdqx7u4u48ahj4s5gd3x5m932zm4fc4a4ds5ncm580nh864jqm37k26;117134279;7874;409568377;292434098
834;bc1pl64edlfjuvp0aj2hwanns945mw6xhjmxdm8aq0z6eejtgsccgyxskwa2ue;857148;1;857148;0
835;bc1psq2a2neynthy86qj6twjyu5p5g3dddla6fe8jql7uykec0l3lkmqhg6xlq;947554;1;947554;0
836;bc1pf4xrapnf409vcvj5km7cvjz62sxqgut7t7rydhrwuapasaaazw4q25dt0u;142919;1;142919;0
837;bc1q6fmqp3ytm5nzqv00amknm63axjue2ueq3nj90k;59528751;11407;143154320;83625569
838;bc1p6k9nhhnhth0aysa4c5dr0fajdhtlky0mwapervdrym7d2dy6sw7q6rhdwp;7642035;7;12901329;5259294
839;bc1p9ygwlstc8kqc53dnv5lkzg7xhnqvjrq6fr60uqvrz35pfemrmy4qa5sryw;704886;4;3087864;2382978
840;bc1ptjc588wlujwmlpp5jk3kk8cqt6332sftrygad662cchq24ryypdsjz8dp5;0;2;796590;796590
841;bc1p0a4mdzwxqtswr5dtncsr5y895c45usszfsxvegka0ute2ftgdhmsn5qas3;312774;68;17230474;16917700
842;bc1puc9mddegqa8mn2jt387c5uxk3k87vuve8l5t5mf6xlfrcuthsntq40evl2;30808;3;2005808;1975000
843;3PDKb2wvfAfnKePrNdCJ3fPaTTPnb5b8Vs;956100;3;4949566;3993466
844;3LUkhXW8BsH72obNt7dpKAzfnbQsv7GtpR;4902022;6;5452022;550000
845;bc1p38ec8mgz0dlmr2he7ncxe27ggpagk2kjjhyhukezaktcf762f9jsqan6k6;421946;1;421946;0
846;bc1p7up65lf8nyreqlwcu6rxnjteww0jre242hqs3ldf20rr9ke3qnvqfxnzgf;2547467;610;168592856;166045389
847;bc1p27lgj3jwy4g0g6u5ja8yq8s45mx8tv395vlh5nghc0ypwsdj3cuscmxqcz;3011770;4;7118770;4107000
848;bc1pru4vxmfdc04l65u74zt3v7jnm5f3vta3z0kr8tvcekzjgrc5z09qgf30z0;546;1;546;0
849;bc1peka7dpfpyf2lywxdc88pv7v5ggwqakglhx5xgmjpakge7xhrlj3sausmfz;0;2;947554;947554
850;bc1py7shwv4wdr537ugtm0pstq0zzn5ckncxqy7gtlekj2ll3l6h0xeq74s0ze;139000;1;139000;0
851;bc1qpnxmjq00zse7ydppyarykhh8tm96nl7qvd2m5u;355363;48;14198261;13842898
852;bc1pgxxneupz9qkmyctudvpwd6lyhyca5rqwh84s5mr2p08f2pf60ewqtmww00;797379;2;1639650;842271
853;bc1pgeww90zjy99959pw7ddypv08hglf55ra53wa33vsflu50kjdu0zsrjj3dm;258243;1;258243;0
854;bc1pdg789pqqumqwke07le5msvrhhhpkqep2yls6sxq9wk25f3p280tsjnpfck;0;3;140456;140456
855;3J5MN4JRQh6bYaMcYVmhxqEACn6RPX9W1g;653528;4;4645806;3992278
856;bc1pj68lhgxlgwsry7skypduv3en62p42352clrgcy6nvkn5h64stxxqgjmfn8;546;1;546;0
857;bc1py9202ty3nmnk3fyg5d9n0mckfn7vecaaduf079m0w46mk5vjyepsyx35g9;2741892;1;2741892;0
858;bc1pneqf37py0tkenyzcl8mr7zy6qxf8wn04yxvjfwnr97p4cs4prchsdtgjp0;100223;3;1068291;968068
859;bc1pymr2nrtmpz2lkatyw5za75ulx3vpdnayugaxjx2nuz20ef7gfznssyje72;3815456;149;3815456;0
860;bc1pyhn0kzh27q54yweeedr9ctvra3qvtrk8fqzzsnsd9u7xz9s2kuzqylr3jx;546;1;546;0
861;bc1psv64h3zyukfvmglk76mqrt975xvcmzdvp82estyvu6tlpy2eq2cqvrswka;87349;143;41989368;41902019
862;bc1qschfcda64ky4mr80fheptj50axekhyacak9kqn;47562881;9578;106729999;59167118
863;bc1pgjgfthp2a0gh4x3w5kukkgtvet4sta9slpdkvd55uw8md2pkqnds2zy835;1912;1;1912;0
864;bc1pdyawt00wrxzvg2ul0dn0vu9c99j5enmj7kq868gcp86u3n7zx4kq43x5hu;38646;9;774033;735387
865;bc1p00lw6uhfmzqm3z8eza843hr6yjullchedjv4fjfksr2gjtxtlsysnlvfqu;1759591;2;2259591;500000
866;bc1pempq28s7y599y6llqrmvxntzmcat77s95234hu2p06f206zx0luqjhlxwp;398081;9;4914009;4515928
867;bc1pnqrctz43m6evvgth6lkwgutndn095ca3tj73f98u47v2y9xlvw9s43xwhw;2856;8;2856;0
868;35RQnPt1tbq9KuyZrN6Eb17RR3U4mnBEk3;9180289;3;20194321;11014032
869;bc1prjnfdg7feev0wywklrqwfz7df9mw0uknacf7gsgnhvrl6ywgdxzqevexrj;0;2;947554;947554
870;bc1pnr7xgjl8hmdh94d05tyv7mv0qkh54hflfgxgytuj4w0txfqyguqq6umn7q;2184;4;2184;0
871;bc1p9atw87uva52gwl24x5m4nz7tncq5l2mhvfd4qck42lql2wp9n3yqr6zq4w;546;1;546;0
872;bc1pwnvh0tzpzh22d2undq8qz3usdph6cxz5gykrnnycdtps5a24lwrskfcxlp;10000;1;10000;0
873;bc1p2vzehr620z0y5rdt0pgfz4yw9e000zlcfztxtsus8x5det870muqs5m59d;302406;3;1041378;738972
874;bc1ps7t47vfnw28k77kaht3lr3l636gt5us7e9pspuv9ygemyjfjfruq2an7sk;546;1;546;0
875;bc1pcqms2fr4ytkjda0svyrn56h0glpzq64mflerae9ku38rjluxusxqa954sh;4523888;151;4523888;0
876;bc1ppgu70dg6t86xs8n2s5t98h937da8pmy9ft2lnwg5mn8dejllw37qffhyfk;4713976;129;4713976;0
877;bc1ppfut5tr6ut22efn4fwq8sqcz5d0nhg5wgm4awwjm46rlf08e66rsd0ljmf;30808;3;2005808;1975000
878;bc1pl35wn7k578zg55exz799m6v6pnu563wg34t7yg7jsnmxpmvw5fdscdsmvu;2570440;122;2570440;0
879;bc1pkpwwwrn30nac82ngjcpfmzxjt6ew8sj4jru7gqxh0fq2dld6teyqnj04v8;10000;1;10000;0
880;bc1pp9n09sttzf9wqedycq0wpu5625c5rl3wavx5t9vvfm43377hwc9ss6dggs;0;5;345840;345840
881;3JTRFGSJvJPx7tju7oTRozvYsqCcVFuuZN;6921639;9;21866394;14944755
882;bc1qws0tr4jlw034e5mawt70z28ecsaxyl86pefwad;10000;1;10000;0
883;bc1prfl9wpj4cfp0488zs86demlw8len3vcvxvytzyts43fx70flzuksmsmssc;368450;1;368450;0
884;bc1pnx4mcqg6m08m5ctg07gczdt7m6tzshkqd04l30c2vmz2tq9dnqfsn49jdm;30808;3;2005808;1975000
885;bc1pczc6f4t9khmrh2v8qfqwf52hmppfm2rfrqhrqmvlykkj0gxll5xqs0tvwx;546;1;546;0
886;bc1pezxuka4e6har0maxsm6ngumhr4wevrcx6m8jxlegkt2fgnqme7tsvsgx7d;1092;2;1092;0
887;bc1p29fv6kfdecqazggy2x8wuuurf7qlwj562h5sy9p29yssh4ekr3ssq54w6q;30808;3;2005808;1975000
888;bc1pd3c6c6purcyztxetfcuws8t7qnvnn2csqzyv64ydtrcue9asjg0qxk77gp;4457152;134;4457152;0
889;bc1p5j7xghwt6c5y69agjhd0udlndp9fta4mnrnup7zrglukmvm26zss2n9vwd;505409;5;2869325;2363916
890;bc1plqd5u2knqjx5yh64xzdvpd7ca7p56p3mv4p7kg772j55av4vvalqw7fpyq;0;2;551225;551225
891;bc1pcc0et4v8np4te926lsc7cxp696ttdjunkwsxstkq8yzvuy9qcxssvucdkm;78192;1;78192;0
892;bc1p86qu3gsd9ktn4gehhpkywzyfde03pcaeczdekgkukx8ngjv0g5vsahaqsh;10000;1;10000;0
893;bc1phwv2dx28medh7lrcgukkm8r55r00mrgc22uj2eshyrs72nexq9cqzxp4y7;5372984;156;5372984;0
894;bc1p5d2dgl7k8g2lkfytdrgs0ep4u0gy667y4cwudnjeweqmvlnv9u7qzvk57j;546;1;546;0
895;3CAKM7AryNsjbp1zztDyVBomtEQFJjiYqz;5419258;3;10973216;5553958
896;bc1pqx4h7ddj5q59rwyyq906fdudye6q82jk8y6t2hgcmelavc9e5llshtxl5j;879;46;29735;28856
897;bc1p4v9fadacj4p6yq6m30d7cjzvz9tzrjmx4cpv63ck97hsjuz6puvswskyku;257405;1;257405;0
898;bc1prfq7pft425tzrdh64g0322dd6xf30j3wun7tqzy5clv49r07fjxsmd4smw;667078;1473;723789625;723122547
899;bc1pyqgpxsj8xevhh8gne26ref6m97p63s4y389v75pl63l77kt5dpmq5w9f6l;10000;1;10000;0
900;bc1pjc4y6s2szlp97eurw852h6glzqy4zlmrwc49hdsv92gr35an4cas9z964q;1092;2;1092;0
901;bc1pyun8h8l3p2gxg7ywtc8jt7477ktc7lqqj7m646l5hlhvr6vvp5dqdzmkp9;905587;130;21161231;20255644
902;33QUuqpssxKzDB59qqS6dUmFHGp6VEv9EE;33124301;130;162606433;129482132
903;bc1pzsn9jcj3fnkawlm4ytk7lktwc03u8f28zqhqpkgfn8mh2ksuly8qjen5d3;546;1;546;0
904;bc1pe43mnagfl9rrxe6ctx8x3ywjtlldu6hdmqhjszvhhvep33xtl4dswcdzt2;4051425;8;11180309;7128884
905;3JwNhgGE5sauVgCpuUKkLAFY5H4waCCwv3;138126593;14;290769736;152643143
906;bc1pln234e30qmxjz4lpxvula7slwruwjuea9r6k8d730ltdm9ss6ymqd20guk;3135005;4;7559414;4424409
907;bc1pdsmmt5rujsvpkf9cjqm4k6l36fdafkjez4hvlz6k2tlzlck4uv6spaka7g;1422;3;1422;0
908;3MLni3AsSVcoj1sahUA9hoNZ3HUWpNibZB;440125;5;1240125;800000
909;bc1phfz97muxly6e4zqvey93ge5v3c0dtr25sc8u3px8t0q3wkhl5svqsxm9u9;1896025;198;32390307;30494282
910;31qG7XByqGHtFAtvWu3wMvpQYM8D9sdzX6;3967715;193;265337621;261369906
911;bc1pse842w7tagxgst27pxj7zp2cwfzp369gjgwek8dnsnv8h4hqzw0s0rekgu;275784;180;281790;6006
912;bc1p2htmywm3plx632zevx7rht848jtzxlfjzztx3zfv65h0ky6zefjq2fzaj6;1638;3;1638;0
913;bc1ptcp0gr73fjjhylh8rfw90qmx2hale8v444u4a8zvvsavga7a62uqzqyh2p;0;2;34215;34215
914;bc1pnm3jt663ka6eypmj83cruv0n0s9a9jwvlk42ve6kn4rg5p2ppg3qh2y9x0;1262584;979;289614950;288352366
915;387QYRNWaYi6V2nHBXuckXF9FubkkEcN38;597826;15;5987866;5390040
916;bc1p56emtt7zyvgd0tpympt5eeu2l9fp4p0le5t44dk0h0w0yk288hdsr4w7wh;3822;9;4155;333
917;37LPdjkvJ9DkwFA4r412ZtgmGYiZxNh4fG;1920932;343;263084556;261163624
918;bc1pvscds62duvt7cd8wutqg5rwnr8t9js6uk6r5rdqmf32e5fdxe6qss7usxh;128855;63;9519160;9390305
919;bc1py7dyy2snkkmxt5u3mc3590jymh6j7d2g7lv9fmyd7s6679hvxq0qpfu7qv;1638;3;1638;0
920;3JoB2H4vdxLczWggkNcAWVppekhTBVUZLP;875153;33;44363186;43488033
921;bc1qdkzx0dnzuyzjlu7qk86mc7rgkpwwms6zg5y5gd;474050;5;4580358;4106308
922;3HviETgdw7dsCpU2tYgU1LzppnHFMMURJr;1398476;7;5580724;4182248
923;bc1pf50knkez6aq2uhzhhvzf0gppzmq3xfy7jcl2mrsu7q6fc5fc085qaf6zdm;1638;3;1638;0
924;bc1paspze7azxfl54yzd0vxpvw508ldqf9jx8dsjwr7ypt9r68yq82us4aj2ny;701766;2;1448252;746486
925;bc1pjfwprqgr429xy0jgzm36wuz3m3z4jy0k9rgw3yhthva70sulgccsa0rkh4;10789120;261;10789120;0
926;3CdSJeequ9HCvTm7tSsfENfQG4uPK5jE5W;43979086;6;139998208;96019122
927;bc1pucqgp4dvg8ka8696024tefnhe8f2pj48z88m9xtqns98yl2ed7tqm9ryw2;168891;1;168891;0
928;bc1pp9s75zylplttsdpw6w7qwcxsq3y2z5z6gcpwftytufp4wk25a9fsv6fv8p;1422;29;1795346;1793924
929;bc1pww346wye4wmayn2d2estldptpqzlh3dvcssq9af27pep2mela3nqcm9xxq;34998;2;115671;80673
930;bc1papwkelpm60hdjmwvqwuplzh9n8gedtc9hr9aw9scmzt2603fqncssfcvdy;14639980;5;44998201;30358221
931;bc1pvmn9upg4fjwuw5ncdd73mcsvmtxad74zzmhvh3l3aqm6v7dqqf8sx3n2he;77019;3;367299;290280
932;bc1pwjna8h2epv73aa4atmqfztm9mj25f957vdemprn7ezukygwcrz3sm5xk49;9035088;251;9035088;0
933;3LmDxga73NNKT6xQPbHCZ6Mnaboe3dJF4A;71938;8;960372;888434
934;3MZFE9fD9WvgbnjRsXvxRDc7LVsEq9meh8;2222371;200;71538881;69316510
935;bc1p80474uhm0ewjn0aqam4erj8xa25ah4dnyws5spzuk7zrgwxs2n8q66rmpg;33420;52;46480;13060
936;bc1p97tzhadxh5ns7k3jldk5lq7auuhlxnp90rrt84xqwcq2qyal3s7sfjy2uc;9512472;249;9512472;0
937;39sje8sewoLmE2VoR6WuxUi2mu8kJsLSHq;47574685;236;1287722222;1240147537
938;bc1p7vyspl92wjd7e40kxg3ahqsrjsqxh2m0ajzkq63an22h6ue74vhsgd2cu2;2092;9;3514;1422
939;3Px3rYVjKzCjnP1w2xw5mnaDXuFE5yz8CF;1281914;43;63016815;61734901
940;bc1pusud9x0uq5ff0qnk9cq0ztuzg5p09mrzt6vnl4nc6wm2rd2g4msqu389wm;546;1;546;0
941;bc1pt3y208ug0q9f8n46y79lhacjvq0znarwzu6df83zrdqraqs3607qwznwg6;10674;11;30674;20000
942;bc1pc8rtapnklm3autheg7z75uefj79pv95z4kx2t5cwus076q8k4sksrf24nm;842271;1;842271;0
943;bc1pad7n9pmhl8nrgypt707w9xq8yq9xccgy3vpamdxgqug0cju0d94qmvvavu;1092;2;1092;0
944;bc1pe605aw60gcqnryl56fg2nyp648fvp6pphrmnnp9catu8hk5py2ms6mt7ly;255128;109;272654;17526
945;3GWmA9x4jma4VaTnrrdu4AqivgCeYd5Jdy;1132494;2;1232494;100000
946;3L5J6xc6TP1C3pFiWMS8FQTynfGqtt4SSG;4498832;4;10498832;6000000
947;bc1ptlye056e0pmy98v6u32cwewwhjujx37mkl2r9qp4ltj05z0m5daqu9zqae;1898439;93;13639291;11740852
948;bc1pftuwnsd57wk0772ajjdj6c7w7gt2x2h3ngklecxya2wakgdr9q7qmaey2x;2730;5;2730;0
949;bc1p5p05smt3za74rgclu4wywhu43fwtx3jpn068dt3vj5kq3hm882wqf2h8tu;749606;3;2382978;1633372
950;bc1p00pumkzskl2l8ajd0jt47kdeg6550g5wn53ddz6kdxetpmy9fydsrczp0u;81552;78;82152;600
951;3LxffjSNLGkrYM36SXeX4xLTG1X9pEyBy8;8380544;27;25978223;17597679
952;bc1pdrtexfqdaec7rearkgw4r4vmcfpqe6d8ckjnsz3wcyfp66nyrgxqw8z4ma;32534;41;42534;10000
953;bc1pzg0wwgedmq3x7ka3503yd9jcpa45lv8p06xahk06emmrywh6d95qhcpq3m;17730;17;44830;27100
954;bc1quh9jm6p06nqnvgvvv733pl0g0y6ycxl0aas2t4;8599675;7548;695634723;687035048
955;351VBA7iozXW6wf5X2z3KgU96qKeeiUcFP;2771409;133;76552506;73781097
956;bc1pr977yvsggltn3pfnc29vaxpyx2ffdgz6wvy60ul32k4386ez64xqrca5yx;10382654;8;24904158;14521504
957;bc1q9uewqm7495ddfcs900yg86ux5tdzzkcphkvd9l;576356;9;2541315;1964959
958;bc1qfkeq6ewpr35d3g4344n47lpn5zcehzzd78sue9;10555118;28;219997320;209442202
959;3QC4XgwG3FSwhDYrvcLxopKqeT2U13H4hL;6898996;11;14421996;7523000
960;36P9rAJH9DqvqnLRRzjrg7DkGSSNcrZgK1;2571818;8;13659718;11087900
961;bc1qxxxxc50cs7tthu4t868gtmp2rk2jrr5chvvz7m;144690;4;898152;753462
962;3G5z78xjhAP4Q3ZNStRRnxzFXujveJqSh2;171494;2;410494;239000
963;bc1pppspff7769t0e2d8j4gg5kgsm3ge280n0hcvthjh4q42jh2pkwxsfv8dy6;546;1;546;0
964;bc1p3spffcnq5c255vcc5sst9d52vt24xalrkjjj3ndz28g8a8wk7wasvd32mh;76274;214;32998347;32922073
965;bc1p7lcm8zmt590y5g4ettd7xfmzah26rqvvweet8zl9jj2r57dhxcrsn4l3dt;1092;2;1092;0
966;35prBnzVyos72akFFbdupEspfr3QG7B8uB;298448;2;664648;366200
967;bc1puusuhhj5tu2xgja2ryw9nys9nkf827m3ge8h3d6a6a0cr3594t2q6v507f;752487;3;2392137;1639650
968;bc1pmfj2ntlmt3us6a7phxu9vnqc5cj6ak432yweqgpsekj8pusy3nvsrl5um7;546;1;546;0
969;3EzFqHBdfjqdEbsqYQZz5LKzTJC2Zat82i;4190339;23;23255951;19065612
970;bc1p2m0zgjql9dzpjw0gu3s0phvuuaj4hf4g7af4x5rr0nvngph48q0qsctgac;34737;1;34737;0
971;bc1pug0r9uuydm28s5kackscm4pjs57vnjc3c4e0kvwn23jxjg8rd0ysfuu4z8;6339;10;6339;0
972;bc1p7yxen97fsf0rlgcngp0d44hpx0z3dd9mlwkumaajmjz50gu9786qxd2dyl;546;1;546;0
973;39qZSVwr8hehBztuVKgH2jEWDZaYnEcNYg;1006933;9;6638618;5631685
974;bc1pz8v8j0cmu86dm2q4yxynz0trw24tf3ksv3gzk0p85fsm206j626q2fawx4;48610;8;7094131;7045521
975;3QytC7zA1qaBJGgpXFjaQPYHXgLoPKKfbg;294229;15;18956317;18662088
976;bc1psm6pvrewrznwqpvwed4dle5xxtdzynx6jyrzjca8tg663f3muzfqfcg30m;34215;2;113322;79107
977;bc1pcqxcztyxa6x6qlf4ltz3uhxzcepq5kt206cahcee0wm0205qf6rsla2j3t;761361;3;2420325;1658964
978;bc1p9srxdqx7u4u48ahj4s5gd3x5m932zm4fc4a4ds5ncm580nh864jqm37k26;117301659;7877;409735757;292434098
979;bc1puwv5tyk8uuykw0n3xmjjryr2qfmyc75hzqqx2tlr9cny4s9dt86q2ctuc2;312623;331;4550661;4238038
980;bc1pysc3hzreynjwnp8fpfhky3sjcz0k8z644rknet5rygqh5n2xdd6spg8zxh;842271;1;842271;0
981;bc1p5gftjfu7fnq7h4rm82c57gvehghd7tsrqhepku3pnsud6vvds3dqhrju2l;546;1;546;0
982;bc1puxh5gu63h6fflsmdsffefq3e7vs7gh04dywx42u6aqmqfsxpfy9qk835nd;5460;172;773039;767579
983;bc1p06zkg5z29s6s3mt743u3zck6j4chg65ac73rpq77nethedegkpms8g0flc;4030026;3;11101826;7071800
984;3JgxzpRyQUbmaEzwHVyJZQV4ARjcXeQcUb;613105;3;1978365;1365260
985;bc1pds4kvzvsfkvp2nyavgvp72jy02zwetxkzpsk2973v0t6f82ur99sappaax;4862257;1009;493991282;489129025
986;bc1preuq80rf78r0074rz4t04yj4wefn7th2he3m7jpck82fwst8v4zsmk0tpg;9961;80;38023;28062
987;bc1p2lnz9gxvkv2fjk38qhl6z7t5dxeudcsc95vjwsjpdy4zhu8c3jrqa8nc7p;763927;3;1721440;957513
988;bc1p7up65lf8nyreqlwcu6rxnjteww0jre242hqs3ldf20rr9ke3qnvqfxnzgf;2477567;611;170434550;167956983
989;bc1qd66tkkgsd4cvlwzl00q2ncxjymgyuqh6lm0ac6;756166;3;2643099;1886933
990;3814VkBd2mcf5WAYoT2Xasz5ak9579FsXE;53528;6;1364762;1311234
991;bc1p8ldd4rg87wn4nu3xsw43uedvdelku0lf3xfum65s5caxmk5dys7qkg03pp;2730;5;2730;0
992;32wp17bURJGTDq4G42eS6TdNQ3siiYxVzX;289481;213;72705626;72416145
993;bc1pp3n75pd74u6g95paf63g82hez6pswn8a30f4jz4gsn83jnnz0dvqjcg89u;698672;1;698672;0
994;bc1p28z08dyc0wdudh42pzna7n49urpuceg4j7pr28c8ef9t9hv93u6q3avcz0;7368;19;10914;3546
995;3NmigbDUzDQ1dPkfgEV2VbHsCqPvGPNEYP;215428;4;3756224;3540796
996;bc1p65l2ezwvs8mxs0q9t4qaxmhkg92g33tp0xdnhdlv793zwq8ffurqf6n0qz;68365;109;202947;134582
997;bc1pchx2u3d4cpepajv29u8mfgnd5j6w4ruzcr974y3nngydfku7wynqyterf9;749606;3;2382978;1633372
998;3Ahywje2UTneUmNeZsTtFW4UX4QocxPHbM;1835624;10;34212192;32376568
999;3QwEuMugqaAszRR55Ljs6CFHUf31rcr4fg;936573;33;13286527;12349954
1000;bc1ptrzc4actpcplak0lrdznd6x4reaeceznwj9h4nctyt9jkxd2xe0q85kq3j;848926;1;848926;0
1001;3M4y1pi4daTJXT9R1pucdFzddqawzDXJnL;636499;15;1788936;1152437
1002;bc1p3gm835hqedqjwwqneyun9dchawlwy5tsn9zt6mxwgzsggv9wcz3sjs0fxp;3060;10;7535;4475
1003;bc1pymr2nrtmpz2lkatyw5za75ulx3vpdnayugaxjx2nuz20ef7gfznssyje72;8285992;258;8285992;0
1004;3JmBa4piWKiT66rnMLEZsCooYH5kXeY9DN;388109;7;4154651;3766542
1005;bc1plcztafw4f8ftr0xlsqvzqqk4tngmnr0zn37mclmc5st8ky8ha3ysxrskh9;260060;6;1243391;983331
1006;3P6mR78kDxnwRcNSJxraDHVC1H8Zr12W8w;1669717;53;290916204;289246487
1007;3G34oNoiQof47EJUwGo2FKgdNKo62gAPqz;1686827;6;3919075;2232248
1008;bc1ppqrfsx5gz8z886m97skppll7mh33rnsvmtf9tzlggme50574f4tsv937qm;1092;6;1145452;1144360
1009;3P33MkwoFvceTgZyRdvMo89mdWu2gBRr4z;409244;3;678153;268909
1010;3A3Nx4ZmCnMWAH8CZzunZba9zNhrmQ3nvD;26520;3;211968;185448
1011;32Si8RFtewKUMochaD9LEuiEQrKzW1dqHX;1111919;243;33549737;32437818
1012;37SiWfzUbdePjFj13ssSk8u3LhR2GR6FjJ;13869971;66;854214298;840344327
1013;3379AngxALxerEZMD37zmtEuMy9TkqFauN;3757438;6;9875787;6118349
1014;bc1pxlvgc26kcacu2tyt7tlfxkr2vpfhvcdz5du52kxvmkv2vexd98hs0x26lx;15854500;7;74103256;58248756
1015;bc1p5tzhjhm8d2ejswymuhsugpv7yzfpvynsqvflnzm6sra4rw9ftccq7elq4r;852189;1;852189;0
1016;bc1p08duuh6tkmfhh7ml2q6du4wc9ap7zltt2sq8jv450zvhwxvscp0q6xpfw2;1092;2;1092;0
1017;3Pvi1MhXCT1dxDzirJXkTZXiAwzWzccX4P;1204475;106;91285154;90080679
1018;bc1pdly4ehsw2acxwp7yn5mysw8xtxdte0flpwv9f6y80apx5ewszndqs2murt;25440;42;3408181;3382741
1019;bc1qvrvw5yt0vmzss5qzwnyw688ncn5pdg38pnuye6;12055533;22;52852772;40797239
1020;bc1pv0n5dxsf0c9h3xdur45n5ejaxx9e25hwdftlpw0kn2n2347lphaq9uvt6y;1546;2;1546;0
1021;bc1p5n673n6c8rf8cu3ftzsa5mgr9gfyuu35jckkcg9fgc8rggt4p3pqypmurc;1638;3;1638;0
1022;bc1pjn5u6whlt8kleh5dwz3jg487kkytwjesep4htuj8h6yf6vu68hfq62etqs;1626182;8;6574182;4948000
1023;bc1pvytl03trgq9lellr3x95jzwmd648wjffcrec2sh09gt7r9rgms5s5wa070;1092;2;1092;0
1024;bc1paxk3q4qd4h2vzdpelt062r33kezzpxa0y5rta9233wvz78sxeurs4wnhu9;347126;2;738972;391846
1025;bc1pk6ancy80vl8suwnpgythx0pg9enpz34j26jdnmu4v3cmpa2as9ksy9gk0c;1638;3;1638;0
1026;bc1pjxucuccmlhqw53hjpt0mtsqpz8573h3vzvnt2v9dkn8yrllvt0csnwmwgm;4822;8;4822;0
1027;bc1pmjxdqjt3hlw2quyun67l9e8ghm9nzu6xmef6ph4x6xcahs8ct8dsd4t2dp;250689;3;872165;621476
1028;bc1p9xtpg65v6u8uh4r2czzfjx4qz2g5g02at6eawulk9k2sq6hfaleq49rfxz;80546;2;80546;0
1029;bc1qqw0f75wadwjz365yptwet4nhjtelpfz86d9546;1708067;131;119155970;117447903
1030;bc1pa4qn0j5epp9aztujm5wtc4kq0lt4jpqwp4huc8jqty9tawgl5wtqtuntrs;174801;213;2613598;2438797
1031;bc1p5h9pquk6f3gq82vxyzx943tqhzs3wl77lxflr7sf4vykm9n8458sjmvrpk;217698;2;481071;263373
1032;bc1pcqms2fr4ytkjda0svyrn56h0glpzq64mflerae9ku38rjluxusxqa954sh;7914576;261;7914576;0
1033;bc1pamq7a3s2q5y6h33kchs2ghfdu9h28tjtp52m7zfj2c62lpsr5wzqzhawyp;34215;2;113322;79107
1034;3NrLm8bDJM8W1FUbo1y4TEEm6SHTvRNt8t;3857380;6;10116498;6259118
1035;bc1ppgu70dg6t86xs8n2s5t98h937da8pmy9ft2lnwg5mn8dejllw37qffhyfk;8191528;233;8191528;0
1036;3MiMYgHZBQfg2NHdQFLEdnHbK7BfswedpB;184550;8;2244638;2060088
1037;bc1pl35wn7k578zg55exz799m6v6pnu563wg34t7yg7jsnmxpmvw5fdscdsmvu;6454520;224;6454520;0
1038;bc1p2dc7zd2m6qvs8x57eq60hz34cu2tfrlzm6z4qcfq88aezj5rvf6s397ljt;1092;2;1092;0
1039;3MUiDJqK3va6k9VLNaUhemc6ayqsWWGcGJ;17525050;14;83411512;65886462
1040;bc1qjlu5quunz6lh8k8wtuaandu6jk0yjt4ch6cc59;808023;32;8456966;7648943
1041;bc1pmwa3wz5796v0tvsaet7rnkf4rdpqpe8de5er9fa77rf2ytw7acnq64unk3;2730;8;2062730;2060000
1042;bc1p057nftmfpsnx6au4cwn7h9y289h8ymtmw3m6wvwgvst6htn6fq0syhu7df;0;2;68000;68000
1043;3P17SAMS6g1yTsTGQNScFxrdJnEiX2jNAT;14481562;16;61818905;47337343
1044;bc1p2jyvn99xmd0vmtn6n902napu9k6n0663yl25e36g8fyjnmstjvaqam62nf;1606527;244;56001350;54394823
1045;36chjUEZhYffEpJVpMmAuUTwHnrSGaWVK5;34404;22;12804117;12769713
1046;bc1p7rrrg2gdfqa8v9pdh84ud3lhvsjhya5nwcxs2pm59jqssnx89ars6s7s2p;1941547;132;54455027;52513480
1047;bc1prfkzny6sy0d0lr3gh7ejaq6uf0fcas5fkr44k5yxv53gflpkrres5ej20t;100546;6;151092;50546
1048;bc1prmuhgmxvznshan4ymmqg4sjufvcndv6aes2d3pyhpz6wp6hh6u7sdvuxld;22745;30;25475;2730
1049;bc1p6wa9ef6jmwx2mppdu87ldrp9xv63e6q9k2y6v82265hyl6sdfs0qzlrktd;8695424;243;8695424;0
1050;bc1pc5ttqv8v6v4wqz2ws3wrdflv75f3mfv9a4dyh04gyvwa95d3l3ysuq3nke;7098;13;7098;0
1051;bc1pkjpe0eyltkwht8npdst9sx5a4rtc2g77zk00sew4r2wnh98gkslqejre29;2626046;505;91621734;88995688
1052;bc1pd3c6c6purcyztxetfcuws8t7qnvnn2csqzyv64ydtrcue9asjg0qxk77gp;9019184;239;9019184;0
1053;bc1phwv2dx28medh7lrcgukkm8r55r00mrgc22uj2eshyrs72nexq9cqzxp4y7;8830296;252;8830296;0
1054;3BXW5zGy36CLTGar6ujm5jT93UgfdWmaR1;4902248;2;9872248;4970000
1055;bc1q8u8vrp8vey0nxfk63n2vgthyufzzpmmycgpgsm;3053;3;294129;291076
1056;bc1qg52mjesja78pje49rcxx50fd07cf6ahfwajk93;1591020;103;93071546;91480526
1057;bc1p25myx0eu5sarn09pfa6qlcnl6fgvf9249w3f3l3dfu4htmfz0w6svshd3h;3276;5;3276;0
1058;bc1p2z4j5z8ddmqj7l4hzg6m5rl2wfa7qnetjjfk0m56l2zycn9h635snwc45q;921378;4;2819703;1898325
1059;bc1p6u567jv88fufar5g9mpusrgg9cgnh6p58medn70a0l3zwc8m88wsx679f2;1667458;5;4352842;2685384
1060;bc1pva6tju26h2jy42nm72577fmc3x4pqtupnav7x3rtnk83jhg3uptqydy76h;79107;3;371997;292890
1061;bc1pwgypdksdt4tvyf6f579wmdrvgmt9cgjmwcu49zm7h058udwhcudqmcf289;34998;3;242019;207021
1062;bc1qzdecf8822sv3nzkn6d04gp8804uat362vjxdwn;73326;3;1171154;1097828
1063;bc1q2m0auzu5hvxs6s36gr5j77mvffnj52ds55p4yr;901397;2;1861387;959990
1064;bc1py0ejq7hzzza3ajdvu45fkwhr6qpg664uz2mcax8a3pm3tgm0z0ksz2m475;0;2;34126;34126
1065;1JJ1Nhk54kRXRMQ5UhhkgAJQvihmqMXhbn;9721090;31;9721090;0
1066;38FePgs7w25WoHBQd6ubHFVYVZzSLDckLw;3248804;3;8380442;5131638
1067;bc1q7cyrfmck2ffu2ud3rn5l5a8yv6f0chkp0zpemf;116835288753;1816736;1702516838061824;1702400002773071
1068;bc1qvtkujnz0g6ulr900tn2y7wdj2re2m977080v2w;309000;78;150207705;149898705
1069;bc1pl8lnskrw7uvx07wcgxmudthus80ssuttgdc3p6yu9p4teynk842qwy7fvs;6075605;5;13523708;7448103
1070;3J9MYcNDCBaaaWD3wL7g8mS95wbMA89tJS;5564436;121;1507138232;1501573796
1071;3LxT5Ee5JH9P6FYFAzAKavEBXFnHewubPR;84830;14;1554573;1469743
1072;bc1qz0mkxtf3t4hmzwvrhhfk9ty39nuvz45g2evrgp;62285;3;514099;451814
1073;3AXb5Daqvm5VHjvXNidL9k4hFwGkZX3vHK;326123;5;2450815;2124692
1074;bc1pgy2uvvrm6z27czsef3gu23254fx6u8edt6p2l36u86fa06k70knqc4qr5q;1435880;3;4463274;3027394
1075;33SsRudH4cG69eDpGZappBCEsAj49sMrv8;1471959;3;3800124;2328165
1076;bc1p43t6hz4xfrceqa8kavzjc6w8jhmn3c6gzcw73na7j8xks26fg7qstapxy0;2184;4;2184;0
1077;bc1pxzpjsr9txlkf92g5s670uwj4v5zeqyeg466te3czz6rq0r0m7z6qxvp28m;30081;5;7643154;7613073
1078;bc1pjfwprqgr429xy0jgzm36wuz3m3z4jy0k9rgw3yhthva70sulgccsa0rkh4;4651648;147;4651648;0
1079;bc1qpjsgzlpv8a3hczjzjrq2xxar5vjtetv2q6ulqc;10408979;2;10408979;0
1080;19jH46agbcPGEzYCysCLY37ow6HKonEps2;236771;41;8369118;8132347
1081;bc1pxn4hfflv3l5tnnfyv3z3mpu56d77ygwvaxrpja3q9gqk0hn8s3xs0rc47w;0;20;5388324;5388324
1082;bc1q0y8xrs3vca92apvaj0dvzhlvua7z5pgvmwmcn8;79865460;1;79865460;0
1083;bc1qtflgz8ssnu29zjckfhd2u9ql88vrseuxl804q0;15980079;36;367247833;351267754
1084;3QH6qLZUgQMga3Vggw6eM5vaXNV8qbS3ci;505288;132;74917056;74411768
1085;1JvwsHRQQdN3R1tyVfUuTBxMU5ByYnbLyW;331770;21;3913321;3581551
1086;bc1q8tw74zlmcsav3t0zqsum6h538g3jg4xt46n8s6;141040728;1;141040728;0
1087;bc1pjxznp99vq2fhgecgv4xkfnxxthtp025u4nldjx0wydh8z6eqn6hsk5vwx0;4494621;175;34920996;30426375
1088;bc1pwjna8h2epv73aa4atmqfztm9mj25f957vdemprn7ezukygwcrz3sm5xk49;4729664;147;4729664;0
1089;1ArHa7V71vWBq6vb4hNxDKmVT19t1R8Neu;298000;35;5522220;5224220
1090;3MZ9o7VYEwmabJZv1hd4wZ6Dza1aGGyyEp;2648850;143;34174301;31525451
1091;bc1qzd4mjgtse7u6zetrxjm3h8rp4g467wrrv9q04p;73119;22;73119;0
1092;bc1pz03gy0kmkx5r47dvcascuey5dyvquw2u30qm70vr85slgj6qxcsqsel4q0;1092;2;1092;0
1093;bc1qu0kh402fws56pjxcwuasu3lqazxedhcqaz809jvf5tmpdax28yxq7ez652;97088;46;2654832;2557744
1094;bc1p97tzhadxh5ns7k3jldk5lq7auuhlxnp90rrt84xqwcq2qyal3s7sfjy2uc;4305920;139;4305920;0
1095;bc1pz0ej2rwl6k5xf9adwky8nhuum8qkseq9lf9gh0cru50hsyzne7vqnmjp00;195097;1;195097;0
1096;bc1pfkp0aks6n8t3cr0t2eu8n06re7tsn5fcc7sf3c5gurmtlxmhjs6s272kdt;164342;1;164342;0
1097;bc1p4c9jys9tjj5tzwnag650xd9psj3mddvgfc3qt0464k56mat8at8s3rka5g;1196554;2;3546554;2350000
1098;bc1pxpjl690ryzel5nal8p95ks98l5c59vf7q22kuu67d8vcyer6jwnselumy2;619924;1;619924;0
1099;bc1q736wu3dhzd0s8yqt402cnhrsn2hf7cmh8cycnv;15448;360;14799345;14783897
1100;bc1qu5xaxfucsl66vaxwff323kh0r9fz5mr5wx30sh;1878564;4;24426219;22547655
1101;bc1pzwjepl0fhhu724qlp2zqt642mvlq4m36aw7sh0r8rx5drhecdzjqzm0aq9;717940;2;1487940;770000
1102;bc1qg3zj09mmwkaxs97tj54rfhry2cway86pguzczc;866024;9;3437807;2571783
1103;bc1quh9jm6p06nqnvgvvv733pl0g0y6ycxl0aas2t4;8542331;7520;695577379;687035048
1104;bc1pwdzlksvmpnle3xr6gkxgrsu97hesv7kqry5djvemmtqp4q226lnsvmrm9a;84690;1;84690;0
1105;1HbcFmrA1Lew9WFCNHEyKiHkw62sn95oiW;1458463;2;1458463;0
1106;bc1qmfjf2pvdfc50hmgdnf2grdnjck3n2cglawsysq;586304;27;2512305;1926001
1107;bc1qqd7nanz5umsn9n3k3mg3s853djj4dsatuvcsg5;100969149;1;100969149;0
1108;395YiRMTrKdEGQQNt8ourm1PH9qFbGczK3;284622;12;1594274;1309652
1109;bc1p4emnyzkj348de8yl2u88qsl97vwgu979ct32eap5f8crsaxkv93q63drwh;108558;1;108558;0
1110;bc1pzjaxg045cwuaz3acpmu52znxrlxmv9a4zpxtgxzhfs5kk7fpd3tq66dkfw;172428;4;172428;0
1111;bc1pr4d86gflrf5qdy0xuck7r3p5969xjnzjux5qgwydr525uva5dwkqlgcrzl;390521150;7850;1026187925;635666775
1112;3D5VSqhVrMx2tgC5AzxgKEmnfjSvH9rhz6;224437;40;95424032;95199595
1113;bc1qvs2hts5u0mk06ayecd3m85ps5w5emuxtlxeg9x;46010318;9567;104442666;58432348
1114;3BmeQC3pnJkVUVQquqygTxok7Nxj5fsLXi;35567028;226;39461365;3894337
1115;bc1pn9vr2hvc6u9x4p7a8ery7zftmqmnwz0ujk3dw2lzgwn43vwfq0lslw2pep;275574;1;275574;0
1116;bc1pa5m5zfu0z03psu2l8wjehkzg7e2slfydwz6vdcsrvaq4a04ekn4sa5gl29;7992783;4555;797842765;789849982
1117;bc1qgtuuajqq5c2xsumnjtecpv2gdjrg3sy3qcrmtl;995673256;151;3944404697;2948731441
1118;bc1qnh3wuxlz0mzunqlse9dhpwlumf3rh2g3rrxz3d;850473;9;3391058;2540585
1119;371HKYUTsDTV15CAuPhYYXCSC4nq9qBEba;1075794;1;1075794;0
1120;bc1p49k326uak8j6284g36k2hwncp8djcxm02qdc325mtm4ykf0t3lnsmwe9ll;302380;1;302380;0
1121;bc1p3xw5mv6tnqx0vszxeqgjhdcwmf3dajlpndzmy00lrlf4w3sqgcgsw3rdy7;1638;3;1638;0
1122;bc1qfysps76rwutefzd0gr0pf9spnvs369lu5httwt;562933;244;127214821;126651888
1123;bc1pgxpxlmwydcef0g8p2nerzdp234xsr27x94d7axthxtryx8y8n3qs7pcq5t;49052;13;23610481;23561429
1124;bc1pr84m8adtl2h7nvujyzjsyacqqqcglx7c2089anfarnk2xrzjhqls654lfj;717940;2;1487940;770000
1125;bc1qezj9vwfgrq0xqvwxs6q0k6w45lgp8crfn0c8dy;265242064;289;3432227191;3166985127
1126;bc1pyt32tedfqzn0y54vnd6gzfms6wx98wx0xc0z627thelxf6u4frcqnsxyf0;0;2;30498;30498
1127;bc1pu60k7n453wzuyr99wkzkhpyqxk6l92sjjxuh396w65zjsq6ejk5qssujyj;221895;124;509602;287707
1128;bc1q89m3dh36y0r5snzljeecfvlc3zal827f9qxc4a;78515;4;585679716;585601201
1129;bc1pzc2nrxk9t9hx00vmlksdagume8elxs9rmp9d7dy8ly9mrryar94scrv0vn;0;2;48000;48000
1130;bc1qy9xmjyqta9rld832rh7zafxyal9a36spy45y6m;806413;1;806413;0
1131;bc1pnac4rr7wepdkwzk0cpahqwe4qpysvsk9fe3kz32dx25g9j9le62qj2ltpw;0;2;28281;28281
1132;1Hsx75JT6FbDaccmsBeop1JWvnRutMGVBK;1625858;9;6893111;5267253
1133;bc1p9srxdqx7u4u48ahj4s5gd3x5m932zm4fc4a4ds5ncm580nh864jqm37k26;117134279;7874;409568377;292434098
1134;bc1qsatlphjcgvzlt9xhsgn0dnjus5jgwg83dr05c6;8468131072;198572;152314100898303;152305632767231
1135;bc1qmhax2wcwgxhwchm6rrw9wswjdmmq7ce7ezqxrs;155478;32;155478;0
1136;bc1ptarzfay3mu46xvq5wa9fndq6wd8ernq6ky8prewgxaqtqv7ftlgsuawa9r;717940;2;1487940;770000
1137;3NFoGtQtQTfKsZdamSKdAac7Ubip87vpQv;4516474;98;162285310;157768836
1138;bc1p9t5qf4prhvmuc0pfrlvcwl90u892lmwnfawt6am2t3cxy9rmct4qhfjkp3;19285;32;92694;73409
1139;bc1qn5ep2ptx0zaar49artjgau468vhlfs3q8208d8;3151021;3;3151021;0
1140;bc1pch33kd9jjcglqvkeqvter4r09talkwf0dtekv78p2va862neswqqk4l536;0;3;87092;87092
1141;bc1qz735zj4ry6usazdtqknqufs2r6tnze6d3t7qus;817555;9;3338347;2520792
1142;bc1pa9uh3qwq0aeh3x46rsf5t4d4l9valcd9yfhlv9zc5vqxca6rctkqakvuvt;0;5;335004;335004
1143;bc1p7gv3gt4dy2mu3pdpt62mx88mv39zlpmpnpum5lgm6mp3j2lhz96sn3szsh;10000;1;10000;0
1144;bc1q933sqe4khmnh605c5t38cfmhm5rzueq023ftmv;741000;9;3975867;3234867
1145;bc1q9c4wk48hw0jehzpky6tj8g8wd6p3hxp9uwn8hx;4492760;494;1365588727;1361095967
1146;bc1pr65hsx7x9x06r0tex3jjmt3lrqwn9h9azv9vpc0jatydgtqunm7sv49mr3;10000;1;10000;0
1147;bc1pgaeqzfdvhtju93znqc0njaw5r9qjzmvgu5g7qmhm90mzc8umxdsqe53yqd;10000;1;10000;0
1148;12BAdUnLgGhsbe2zvdVvWCSMpKaZeqzXmm;442238;11;2845238;2403000
1149;1aL3foeojzKQ5HVVRTF5bJv92s5f59jkP;53922;9;506089;452167
1150;bc1pxkqxssnw63h7p665tt05wtfmzvsa7s4trmkmlewmur40qtumlncs7t6x58;50134;1;50134;0
1151;32MDFiGeqf1WxQh4Uc1zaakLRxUzkWHUkJ;155355;149;32538546;32383191
1152;1A9Z8FHawa7SZvFXwro2YZ5TNec6Dx84m8;200742;3;648441;447699
1153;bc1p2mdyeptyj9fx2z3f5cc9dewal5zy224aa7zj7zz5p967vm0g0a6qs26x3z;24025;108;312310;288285
1154;3CEzfUj9zbdzaHqs31cukPCnoKiY1XCyFP;3109317;275;1810000770;1806891453
1155;bc1prhxat8jkz39n0vpym4msnnsplf3px7ae3mrp7hkwmw9ryr620q2s3al6md;495332;110;38512126;38016794
1156;bc1p889080dyzvlledwq30mvp0js5csws39se48sssktvmnsjmckarastmlqlr;2730;5;2730;0
1157;3Mm4HbAoyiXb2ZjjD7KWwVMirgwe8jUp7p;604072;1;604072;0
1158;1GeQLvVyCyvzgu9Hg1o8jjSMvstXW4kC4N;332037;13;4015435;3683398
1159;bc1p4ug6lkph7ymqezy3zj4x225504g9zk6nk5gp0kdlxj689rrmewhqta7ahl;0;2;99518;99518
1160;bc1pymr2nrtmpz2lkatyw5za75ulx3vpdnayugaxjx2nuz20ef7gfznssyje72;3815456;149;3815456;0
1161;3M34stduWX5jKbCoyn3r4EyeyexMTHzMSd;0;2;2163164;2163164
1162;bc1pqfx2zqwqtaq6mdfav97w529te7858tk4zevgtq22qdeucrnpjxcspufhc7;539946;4;2366184;1826238
1163;bc1pzlqrrh999ffz8fardm9e37r438d7cvhhptnvqr4pfay2xq3ac54qrawgsp;10000;1;10000;0
1164;bc1pwap8jpm7j942ey3r56nsmzujgancf0afqwxy4p6udz20jy20g9sssuuxm5;123493;181;1369632;1246139
1165;bc1qqj4yxpnukrjra7afac6md58k50tvplw5du3d22;1719102;206;146521585;144802483
1166;bc1p03js66q5recgmyvsr2ttkxrqxp0tr0wjr8fvpal54mxqrdlpl9fqysl4wn;2914;2;65916;63002
1167;bc1pjdyaed6t9kzjwhdqmu55xmczqeq9j9wwlu9n8mmug4kpf053wl0shjvwea;539946;4;2366184;1826238
1168;bc1pg04xnwdngz2wknwh7632key65mfg4m0reftrxxa3pakg8mdvs9kswxs2hr;0;2;34126;34126
1169;bc1p32nktsuffprllv0j93a2d3q33s0l6rlh598hynkgrt60lf6upqmqasw00d;155192034;8020;623213159;468021125
1170;bc1pjctrxh5yjzfsvvhezqxvn5krk89ut6yyj87vlgr7mez9yhfhtpuqkn0djq;10000;1;10000;0
1171;bc1qnllduhqat4ywlayqkspzg8h2qtnpn4kqjs6v5e;145474;73;4107159;3961685
1172;3QqSsYFG2epzsUnuo3Vs8XhxZ5VKKuzLX1;78376;33;49058083;48979707
1173;15Pne3cNuK48YPWEQ5KvNNpBfvG1dncuPE;18094348;96;44093912;25999564
1174;17qVdcurmLz6qjf6xwb28XPR3UFAasAVXX;803000;34;18914422;18111422
1175;bc1pru0qxcxh7mjjnu0wpj8ydnwhgykqrg580dsydxq9refajw9ujgvq9lufnm;292960;14;1571587;1278627
1176;bc1pr74tut6g4slacvs8dnd9uf3duhekmd5wzqhm77v6pwm05lwyr6rqf3uwy9;1479912;2;3019912;1540000
1177;bc1py4q6ayf30a2m4kf9t7u5jn3f83qlx3wuzmqfwuddlmpf3gagvrps0dznnv;59204;1;59204;0
1178;bc1prd4h6mw67cmqh2mn4a4w2r3uqg3swkpeprte0hguwjksfhf4z7asvtqpxk;102000;1;102000;0
1179;1QJzhrUJfaF23CAMqAS3PmfpcJDsmHrR8R;677218;1;677218;0
1180;bc1qkym2ru72kyd0cmuj00rk2kmuntyu04frqp72gn;8137;22;8670824;8662687
1181;bc1qasyr5rjz9j4yqrnfj3gq7r8qepjuxfkm666m93;8344;1;8344;0
1182;bc1puhd6p3ghv2ra5xjw924kdukjs6mg6k348drnm6gpc89hx5xzs4qqypcxuz;0;2;34126;34126
1183;bc1pcqms2fr4ytkjda0svyrn56h0glpzq64mflerae9ku38rjluxusxqa954sh;4523888;151;4523888;0
1184;bc1puc8uglfpsa34v2fkpdylhalsrvxchxx5r8l673rwe8r4p3avlvfqv4vu77;115796;2;274592;158796
1185;38mgAFazWBXuPMDXgqbzJ39TyQ921qNVkF;1505943;6;5283112;3777169
1186;bc1ppgu70dg6t86xs8n2s5t98h937da8pmy9ft2lnwg5mn8dejllw37qffhyfk;4713976;129;4713976;0
1187;bc1pl35wn7k578zg55exz799m6v6pnu563wg34t7yg7jsnmxpmvw5fdscdsmvu;2570440;122;2570440;0
1188;bc1p6cslajaf9exwlhtt7kat85jgp3wmj2g4r93jhnkq8ay2sk5wt4msnatfpy;675259;2;1388530;713271
1189;bc1qwmruasmj64jhh72v6u86acmjfy72yyx84ut4ac;1164084;26;2449483;1285399
1190;bc1pkfhpw9ggjjeapfkar6t5t8fzhuphg4lfs58agttw336c23nslluqagxkut;5089848;1783;1269680408;1264590560
1191;bc1pmnx4rpxfgkj9ran0zhayqcc5hv7u2arq036mpm7u67fn4unqftrqvy30vr;4638960;1;4638960;0
1192;1GJs65AytWTwTxZNNQNzcABEaWoLjZ6erj;208322;149;118256302;118047980
1193;bc1qefcwyd858mgr0wy8ce2ymx5l6sr9r68mmcsu2p;209000;132;16416665;16207665
1194;bc1qmpmcp48hff4gd06q7h39kg4l0txe0k8cljd6nf;17220;2;17220;0
1195;bc1ptgvu6u5xcequjsefytch6ct2rm94ea4kjffq6vc6w793008nt0nqd28r68;634366;3;2016618;1382252
1196;bc1q5vr785yc6claxuw5f63spqe7ukxzflw7yz9a3e;151414;1;151414;0
1197;bc1qtzrgc6sq5c3hgktlg7dk38ytgdm8fnjhnj9khl;1886161995;56001;21893969820463;21892083658468
1198;bc1puyje7mg6flq0p9y8fazgrl9clvh2up8tlaj28uxt2vmzrw67nlcslm3uy6;109199;1;109199;0
1199;bc1qmz530842lcjajr07ugghavjhmyv2e09f75e9rh;8616878;10625;3402909229;3394292351
1200;bc1p6wa9ef6jmwx2mppdu87ldrp9xv63e6q9k2y6v82265hyl6sdfs0qzlrktd;3210832;136;3210832;0
1201;bc1pd3c6c6purcyztxetfcuws8t7qnvnn2csqzyv64ydtrcue9asjg0qxk77gp;4457152;134;4457152;0
1202;bc1p83ua7n0sy5er0nzw5jza5p8hp2u7x9xr0hdc6vr9asedz0wv794sy5twce;371525;1;371525;0
1203;bc1q8m3s9d30qadfpjlrcp88ecr4lanjh832fuem8q;330000;1;330000;0
1204;bc1pmk3zcy67at5z9m4wpku7e7arll3hps22hm409nkve8fuc9n7lz9swshmkz;2520692;18;35891978;33371286
1205;bc1phwv2dx28medh7lrcgukkm8r55r00mrgc22uj2eshyrs72nexq9cqzxp4y7;5372984;156;5372984;0
1206;bc1pdjlxt7v4572fqkrlzdsx986l6zjtvl9s7ymazc4cv3rpxgqz3wlqhc76uz;114802470;7898;411790964;296988494
1207;3EBWSeWBaJDSQaPvn2N1WrRqZbBMZ5qZGk;2345638;3;5245638;2900000
1208;bc1p0c0sm6qnxnsx40u8mgqdr8p8yqx08p24qdx2qw03cch5dfmjf6qqd57aqh;2184;4;2184;0
1209;bc1qjanwgafr7en9vsu006kl7xhn4xclt6w56ul7ct;0;35;2584733;2584733
1210;bc1q9p9a2j73xk7azeu7glsyey0xafqdkslyqjrrde;23564;4;214990;191426
1211;bc1q83nl69f7t6qeyy2286cn0ruj8l3m84wz9xwms8;1471842;60;10766375;9294533
1212;bc1q9r2kmgsj80rlp9ea888xqalzclw3dfwc76we8m;20000000;1;20000000;0
1213;bc1pwudl8a536lu67d0mcjl6qrsucn85jayedprrl7nauw2xsz5npxyq3x6wa8;0;2;33570;33570
1214;bc1qtn94dw3ll3wr0905tf5pt5nrnm6c4m8l28n5al;2750867;2;5870890;3120023
1215;3CDNxjADrg3nMUQ2ur6f4uwmuZKWCScVyG;15648294;6;15648294;0
1216;bc1pfld0s6jzcd2erfrgqr536n0k6w276wxhpszypvkq0zcwqykqhw4sll02nu;717940;2;1487940;770000
1217;bc1p83qcd6xv5dhddqzxn6l5y82936f6wc7vfj6wylf43pa2v5aqupls5uux8f;128654;2;292654;164000
1218;bc1petnk8rmkp8l8awa4vpcma3p4hfgs6ur7eyf32q7xsyw3xuudka6qj7hzjh;10000;1;10000;0
1219;bc1p4vpr5h3mpgndk3asts6mk4u4yql6vsng7z69xxjheaz7avz346lqj0zsmz;180819;1;180819;0
1220;bc1p2v6ar9pm630g22gx0pncgznegf9ypn5f22plc4h57v6wk6v5ktlqtnwq2f;1127035;3441;1414682101;1413555066
1221;bc1p0wkhy50957ssfeexhad5ygmrzsggdl8my3wfr2z334phtuyqjcrqga99a7;350954;74;386426;35472
1222;bc1pqa7s5n2tw9v37fhk5wt2hcwuu48he4tc060jsckm3d47442dkzjs74lxv0;1500000;1;1500000;0
1223;bc1plkdtrg5krg4gar3v3elhenfx8hujt8eq5vlhwvrea79t6dtr0uks7dlrzj;0;2;255800;255800
1224;3CmYbBAK6zgX2q428FLiSRfPrQS2ibp1XF;1530265;188;176184451;174654186
1225;bc1pqwyk5t2673qg6ek20vapkqade87pjx9fg7p5vd47smgvcdyjpxeqkwjcqj;744330;1;744330;0
1226;37uD3JaicHBk1PDMYGo28Vkj74Nvk5Ubvo;1430496;3;3430496;2000000
1227;bc1ppmfksrsvryrgk6ug4fdanwy27y8vvqnytmv3q83k88vqvhkvc3cq79xhs5;0;2;215254;215254
1228;bc1qp47fh0lcxaypzdkha5t8t467fvqdwlcng9d6kc;2107590;3;6398748;4291158
1229;bc1px34n7xwk8huh0mcmfvt3mn49wc5u982uapthd3utyna5yhlyc2jsp9zanh;26327;3;158023;131696
1230;38zWEbsRJgQ6KXg5cLJcUKovJR6WAMHort;1804182;57;20441178;18636996
1231;3MZ9o7VYEwmabJZv1hd4wZ6Dza1aGGyyEp;2648850;143;34174301;31525451
1232;bc1prjcvtvcr22wk3y00pkwg3sdqhflnfczuqkh0f7nhuqrawgmdvr5scw6sr7;0;2;180508;180508
1233;bc1p2h37pe8lh0z8u3tuxhz8ut29u7u28t8f2h5edjjsgqqtsnnz0wrqxphtny;128654;2;292654;164000
1234;bc1p4n0p2k2y03cxq7e25030zflht2y3gkq0dnewh76dfhgxua88cknsegawcg;128654;2;292654;164000
1235;bc1pm8xeurc7xzlctfdrplna4e0yzyyczyw6ux4ar2e2f8e4uuaqj8yst3yw3p;10000;1;10000;0
1236;bc1pmvayn2tz6zf667jdlxuma5me458hfksjv8mvanah72r3v8580kfsgpln9d;750830;1;750830;0
1237;bc1p97tzhadxh5ns7k3jldk5lq7auuhlxnp90rrt84xqwcq2qyal3s7sfjy2uc;2980808;123;2980808;0
1238;bc1pfdh34xy2ehv90aepeelkpx3z0ancwl3xnjzxfunnzk8hts8de8qs60xsce;0;2;145762;145762
1239;bc1ppuggh0t2cdh2hgp5r2kxlaa6yjmxwzduvaqgjjuf47nvas4ymghq6xhtk5;1395077;77;28800701;27405624
1240;bc1p48hhwzcdgyw2kkycdkys945qr8trkjk93v3xjkhfpaevlej80q9qy3q60d;10000;1;10000;0
1241;bc1prxrs85lu22hvhfaxnwvauzt056q28gmxe2yw3y2m7u2s87a9hmtsf2hfz0;128654;2;292654;164000
1242;bc1quh9jm6p06nqnvgvvv733pl0g0y6ycxl0aas2t4;8564859;7531;695599907;687035048
1243;bc1px0hhnwxhuk8s7htxy73vzsayl9fuj49tjjzwrxmqwrwhddcplcpss2ej6d;177056472;266;2998103329;2821046857
1244;bc1pcj2t8vansd8jc355wzah6skuga72q0vcteluxg8gpuap2pr0rffsuvfsya;744330;1;744330;0
1245;bc1p9wgy9zms2jrscpjcyhe3a6eravsah2f9ly7syffg7fq2j5cqc8hqsq3dkp;10000;1;10000;0
1246;bc1pydms6tfd4xkqnwjhcyumxaz9xpav27s5uarwpwxjsqhvz2yt0aesxehy03;128654;2;292654;164000
1247;bc1pmhaj50gkjmr8en07ezmqvrlrl7k633x3crjvnz2jcvsn0u9afkpqwsl62r;10000;1;10000;0
1248;bc1pj9wmlq84xqktxs0qvfra8vuak3dwq6tf5my87wjtvqu5avgqtqnqqjkq9w;10000;1;10000;0
1249;bc1pua6ukzvy4qhd36wltfzs265xnpkpqpstyxq9fp7uueq5yx8k9pfqzvuhxg;10000;1;10000;0
1250;bc1pl3cr3xz8erhzx88qpyhtyk5s7w2rq86a437kg0g6gvj4g7qy949sl67ua2;128654;2;292654;164000
1251;bc1p45rtvs936vsjlxg9dsms5e657xhr227d6a8chmkclkey7yxjs73qtqn6wl;105369;1;105369;0
1252;bc1pllnllduwugqwwxymqse5xv99xchu3zrjc6wgd9wvlva64j3flzls3qffd0;128654;2;292654;164000
1253;bc1pu2pcsy3m5jkxr9ecurx7xc9ej6szanspdgd73zxdugul7xrw8kpqa50hre;10000;1;10000;0
1254;bc1pfp7cccjzem6jydm32qkzas2h6gx2pq5alpl55l3yyg7t3pna26cqrce2cg;128654;2;292654;164000
1255;bc1qdlt8gpmfcd37qjxtqwu8ja8k45u87r35sceeay;2107590;3;6398748;4291158
1256;bc1pjf5aa79r2j7yqtwq6c76yme5l75g9jh7c5rx5ze6wuxhurnv32ys4d4p0a;10000;1;10000;0
1257;bc1pumun8q22vsj6x82hn24avg9g5zv3k6cwv9w03drwnas6x4476gds33a77l;582981;2;1202942;619961
1258;bc1pg9yj5wvdl60ua90jsnz7fmtsemhlg34uduqhppjgvccztu4zpflqu57th7;128654;2;292654;164000
1259;bc1p0kepuhaejvjcztjcrqh645dgt8wp7dnedrhu3ks0hgtd7f5mudsqnw6ul6;231605;142;19409266;19177661
1260;bc1pmsrm235jt29zw7zhq6k0k26gk0pmp8rulem4ujr64p7rg8xjq3rsmccpae;10000;1;10000;0
1261;bc1pm7w9j9v64383kmhvxg6clf7t0gg8jdv7l04z08mj607x7kt4jynq040uft;128654;2;292654;164000
1262;16pEUBYtA362He3YnCrpxhuWRvxgZXfTzh;67753;4206;50870683400;50870615647
1263;3P2jazHCQfCTJQFR3GuCvM6LK5ALM2MFkM;4046613;114;71371628;67325015
1264;bc1q7k4j0nmxk39dteuph2zjzclk7f62m64nv5keh3;587339;1;587339;0
1265;bc1p3cxfwwq3l76r7tcmm25n9j38hcyx0lpsyr4jk7dph20mcna9qewqw7a8ly;128654;2;292654;164000
1266;bc1pnerrph5d6jlqusj23eqeyxv5e2nytp0l7kcgt9f8nemg7zhap4rs8ghmv0;739581;1;739581;0
1267;bc1pu60k7n453wzuyr99wkzkhpyqxk6l92sjjxuh396w65zjsq6ejk5qssujyj;221895;124;509602;287707
1268;bc1p3p5setr82uprwc69u4esydh6rjs5mmalr0wwlhpeju3l7u7wy9psuqkcr8;363005;319;109768840;109405835
1269;bc1pescf9xs74qlr99uqsaztrg7u8xz39rep7kt6nx4zuekxrt8x8rzsa0q980;744330;1;744330;0
1270;bc1ps028qyymryrwn64xfuw5dkdudqyv30suumh467kcva96mxnt7xrs77q3za;10000;1;10000;0
1271;bc1p7az8nrnjgc7s2wxll4vkrlmq38dyjphs8dcswygltrc4uukgvk3slx7yuv;2486035;563;63039740;60553705
1272;bc1qlmnjz2rdptkkyyphh8ntfggs6m0pde4hxcwhjc;843344;3;843344;0
1273;bc1p0tykjv0lcrg43epy274rl8skcpkd9ltpetdf668ksvejx7unfrnqte9jg2;173607;1;173607;0
1274;bc1pu86wrnetgej9f6mzsyqz7dw3sz9stddu9z92l66g7xslmqmjc57sdhyqkx;128654;2;292654;164000
1275;bc1pcgk6mnlyzj8c5tsca7j0xfgcrgqy7p95tj9uxrea72vyrjntc36qwdkqpf;1638;3;1638;0
1276;bc1pawhj4vspq0tlp0uayv7ycqahpjcedn2hkln40d9aq5xl03qus7lsyc0klu;190053;1;190053;0
1277;bc1pnp8k3sxlkqdf8wzj8ux9pvq5gm6yy4fsyw8rg0gwqv3wdw46zezqxfl4qk;10000;1;10000;0
1278;bc1ptnj4jqk0yaru7kdaheactpe4jka66cynwj4w5wf0cgzcnx5kupqq68j47c;0;2;377735;377735
1279;bc1papllyk4ysjh3vdcezaq0cl3pt2rgannt4jwfdf0prpdvvs9nwggqpjxnl4;744330;1;744330;0
1280;bc1qp0cvp5kernjw6umghev9hwu0wtauxnqswa677g;241014;5;10149434;9908420
1281;bc1p9nsqg63wnmkmmgg07myhdwkhvhrt2g0rw0ty33g9tfa0p6hlqp8qlwtg4v;0;20;5012865;5012865
1282;bc1py7e4mh6m7x24l7258l32lqv7pe8ljputq6nqmyvcedxz5x4elrpqdg3q5y;128654;2;292654;164000
1283;bc1p6elrmjet6jj62rzdzl3232lppqn99g9ucv4zc57mjydrfw3ffurq53h4nf;455800;1;455800;0
1284;bc1q6fmqp3ytm5nzqv00amknm63axjue2ueq3nj90k;59528751;11407;143154320;83625569
1285;bc1prutwzwtnh920q8g46ndeu3utx6lctrzzvfep7em8ns25am2yg9vsfxhndh;20497088;965;20561934;64846
1286;bc1p9xejpyw3vma24ua39rc0mfqgn56cjp9fx2dskxnytap85ymtcz6sxc8k8l;4562164;1;4562164;0
1287;bc1pjv2jn6edrfscywwmlx780fprhyfxdrk3avvh2svujhjf0k5v7d6s95a886;0;2;355800;355800
1288;bc1pw7ng9f7f3ka8x7sxrn9ynswzap2mk0xcd2xve94smjnu2hm62jvqgchd2k;128654;2;292654;164000
1289;bc1p34htxey28e9j9rfqqcqu4v4rkjsfltx8myfasph5tzwvmh2rwh3qexqvyg;750830;1;750830;0
1290;bc1puje947r00pxxnqdygst6gx87es8yhv8kk7apasy5hvdayxhdecgsy5rv0g;744330;1;744330;0
1291;bc1pxp5zm5393vhgjtqx5tz3325kpweuhw3askjvmstkck5akjmz40us7uk0rj;10000;1;10000;0
1292;bc1pm59ej3k6estmfld7um400wtp7r638tkc58ma0wa2g2j5er3fhrxq6ep4ue;2184;5;252184;250000
1293;bc1pnhfx8wwdd2ws82az85p8046zhnt3ehcluuhn4wsx5ms403nxf6vq7ct342;128654;2;292654;164000
1294;bc1pgckx75zy0cxvkt47psadasrps7rynh7y328ql40tuwyaxmgzzptqutyqh4;128654;2;292654;164000
1295;bc1ppfdxwvn8x00qcrapauaxust06x6retnuw349qnfh5zq700ycw9vspfk8sp;10000;1;10000;0
1296;bc1pzlxhmy3czhj8e87s758y0cmk5ln9accmezrxpsyayy9jxl8fkdhqcgua49;744330;1;744330;0
1297;bc1qjj2w2xsu0d2tyle0gw2690q73y20x4zhelmhyacp6r5pygvudrlsqyrsem;420690;1;420690;0
1298;3KMi3Xn3bQpjE2zTSNbPxZX6c4b7Q3BJ9s;3123564;2;6303564;3180000
1299;bc1pua8m0megz25rf87qd6gx75zfmw9d9nkm7jmqq8s64vn9qp6vzy0qezd0ux;750830;1;750830;0
1300;bc1p0sc8ze5uns80q48neavyef5jq74nvml7ayyjg8fesvakfuqu2egqxckyyg;128654;2;292654;164000
1301;bc1pw3xsgvpzstkn7zwwupqnyescqh5hukteudgsm0a4669hj3v4fggqllw7yv;10000;1;10000;0
1302;bc1p7y6qwzqc8cft5ws2ec7ryqnclkv2cq2jq36jnjarjukseh27m75q5a8nu6;87434;94;22726205;22638771
1303;bc1qclvpqju5htdh6spaf3lzzum76hfy0tsnqfcaag;95811;4;199446;103635
1304;bc1p09qx5vtqyw75hs34psfahe55cas83uvqtm90jhkmcqdsp0rwhtfq2rnsdf;0;2;34619;34619
1305;bc1pzdlk5mmpmtla24cddzklcvwqrfe39yxpunhjgp999wjtydkd5eqsd4jdwy;10000;1;10000;0
1306;bc1pnxxttfpfs669apfkmgpakxcdq4y24g9nkq5tw4llp8n0ggv0ds3ql3fctv;128654;2;292654;164000
1307;bc1ph7xfc5hmve3xffr00cyf69cukr6cjrv0gmr90m07ms7k63xfmcmq6ghj72;509000;1;509000;0
1308;bc1pcwly30zgscr7d5plu3ceqkykxvh2jgnh0qs5p3rcjaze08nsyu8qxzj06c;128654;2;292654;164000
1309;bc1p03hex7ctkwl497jwm7hhnjf8w9pyfejkfn239peg85mdp3rf5asslafumw;744330;1;744330;0
1310;bc1pfm8527ccw23m2arg86sddfrhexdtzdxf5sd9xft08cxt7dw36kaqh6u9s9;128654;2;292654;164000
1311;bc1qra2ll4wyxrqy02k07s5kf89lausftmgs902vg5;32225633;1;32225633;0
1312;bc1pdeynwf229v09ummyrq0yrc33mtwckfgj4xxw46hrr793673j96rsv2p7lp;128654;2;292654;164000
1313;bc1prwgc28dws4ttl2uj6lx9atwzqy7cwy3h4q88s94gvfslv8ajua3qec7z0p;10000;1;10000;0
1314;bc1p3z32wt9lg6qgsgaz22meegu6fnldswj4477ynun7y0g05q3gr2zqhvk7lc;2780071;255;99732898;96952827
1315;bc1qschfcda64ky4mr80fheptj50axekhyacak9kqn;47569356;9579;106736474;59167118
1316;bc1p06tvnqyedlfstuffhnqd2jp293pes66g8ctmw52negt3fk9ynejq37ncd5;10000;1;10000;0
1317;bc1plnhmjc83lx2tw3zkqqmftcdeww54q3mlmgavacs5h36xf0kaq5esyhhphy;128654;2;292654;164000
1318;bc1pcqhw90atrp8uajvy0h5g6vgl7df0j0dlu6y0qrgxgfa9ap3cr6vqr6egqd;10000;1;10000;0
1319;bc1pvt2xyr6zvukqv2c8r879emq9jwdvtkp4zan8gxdwnuu7rva3g5uq68uvyp;7456283;2;8956283;1500000
1320;bc1p8aakhgl9e7krl8460qt47z0mn3enmvhnnka5cn5c88vsmctassrqg0dgkw;128654;2;292654;164000
1321;bc1pav5c52g7l9errl42pypw037pwl2plpnn8x6snsj79mevg4d4hjds0k5w8m;10000;1;10000;0
1322;bc1qq280wfd7pwx3nywrjtcc7man74z3hlsffvpd55;1096983;1;1096983;0
1323;bc1p9y2dhyzzyc6tzqdsfdy0yxnum9mkd86g2m0s0kacp5gvwwwc0ygsrpfkmm;744330;1;744330;0
1324;bc1p44fv8cz4l378ztf5lpwfs9uvrqx2r4fw893a770c6mcjdj3zcxqqssx7l2;128654;2;292654;164000
1325;bc1p7un034435y05gxf37zedx6ynu5cxku9a45v92cch59v4wj9fr76q7cdkkw;739581;1;739581;0
1326;bc1pl8uvkzzw6vza5vcg6ejpwcru2kamzw0pc06am8wppg5u375j6thsz35l7a;128654;2;292654;164000
1327;bc1pe7kkt2j9qeg92yf0673c0d8q3ttxyjsmpeh5zjx08cxwck7uajfqxyn9lc;10000;1;10000;0
1328;bc1pqgvm4an42l6l4twp08658639tcv79fpxs2q3e5vn3lskdlwekutq20g904;265800;1;265800;0
1329;bc1p092g472vda8xkn2s35sq4fl786m0zwsygjx5f47xggjdxfuvz5aqx9639k;128654;2;292654;164000
1330;bc1p562astyrhumg4umv3q8h93njj79mvz2fca7hy2fmqjk3h6n7s5qskm60ew;546;1;546;0
1331;bc1p4kex5he2tug7kcs2rnq9g2kceyc0qras6pt8g6cjrdue4rulppesh87u97;321511;249;558893546;558572035
1332;bc1p3szr6a0sz7yhx6ru0zxqq7zsc7snt4ch6tvtrkz7zaza0vav4unqz6kcs2;128654;2;292654;164000
1333;bc1pe265ln9se3pm6appg79y40wlajmu60afhfx05lq22sgvajw4apuqk2ky68;0;2;739581;739581
1334;bc1py6680k0rfr2yd5yryj6yvtq2083r2wtjlylygryhx58y8wx266ysxdfyul;128654;2;292654;164000
1335;bc1pt6ce4sjvyjczcjd2nc0y7lggha372kdw47zvfj9pcctn5vempdgqepxv2k;10000;1;10000;0
1336;bc1qmxyxs8jvlur05uqprzcz5mdadjvdh0lz5xsxly;971207;1877;391921458;390950251
1337;bc1pptwl792z4upwfacgm3lhtlvn92qksmlpqtum0v7pxr29sdfucftqzyd8nk;546;1;546;0
1338;bc1pqfjuh7kzapjuxpw8ug6gz3mglgzqhdylgwn58tc2emst9nlne2usr4e5jy;10000;1;10000;0
1339;bc1pgdl0dle37qk24e5art3zcj2x2k5wa8a8ct336ehumm8v4mku09jql8rxgy;174148;1;174148;0
1340;bc1pnr6pt0a7cn0jfd5cqx9raexvz6zzlj2krhxakln03jxgwc8lw2us3xd4tq;366868;537;111595500;111228632
1341;bc1pcqms2fr4ytkjda0svyrn56h0glpzq64mflerae9ku38rjluxusxqa954sh;3960736;143;3960736;0
1342;bc1p6gut4x0aw5upt942kufv686pr359jayyhe59gtxh9luaxglpeftsrecmxt;1169672;113;139900860;138731188
1343;bc1pje2hqa88h597pmd635gsr67juv2nn8xerg08ed8ehy86mdf75eqqw2nvzc;128654;2;292654;164000
1344;bc1p06xftpqvnm956wnlfraq9qj25dkyvtwwy8y95dwqxdl75rmp3lyszkwp4a;174246;1;174246;0
1345;bc1pz7xzep5ypv6wfkf0fsf9vt5hzs8pudnk5fkctgew9u4lh3uy0wsswzmer4;128654;2;292654;164000
1346;bc1pcjm288ummet7s9fmaeq8e0pcu79h7r4sfj7muenzcvcywxtnfats3qh0ja;128654;2;292654;164000
1347;bc1p8f9xw6z4nr5a6y32gz08jyv5dnwu9zh8fe2qsxnw4w04f246zr8skes86h;750830;1;750830;0
1348;bc1p9ptadeyumwd5vq6k8ynpvswtptpmf96f6lrxvndyy62hrppmddtslly9j5;744330;1;744330;0
1349;bc1pd09s7fp3zpstqzxyehhzgag5zcv30pxfl25m2pnfr78xaek7pqrqxw0j0k;128654;2;292654;164000
1350;bc1pajhyst9d3rwre8jr4gcxypzvaf6hkll6x4rmwr9xmkyxrg0epprseezp6l;128654;2;292654;164000
1351;bc1pq6g600a535sm6ndezmcf0ra44rxcsp4xf8fgf3j8jzrc68fl9vkqsfxdy0;282282;10;4123140;3840858
1352;bc1p4wgvmr5pex80hmsxrf8uucwkfjx5dl0zxcua86hrqrrv0gw39esqra55u7;251507;8;4981079;4729572
1353;bc1p3r6yx8awc2j3e4t758zy007pmk7vx9wvfj6m6msxn8m7pkpy6lesr76lt0;0;2;31883;31883
1354;bc1p5nuztqsh3vjyzqzvpfwedjecds0yddnw6frmy0hcf97pvexzh4lswwfgyp;750830;1;750830;0
1355;bc1pve7rtpj28650fuxymn4gqxk83dss23xex9s4wky5607cr752czqqzwfyf9;128654;2;292654;164000
1356;bc1pcjk4ffr4wpj3k4rmk8q4sftns9tcw96l808u3cgpvkzz3jscz4lq6cywa8;128654;2;292654;164000
1357;bc1p6wa9ef6jmwx2mppdu87ldrp9xv63e6q9k2y6v82265hyl6sdfs0qzlrktd;2220312;114;2220312;0
1358;bc1phaqj6cgr6ah9q0jtz5g79sh9h9ummk2lszrflrl2q3guk5h72gjsn5xhdy;128654;2;292654;164000
1359;bc1phwv2dx28medh7lrcgukkm8r55r00mrgc22uj2eshyrs72nexq9cqzxp4y7;4845680;133;4845680;0
1360;bc1ps5yk7m4yjz8eeu2cehuf3hguuqq7hhs7jzl2tx9d9pewhca8ydjqayakdn;10000;1;10000;0
1361;bc1qqjnnyznmw93lufuxyme0ljmkwjnwkvc35r92na;2521631;115;346445737;343924106
1362;bc1px9l76wsq9g9auzajael62xkq9532ctr346pt9d8mg6cw2nxjhnqslw07cx;10000;1;10000;0
1363;bc1plg70hnmsv2v9y0zevcwqyj3k6k8qvqtels6urx0eptujn2zdrgls7efddr;1580072;11;23142508;21562436
1364;bc1pq5z0hvxnewyz2kr40j4d32nx9tn0jx0vvdsvjnlckjekyhdm0j6qh7w6hf;15124907;2123;16272053;1147146
1365;bc1py6279x4r6all6wqhgpu5tx9qh2lapja0eue8c4vc2jkcplyf9zds2yx73l;128654;2;292654;164000
1366;bc1qznd382dqapcp0j2xf5jyu548g55743jy3ywwqc;6764066077;4895;198238889896;191474823819
1367;bc1pezfx2z7stszhvcrpjwvmje9eavtvk4850krg3333n6qpt0fg4uhqllmuw2;10000;1;10000;0
1368;bc1pstgxfm9er2d8ls8wc6smlp3qc80kuw5atpksydrp85f75ld3vl8sllw94d;128654;2;292654;164000
1369;bc1p7hwthws2lzhy033pf3860ykthljxcsn9q75p90z0lkpgawxuagascfw2py;10000;1;10000;0
1370;bc1pv46up8cmvzjchpjmrhaxpyjtctyxep5pa0v8hyh4km6vaxme87xsp58yv7;10000;1;10000;0
1371;3P4WqXDbSLRhzo2H6MT6YFbvBKBDPLbVtQ;16610232766;955087;49995343805;33385111039
1372;bc1pn5sc7qc7770mc9g99dc4nnmnam27w5qszs6mnz0ghk6fzcc773aqhyyfu3;128654;2;292654;164000
1373;bc1q58urmlnhel5eg70qtkklr8dcpvf6xl68x5q4xa;856938;5;4537950;3681012
1374;bc1qf8hp6xxtpds0q7a06suzy5q572j08f7t8v60g6;0;6;693390;693390
1375;bc1pyk7y0lapmzs0hm56vcahuq53tryuzcv535fcp7jz94hmexdzvwtq8sl7y6;420187;3;720187;300000
1376;bc1qpp75mwld096676xpcxlpcsfrwuqc6qpcqngfty;1191612;6;7529562;6337950
1377;bc1qn0ygs64ptkz72wk48d9qh6tnx7qxl2kf5l5fmu;826938;5;4387950;3561012
1378;3CmYbBAK6zgX2q428FLiSRfPrQS2ibp1XF;1530265;188;176184451;174654186
1379;bc1qrnshtks9qsujmaa45cnx4sxxpvrgmhjlv7xq90;801612;6;5189562;4387950
1380;bc1q69j6hznsqfv3fvj9xzvswx6ne4eseql5m05z7s;426938;5;2387950;1961012
1381;bc1qg0gzyntp6spd737eg5svflx2dvg4kmr3nat3cj;1221612;6;7709562;6487950
1382;bc1prt95fljyy5hl2rwvz9ddwmr6ctkuj3vkwpzfgz4hl9sy9m7vjxjs9jcncv;1733161;200;312431140;310697979
1383;bc1qy2eme22u5vnv0p8du73hd3q7qg0sfvqndjetn8;4826938;5;24387950;19561012
1384;bc1qzk7tuseh5aemw3quxrdxgffunaxq5ayd6f6zjs;0;5;6735664;6735664
1385;bc1qwxxpmx2uhv3gmr49mcmufhn8fxs7x4xqwjl8qk;4826938;5;24387950;19561012
1386;bc1qfxpq5wr5u48huvv3rt3xnnzqt4r2rvsq9plx0h;1362577;5;7065542;5702965
1387;bc1q3ttsqkv6a5nxpgz3pvtgync94rsx3lfs69tqs6;213738;5;1321950;1108212
1388;bc1qgjv6wwzla70t02vzey622k0fc3zlhg4qpxludd;4227938;5;21392950;17165012
1389;bc1qtjnrg8nxhnpyz5rehdjmaaz9u63awk9rtx80du;4826938;5;24387950;19561012
1390;bc1qfjgjq6trwj6zva9j4d5t9z6zkmzdadvz892qya;4826938;5;24387950;19561012
1391;bc1q5a6prwnlmv0u50la4xv55lkglaqyjr9vjpl3t0;856938;5;4537950;3681012
1392;bc1q5n78ag6f2x5m3amx5nssw2jfl7jcdfqukf0cfv;4624249;8;37703120;33078871
1393;bc1qdvdqa9flulmtvrru55vxv2sgrfzrwha66h9sfv;0;2;164242;164242
1394;bc1qe98akxkl8m9l8dvtpmdngwrlcypjwj5yw3zlpu;0;5;527108;527108
1395;bc1q4mawrrchchj4gdy6jp95jut5jl4z30ztz8jm0y;911572;5;4811120;3899548
1396;bc1qhkckkdshkjgtuyu9m8m0eedlg0npg42h6zzpk3;527497;9;5659209;5131712
1397;bc1qzr7ew2vpd4zkac5gcl0yrxcl8fsx7xza8wgawa;776286;7;5965848;5189562
1398;bc1pxfn9884908xlcqlg07swmq0du73ht54s5j3nt2y9h4zs6mwq0znqa2nxgn;772882;8;1962496;1189614
1399;bc1qstxx8hx6l22gj2c5lfdecfl50tyqska6ztdjn8;475938;5;2632950;2157012
1400;bc1prutwzwtnh920q8g46ndeu3utx6lctrzzvfep7em8ns25am2yg9vsfxhndh;21246534;997;21311380;64846
1401;bc1q7zuhjmxgqqly89p8gqqpnfnrarlvsvlfrnegmu;426938;5;2387950;1961012
1402;bc1q300m2ywp7ahy5w2l3jfx2a4es0ku8ws0kl5gtp;1290225;5;6704385;5414160
1403;bc1q6aehuxkcy9rjsgyfv23zd7xt48x8kanjv8xv2x;726938;5;3887950;3161012
1404;bc1qpcvpfrqru44dlqh6alz36jnlhr0s2fhslspx49;0;2;284242;284242
1405;bc1qf7mampawe0cttja6kn3tpj7td2hc3kqkyldq6l;750960;8;6716808;5965848
1406;bc1p0xtsgv459cvgeqt4ccqn444vnz2e7gpyru50r4cvw4jdad3pqu7s25ulur;255187;2;555187;300000
1407;bc1pwmp5j8uelpf2k0ejxhganz4wyw2hn36z082ughfxv7ap89qmftcszrzq6s;4570187;2;5493187;923000
1408;bc1qqag2ye7wpq8w0dsyvs0k7jz73xz3wqfpv4h97s;776286;7;5965848;5189562
1409;bc1qpnjvf0fnakw32ug5pv4e57j440kjpwpsl7t49u;2056938;5;10537950;8481012
1410;bc1pagpgysupgemtgndne9v9xhzkfsnhev9zm0klmp0vzz05ysm9ys8qmxupyz;255187;2;555187;300000
1411;bc1qlwalzd83xasehnex9f84xsesshg3c8smeu4rzh;401612;6;2789562;2387950
1412;bc1qchnchspj7q8qw6ssl3zaplcppugd9hp4tt3jry;825267;6;5331492;4506225
1413;3JnkaWVwWjv1WavcgAm46jxTHfNd4ucr3B;3016074;7;8949654;5933580
1414;bc1phhyakgjymfss6yfpxyhn45n742yg3k2tu4nadlkgc5cc8zy08dwq9fk2lh;127861;3;327861;200000
1415;bc1qpfcf95cyfwt0xsw49ccns8vrzx5m4maj623c3h;750960;8;6716808;5965848
1416;bc1qch86a6qy60xx4mtrmcz8msz30kerppa5ev7chk;4826938;5;24387950;19561012
1417;bc1pq5z0hvxnewyz2kr40j4d32nx9tn0jx0vvdsvjnlckjekyhdm0j6qh7w6hf;15124912;2128;16274788;1149876
1418;bc1qk309gzmelkz7r68re77hla7cykw8ahxwhdyf37;1426938;5;7387950;5961012
1419;3P4WqXDbSLRhzo2H6MT6YFbvBKBDPLbVtQ;16621550590;955134;50006661629;33385111039
1420;bc1qmea9sfd7c9lnqzjpepj4gnsa3fef6m9zqz3dng;1327264;4;5461012;4133748
1421;bc1qrhgg3t3qraxhj4r79my3gxgwh0jewrr6fa8fs5;550244;4;2352932;1802688
1422;bc1qm37x3p354kq69fd4djwudck99unxndxs0madn0;2107590;3;6398748;4291158
1423;bc1q8clwvk9nv087n0weru29u8ckt2rhaf62502mlm;2132916;2;4291158;2158242
1424;bc1qgpujwrzvaaxqq2fk8lcg4dc227q89erqf7rtqt;0;2;104337;104337
1425;bc1qskfx59w330lax5d6gup4cspgvrctlrkrks239r;827590;3;2558748;1731158
1426;bc1p66f5pgzz2akuz2lhc90p95c2zttzl3p78uvlfl46xnkws3eaz8fsmpyp6x;2566259;2;5241259;2675000
1427;bc1qxdhze32kner7erntnuyxpgt96cs3jwjlymxm7k;477590;3;1508748;1031158
1428;bc1q9h8j0y59gpacsaxcz6ta0ryq6a0qlpgrlawkst;897916;2;1821158;923242
1429;bc1qjz0knlgtrrgp7hw0rel7hcvjupjendlg82ymtt;527264;4;2261012;1733748
1430;bc1quzx0h05m9mtejj73y6s3dsrpp36ue0lrjja6y7;515606;4;2214380;1698774
1431;bc1pwj8252df274z3zh9dnpyer2wgepv5jyrss52q824txvawjdj5urq2uq9w7;247861;3;567861;320000
1432;bc1pcfs5sr5znp22pllkm96nmq093nms9azuz5ly2rst8eu75kwzfa8sut5r6m;155187;2;355187;200000
1433;bc1qvts28qymrjl9ysnn0ez0wsvarxhn8rgy37qhfc;4877590;3;14708748;9831158
1434;bc1qr9cpgch7qurlmqawtjpfdu9s29ap5vskanp2e4;502916;2;1031158;528242
1435;bc1qwvtrvmp29llap2jyex6xjjsyem929n5suduw08;493990;3;1557948;1063958
1436;bc1qzsas8klh8506j5rf5qkrdqzrgvsu6pdqm54jes;1409679;3;4305015;2895336
1437;bc1qwxxpmx2uhv3gmr49mcmufhn8fxs7x4xqwjl8qk;4902916;2;9831158;4928242
1438;bc1qjgstae6nfc7k69ryzdufhzfm54kz5lfj38pu94;0;2;164242;164242
1439;bc1qx8rl5ykuka3xh40fvt6hzttj9nzwtu03cqypfl;1267590;3;3878748;2611158
1440;bc1qlzlehpxa3cfedfzdt85jyrztrkw6guzptv9ckf;0;2;164242;164242
1441;bc1qgfulgchywkjun2hqftlhsajh8q5ym4dluvs5cr;1858254;5;9544530;7686276
1442;bc1q9v9hjwf53mtpj78jjmhk5vmjqk9097679uul3y;637590;3;1988748;1351158
1443;bc1q4fp8jvcjqwtawm2uvt2hx2g2rdytcrjxc2ysja;502916;2;1031158;528242
1444;bc1qfjgjq6trwj6zva9j4d5t9z6zkmzdadvz892qya;4877590;3;14708748;9831158
1445;bc1q2se82hctuqkqvuzf7fyq0y6v6m2l94ppdk59zt;801612;6;5189562;4387950
1446;bc1qr0ndrj04u96ckujmakxprpqaw2yzajrgcjp52c;240193;3;796557;556364
1447;bc1qdsfkfal73cxqrypxsqffalms72n022glqurnfh;0;3;4099158;4099158
1448;bc1qpm2dqtqd8nvspku93kfzuczakn89q92xgn3kjl;729770;2;1484866;755096
1449;bc1prprvzarzvtk624edyflv59q329ykku5r0ppagszuw3hpzasgf2wsk7r953;2861;3;77861;75000
1450;bc1qnw5uwe05u5m4ddukmd37c399729qfp9y7r94ug;369310;2;763946;394636
1451;bc1qv8ee7qvqk02fyxy2lecxpdj24tff3ffa42xekv;877590;3;2708748;1831158
1452;bc1qmu92p3t8l3prn7jwtlkt592hj08ns3tensst3w;2132916;2;4291158;2158242
1453;bc1qa68klf8hqlu90d8rnqu7sytsws5czpsf2etwjm;4020790;3;12138348;8117558
1454;bc1qkr6mrmz89je3lgk5lsm24200drl8htq39kr67t;740899;3;2298675;1557776
1455;bc1qzywtfglqsac4lqzmaa7h95rg9mgehkj4q6fsmz;1255590;3;3842748;2587158
1456;bc1qj5cgkpx93t4n8grnypq8e607def7puj02au0fx;565932;3;1773774;1207842
1457;bc1qv9xgwydqpf9wm7servmxmjnw2cgl3jnq5esn9x;679316;2;1383958;704642
1458;bc1qhdpravfysev2jmr3kxzmlp7g6xkkm2khk23px9;932916;2;1891158;958242
1459;bc1psps874e7glxpd4xcjglkmmakuxz22afssnsvrftpeqpsmvd3k3zsml0zg7;255187;2;555187;300000
1460;bc1prutwzwtnh920q8g46ndeu3utx6lctrzzvfep7em8ns25am2yg9vsfxhndh;20459088;963;20523934;64846
1461;bc1pr5yuff8g2ah7u3e9faatywy7z57slnfwpdex6edr6mmhdyvsuk2saavlfq;6455187;2;12955187;6500000
1462;bc1q73gurwal54tznqz57e8u8crefv5kvc2w9p6h6w;2107590;3;6398748;4291158
1463;bc1qv2fnhqxfnmsxg4x7xydzpf6avlac2hmam4mcc5;497590;3;1568748;1071158
1464;bc1qrh6jqpa865d9mcnehx8832tuq5h6wef5pk2chq;1277518;3;3908532;2631014
1465;bc1qzuk99wa6lyu7edw2lnuntr6s604gw3utges80y;502916;2;1031158;528242
1466;bc1qcpxx2h9ldt5cms5aa49yzwqqh8t5v6g7z570hy;77109;3;307305;230196
1467;bc1pnhqecv8lztgd4s8wwslvmnquv0pctygwtsykn6nfj0k5nfxy7stqu357s6;255187;2;555187;300000
1468;bc1qz48t76r232yyn6yelkdvqtsdc07450zt9tjlzw;795031;3;2461071;1666040
1469;bc1q77w77v79n9gnacx25v9pn00l5r0nxytwewnww9;0;2;39242;39242
1470;bc1qeylxdq23mqqw54yyjq49fws6lwm2htvvk6x0uu;1602858;3;4884552;3281694
1471;bc1pjfx4sehefj6qv6tnyjwwymnchfufrh6quqg7c6u632s3qu5ud6cqfqfs4w;67956;3;208051;140095
1472;bc1qxjemzpyvwhk4y50hekkv367p37gg5hjath59wp;502916;2;1031158;528242
1473;bc1qchnchspj7q8qw6ssl3zaplcppugd9hp4tt3jry;901245;3;2779713;1878468
1474;bc1q635eqaqhwfdkkf8y97va20mhdp5sru0a9qff7n;1477590;3;4508748;3031158
1475;bc1qz53z97vjsas6280tuhwr5hnf8fe7mc9t8jdstu;477590;3;1508748;1031158
1476;bc1pg3u7uv3nsuv3t5q5pqz93e50lgzjy94u6drjmcm5my2dnpkx8jtqp42aaf;55187;2;155187;100000
1477;bc1q95nl4dpdcz3336a53vpp6us5k6lz2cng4pp000;1882590;3;5723748;3841158
1478;bc1qc0dkysmwf5268zyf9antnxlupnxzgj3tnr5kyn;3404681;4;13770680;10365999
1479;bc1quc3scx4ggt83p0pa0n7kjqsyztel52neeftlq6;169527;4;830064;660537
1480;bc1q3typvr52aupdm32tfq372y5arkeuwf4rkh3dlh;827590;3;2558748;1731158
1481;bc1qcspz8q69l6tq28px8necu2qy8llsf4y4qgnufp;222243;2;469812;247569
1482;bc1qq6yfzsvkdte5q5vv7a2zv3l33sxdpmlxua8jtd;0;3;2977096;2977096
1483;bc1p9c9f9h8r438hnj355dv6hmsrp04ul292690gyd703598u88rs4ksmjupqw;255187;2;555187;300000
1484;bc1qpd3gvxwe25neqkac54xtxsqq7jkgk0zwkursn7;1267590;3;3878748;2611158
1485;bc1pqz7l36tmhjre7luucyp6jtsue5k24jhkquretjtma9z8pv6rctaq9ttv50;2172920;35;5778918;3605998
1486;3LoeoeWJy2MsuCQ5mEDdjX598iF55W8vD3;49548554;2;99548554;50000000
1487;bc1peeude4pmjenf3ymmnduc66eae056e6kekhwaaw3ldajwzwlfctkscevesw;155187;2;355187;200000
1488;bc1qmea9sfd7c9lnqzjpepj4gnsa3fef6m9zqz3dng;1327264;4;5461012;4133748
1489;bc1q9z40asazs4awnu6xp5rj8y3tc9a3z4mfgd3nst;2082264;4;8481012;6398748
1490;bc1qrhgg3t3qraxhj4r79my3gxgwh0jewrr6fa8fs5;524918;5;2877850;2352932
1491;bc1q78lkkxxnkpjxzuek3m6lug45r827kwmlus2g94;627693;3;1959057;1331364
1492;bc1qx8vw9dmluyzrwhrm40p3x0hu68rtdhzgwypzwt;452264;4;1961012;1508748
1493;bc1qpp75mwld096676xpcxlpcsfrwuqc6qpcqngfty;1191612;6;7529562;6337950
1494;bc1qqfzg2zf609lr5tdahrnzq7w8q0hsc4e6cgn6w0;1439395;5;7450235;6010840
1495;bc1q8clwvk9nv087n0weru29u8ckt2rhaf62502mlm;2107590;3;6398748;4291158
1496;bc1qn0ygs64ptkz72wk48d9qh6tnx7qxl2kf5l5fmu;852264;4;3561012;2708748
1497;bc1pk34jrzejcngwj230veu7ptcuuk5cs7cs9am4eq2uprzgh22npwks45me8e;5001499;4;19922811;14921312
1498;bc1qxdhze32kner7erntnuyxpgt96cs3jwjlymxm7k;426938;5;2387950;1961012
1499;bc1qra965uun2ayfgkefsnawl3c44ea946nkww2z7x;873264;4;3645012;2771748
1500;bc1pv5kvazz9t6yqjpjkrqlh7luh4tqq0z5cjwfx09c8ucv4x9ta8krq936tlm;313355;3;3771523;3458168
1501;bc1qlzswa598g2hwn6cgjzh5fyag89nf2lv2rlcah7;882264;4;3681012;2798748
1502;bc1qjz0knlgtrrgp7hw0rel7hcvjupjendlg82ymtt;501938;5;2762950;2261012
1503;3MFXN7QZkPmCJKamHMdQv7x2SmkGRDFgtW;5710913;2;11513080;5802167
1504;bc1quzx0h05m9mtejj73y6s3dsrpp36ue0lrjja6y7;515606;4;2214380;1698774
1505;bc1qr9cpgch7qurlmqawtjpfdu9s29ap5vskanp2e4;452264;4;1961012;1508748
1506;bc1q49kzw342uyk6hxrj4anez3rpcwcczensks5mz6;0;2;164242;164242
1507;bc1qdr7ux3vp9wn233nzk60hq0kxwdn6prqylu2lsl;877590;3;2708748;1831158
1508;32SfvhPWyN67DQberA8yvnqbzu4nqhMvci;8801378;318;318602600;309801222
1509;bc1qx8rl5ykuka3xh40fvt6hzttj9nzwtu03cqypfl;1216938;5;6337950;5121012
1510;bc1patt79g6x9qyee62r3pusavstl8vxdaa3twpkq9gt7sut33z9vrjs5rzzp7;245187;2;535187;290000
1511;32CacKt9cEQrPWNhWU77q46Dk5EZhs4bkD;2919325;32;64676110;61756785
1512;bc1qufjtcz2vz9p64cntvvn2xn4gr5hevjq4k7u6zz;0;5;4816616;4816616
1513;bc1q3ttsqkv6a5nxpgz3pvtgync94rsx3lfs69tqs6;239064;4;1108212;869148
1514;bc1pylq20lqa6r0n5ersgz3vaunnu70xx969audd9phnwdttlm8zmtxqmxg53w;155187;2;355187;200000
1515;bc1pjqx7nundrjuu0037v0plyy2vunswq84j7tdpj6efxnp8xzhkzxaqy547sd;430187;3;670187;240000
1516;bc1qm3cpnh75xvt9n5u0dh2zquflumm2ynlq5p0yjg;1917082;5;9838670;7921588
1517;bc1p3tpsrvds2epaq95wyuychgmtfyjk73ue2rvnhyyll7vn5azg9has24emdx;245187;2;535187;290000
1518;bc1q5a6prwnlmv0u50la4xv55lkglaqyjr9vjpl3t0;856938;5;4537950;3681012
1519;bc1qtzz25qkkyse0evzlfm2yf6h9qfeu0v4kckc4rt;1242264;4;5121012;3878748
1520;bc1qnw5uwe05u5m4ddukmd37c399729qfp9y7r94ug;0;5;1426588;1426588
1521;bc1q5n78ag6f2x5m3amx5nssw2jfl7jcdfqukf0cfv;4649575;7;33078871;28429296
1522;bc1q4n4kk8zdr7dq9q6ytzj73g6x4fmftm3ta5tvy5;4793903;4;19327568;14533665
1523;bc1qmu92p3t8l3prn7jwtlkt592hj08ns3tensst3w;2082264;4;8481012;6398748
1524;bc1qa68klf8hqlu90d8rnqu7sytsws5czpsf2etwjm;3995464;4;16133812;12138348
1525;bc1qkr6mrmz89je3lgk5lsm24200drl8htq39kr67t;740899;3;2298675;1557776
1526;bc1qzywtfglqsac4lqzmaa7h95rg9mgehkj4q6fsmz;1255590;3;3842748;2587158
1527;bc1qv9xgwydqpf9wm7servmxmjnw2cgl3jnq5esn9x;653990;3;2037948;1383958
1528;bc1qhkckkdshkjgtuyu9m8m0eedlg0npg42h6zzpk3;552823;8;5131712;4578889
1529;bc1qzr7ew2vpd4zkac5gcl0yrxcl8fsx7xza8wgawa;801612;6;5189562;4387950
1530;bc1p6p9dvsjh346vh9nhnk7np9t27qdufxe0y7dz4aj5cusm8rwe8hjsghclu5;55187;2;155187;100000
1531;bc1qhdpravfysev2jmr3kxzmlp7g6xkkm2khk23px9;907590;3;2798748;1891158
1532;bc1prutwzwtnh920q8g46ndeu3utx6lctrzzvfep7em8ns25am2yg9vsfxhndh;20841522;983;20906368;64846
1533;bc1q9grdxyuxumpm7xxs2q669yk9jk3l4c3fsk5074;815713;5;4331825;3516112
1534;bc1qzh6w7rcfxft2hqz9afl4qhdy90r2887vk7vf7q;2023398;5;10370250;8346852
1535;bc1q7zuhjmxgqqly89p8gqqpnfnrarlvsvlfrnegmu;477590;3;1508748;1031158
1536;bc1qc8s2xn8dyl90xv366hcxpl9tgz5jz7y76fkqnu;1082264;4;4481012;3398748
1537;bc1p4szmv8gjfkt7rn0fd93lnfdzn2ufhjk9dsllanyl99cfwefsau8sufghu2;155187;2;355187;200000
1538;bc1qu4lynmxf5xlwnxtnuf484wgwy9j33ewxhksef3;2809660;5;14301560;11491900
1539;bc1qrh6jqpa865d9mcnehx8832tuq5h6wef5pk2chq;1226866;5;6387590;5160724
1540;bc1qsh29kuk4fsvqgvcp09amm3ewhwhvjeeg7qg50r;1158301;4;4785160;3626859
1541;bc1qf7mampawe0cttja6kn3tpj7td2hc3kqkyldq6l;750960;8;6716808;5965848
1542;bc1qjdkmyqv5te468lclzwjl3rgyvjqd9s7mae06mj;0;5;681012;681012
1543;bc1pmdz4ugcthg9tg8u0x4l40y06vtsxrh0yj5ndel80uvtjdv429resdu80np;802625;58;40760261;39957636
1544;bc1qcpxx2h9ldt5cms5aa49yzwqqh8t5v6g7z570hy;0;5;359088;359088
1545;bc1q5hzwndwdrc9udhy48rwn99q8j2f2ux75v8egqm;1056938;5;5537950;4481012
1546;bc1p264xzyqea2eushzzmplvxgkk9xpunw3mkfwdpzcf9rcswdpcw05skgf50l;804183;34;2541236;1737053
1547;bc1pdph84du52xakwjg36apjfsevzlw0nzjww075d5sfhlq9p5hrg4ns9dqqsu;155187;2;355187;200000
1548;bc1p8trehnmh496mlmv93tezdps5q66ngxgeccpupuz5crxk3j5539jsm9g2vn;55187;2;155187;100000
1549;bc1qf44klzxrslg7tkel3twtgamvx6upg4nd4y08hw;1027590;3;3158748;2131158
1550;bc1q97w8ur698ndq806z8nxkayjcplpetcx3ez0p8l;1242264;4;5121012;3878748
1551;bc1q02wxps8t52h6lzm5d9ukxm3vxmyjjrq93mkf3y;1272264;4;5241012;3968748
1552;bc1pukxjpfnsp698sdyxznxg0fxdtnaq70kmrcy9euquvg73y0ge94pqpxqxj9;0;2;34303;34303
1553;bc1p0v3hwjfw2689xr4ph8arfch0p3etjw9g0w877gsxfanulpc0cd8qyt3df2;2009554;41;24600116;22590562
1554;bc1qewef2u4d28pygdhfd9vacr4qjl7gqr0sulu2pk;2082264;4;8481012;6398748
1555;bc1q0sujfc6xs745csu6qc3n9qvzyay6p0pq2p2g06;0;2;149742;149742
1556;bc1pm9m9jwuxnap8cwrhnlaf9y9xj0y07wac25585d75s6968gp33wks9m02qj;127861;3;327861;200000
1557;bc1qkgpc0rkyxyhmuymsaydz3k2vr2rk8xu0qtw8ae;29863268;3;89665782;59802514
1558;bc1p70w2xwxfp5e86evpjzupqfefklupuwtpgc6njmrl8m0qug3m396svu9z84;127861;3;327861;200000
1559;bc1q2xzuklv5xekjeexhas95yep6gc6w30lt32pc7m;0;2;401078;401078
1560;bc1q2qurae35spl0p5tw8r2mpj4fu9gzt0wkjtrjqx;1297590;3;3968748;2671158
1561;bc1qlwalzd83xasehnex9f84xsesshg3c8smeu4rzh;426938;5;2387950;1961012
1562;bc1qtw9ht9xkh56txqqv9g4sya0rc60vw02rxd4uxk;0;5;3681012;3681012
1563;bc1q635eqaqhwfdkkf8y97va20mhdp5sru0a9qff7n;1452264;4;5961012;4508748
1564;bc1q5nczf0tmasj3h54mfzslg3ymnx7uxa5h4saqkx;856938;5;4537950;3681012
1565;bc1q9cvmpylmegz5ed9qdstekafxxgtx5elhdhtm7e;717800;4;1534800;817000
1566;bc1q95nl4dpdcz3336a53vpp6us5k6lz2cng4pp000;1857264;4;7581012;5723748
1567;bc1peygcydkr5k7ksgqfuqel9r4fkcegjl5qjne3knf9t690ha449vmqk5tf7v;113361;3;298861;185500
1568;bc1qzu2srjdcd323zy5zufcddd2dr6sf82c3vjvzu8;0;5;6019108;6019108
1569;bc1qqxzyxflm7yggp336pzxujrqsxmgf3eu0nqdv5x;1216938;5;6337950;5121012
1570;bc1q3typvr52aupdm32tfq372y5arkeuwf4rkh3dlh;776938;5;4137950;3361012
1571;bc1pdjlxt7v4572fqkrlzdsx986l6zjtvl9s7ymazc4cv3rpxgqz3wlqhc76uz;114812178;7899;411800672;296988494
1572;bc1pg0ssang97swjzpyct9lvteup6ss5mwkyy7l4pjzvvf0ptwe9z0tsnp2lyp;127861;3;327861;200000
1573;bc1p4mqml60xhptsl9zff65wslg9jwefg0dh8vh2ypa6405js7q9tmus2vt0qr;55187;2;155187;100000
1574;bc1qd40y6ll4y5hgh3du3l2sx2mcwnrfmdwdgjvack;4823264;4;19445012;14621748
1575;bc1qcu5efyktf59c9d3s06e7y4vcvqzggr4pff0c4l;1846938;5;9487950;7641012
1576;bc1pjkg8sruh22k0rh5vcy869urs8rnm09pn8cce5vhqzk4vmk8gxceqtd5pgn;245187;2;535187;290000
1577;bc1qpd3gvxwe25neqkac54xtxsqq7jkgk0zwkursn7;1242264;4;5121012;3878748
1578;bc1qk309gzmelkz7r68re77hla7cykw8ahxwhdyf37;1452264;4;5961012;4508748
1579;bc1pwjdvd6lwts2fc9w43eztqew8mzl2vtntxtyxaf2le0sm3vg5spcqsv5tce;47121;1;47121;0
1580;3AHoReRbLMyznzsQUEW726cVtE2CxA5zxr;45482;13;1804643;1759161
1581;bc1pkspegsv98v8gyq6dsn7yp9092r8meszt6md6weanjzm2kcvg499qftqzgw;255187;2;555187;300000
1582;bc1p3x5nalrgryphy20tqskgsxt5fsljwnvs4uxq76m2nc54s8d4vs5qcuct0n;23828;39;42163;18335
1583;bc1qr4pwg3neqz8a7q6hyf6k0wzjkt7h5ycasplx87;4813793;9;4813793;0
1584;37r2GGACpFkBLCZwtiMFKuYVredemUJEZq;1877911;1861;1493134821;1491256910
1585;bc1q9z40asazs4awnu6xp5rj8y3tc9a3z4mfgd3nst;2107590;3;6398748;4291158
1586;bc1q8u28wa6ya3un87ed4p65vwsettx56p8ksxk9hj686cm8undpg4uqefnfke;31000;1;31000;0
1587;1MhGPVhcD9rW33JHrD1ifmL1rQP2RMRfYd;10000;3;704679;694679
1588;bc1qzr8sq39gqq9xle0dldyum4cadgv66qcallkj5r;3077723;100;116027689;112949966
1589;bc1qf8hp6xxtpds0q7a06suzy5q572j08f7t8v60g6;88026;5;693390;605364
1590;bc1q4l6c0fy8gpnsf43jljlvpmt2qel5fa0m8qrxtl;8773317;5458;2613418213;2604644896
1591;bc1qfsunevmz4hkn2ej7yavezrsfpv4eek6uqd4ed6;988000;3;988000;0
1592;bc1pkfa2ekm4fyf5hwewu5hdu0rlzze2zuakt53xs3r7e9hhpld7pjusptck3s;1425;27;150522;149097
1593;bc1qu9khjx2883p4n2p35llzstxkrgmjf0c4czfmhm;220000;7;768000;548000
1594;bc1qt8ve05thw9qal46srlaxght37ut9ck9x2jk92t;547000;3;547000;0
1595;bc1placev5aq0w6nf0uvrqzek929na3d4hjly6hjekefayu4hnsfty4qlgu0qf;385450;1;385450;0
1596;bc1qk9txjt8tmzpe7a934t45zhnmepx07cuzemssya;730000;1;730000;0
1597;bc1pm67xgqxgqvfqep6s0t6tkl4kh65mwcpnxm3kesjtzwa7g90p6cnqg8yxmt;2033600;2;4106600;2073000
1598;bc1quey76eaw0r2sxfq6u08ea26xg28qkledfvs5u9;1638341;2;3302008;1663667
1599;bc1qgjkpu7knxfhg4ds3smlqjru4wvdlun3cjge4hm;190485;2;190485;0
1600;bc1q8yndz2gh3h4pjjyz2k9heqas057ud3zsyjefr4;312814;16;2862019;2549205
1601;bc1px6wluu420jtspathrsqvrc6a7v4ngxf59z6ymuudx5vmf6af5kpqecj7rw;146000;1;146000;0
1602;bc1pjfwprqgr429xy0jgzm36wuz3m3z4jy0k9rgw3yhthva70sulgccsa0rkh4;4337536;132;4337536;0
1603;bc1p54cfrfxe9uczz8y4y5lttyxcfz5hu7uu0lw4wswr2y8zpt5fxtrs568gvn;3000000;2;6163333;3163333
1604;bc1pqxk7pjfm6kfuffv72qtm45r220auxprukem9hjld6wk6pfs60pfq7evepk;162655;1;162655;0
1605;3E9va1rmKU37fAVA8u81CMroLFgwkTY8LZ;1409538;4;4520959;3111421
1606;bc1pa2c34ky9pw5qlpjxyr067f5eycmdky6g3emnplcp5tuuvx3t6ztspa6x4z;385450;1;385450;0
1607;bc1p0n39t4lvvk632ckyefh0a83vcpswe0p0auc47aay5xz9rkesnf4q22lzr4;599201;3;1901947;1302746
1608;35j7jjRfiVNGQCPNLc4EZgAieCNbWHG59k;390169;2;888920;498751
1609;bc1qm850zesjyl9r3xr0u2ccjdkrp2pm2af5pp453a;798756;8;24968289;24169533
1610;37yxnX929L1Pa1afzs8y4C4NmPPa5fqQUG;57000;1;57000;0
1611;bc1pwjna8h2epv73aa4atmqfztm9mj25f957vdemprn7ezukygwcrz3sm5xk49;3949592;124;3949592;0
1612;bc1quzx0h05m9mtejj73y6s3dsrpp36ue0lrjja6y7;515606;4;2214380;1698774
1613;bc1p97tzhadxh5ns7k3jldk5lq7auuhlxnp90rrt84xqwcq2qyal3s7sfjy2uc;2963088;122;2963088;0
1614;bc1p2qy4mtan04hpafdkwcvfl3mchxuwzm6prwzez0sxg46zum7kuyvsu684zm;49373018;130;289561299;240188281
1615;bc1pv0fe6uqx4rpcxuyzg3fkwn4r2rvkd77jj96a55m99ya88dwyxees7zxpcq;200932;565;5042296;4841364
1616;bc1ptfdmrcnv3tslyrvqakhj50tltyuzgh788j2t4lmhz98qsrlhvn4q2nclsx;10000;1;10000;0
1617;bc1q7797yygldjd3ljjjyjuvwx92vqk2lns30uukzw;393380;9;393380;0
1618;bc1pt6867y0urx8tq4pk8kggmanc7sqaeu0f3zgdt0wrnuq2tw50anvsnnvznr;255187;2;555187;300000
1619;bc1pklq45zryd33sgnj9wfa2v0qldzqe4xgj33hj4awz8x49jm9cvh8qvvlljl;2736576;2583;8368550;5631974
1620;bc1pfkeucus4aw804ncywml7zecejde694tam7a4pa5h9hhu0n5y929sclw0qu;0;2;87808;87808
1621;1GVVnPKXAwYV8gn2k1TWXjmfhQTokWVsUo;64000;1;64000;0
1622;3P5xWKdg7wuvgidWsGFUS7rukEJQry5MXM;340719;69;6599126;6258407
1623;bc1qdr7ux3vp9wn233nzk60hq0kxwdn6prqylu2lsl;877590;3;2708748;1831158
1624;bc1qx8rl5ykuka3xh40fvt6hzttj9nzwtu03cqypfl;1242264;4;5121012;3878748
1625;3Lu2G4BSTXziXZi8ETeJWqu8wqXBeP3kg6;758572;40;7431733;6673161
1626;bc1p7p280deamvtejwqwg0aml6xju6xs8vd640pjvle4eudehmtn7efqyf0pxt;10000;1;10000;0
1627;bc1pg2a6up9335696kw54nnwtxemtk6hzcwmqlr482nah89jd38d94gsg5g32s;52092;1;52092;0
1628;bc1pr4d86gflrf5qdy0xuck7r3p5969xjnzjux5qgwydr525uva5dwkqlgcrzl;390495440;7849;1026162215;635666775
1629;bc1prh2m6us4ru25uaqptc9qhk9729pgxhlhk4kanse4arwxr9f426hq3qffnz;50600;5;50600;0
1630;3JSGCPVWddhTE1T2ipQFZPYiDWf3PqcC1k;1669643;3;5563418;3893775
1631;bc1pv8nn0kvzh8cpcz30yrxns77r504xe9fyqnmtes2p7hjcdxq5jv0q3lr9l4;2184;4;2184;0
1632;bc1pgxqnhcddfcn0h4za3ww57t9rtr3hf9cmurxzk4828cmrchwjztqq6xyg52;60973;12;24462410;24401437
1633;bc1qgfulgchywkjun2hqftlhsajh8q5ym4dluvs5cr;1858254;5;9544530;7686276
1634;bc1qvs2hts5u0mk06ayecd3m85ps5w5emuxtlxeg9x;46010318;9567;104442666;58432348
1635;bc1q2se82hctuqkqvuzf7fyq0y6v6m2l94ppdk59zt;801612;6;5189562;4387950
1636;bc1pr7kmrsnp80rdq8adjn5zp3anw7excq20tmc6trt4jm7mj806mncsef8c7g;10000;1;10000;0
1637;bc1qzw0var88kcn6n7drm8ug5q8p7m0dz0a3hnmssh;706000;133;27453316;26747316
1638;bc1p3xw5mv6tnqx0vszxeqgjhdcwmf3dajlpndzmy00lrlf4w3sqgcgsw3rdy7;1092;2;1092;0
1639;bc1pcknq4nm6fdfu8xs0cr4clft8l9yesrjmnsq4fmepg3g9asz7ynkql3tjy0;566420;3;1868497;1302077
1640;bc1pu099cqm4jg7927p3ar28j2778zwkx4a0e4c2hsaszr395lrurjas3f308m;385450;1;385450;0
1641;3M1w8DHk2VY5ghgBo2pTNPtxinPNa6RcrZ;1484869;4;3045738;1560869
1642;bc1pt95htdpm8ga60h78znwla9rsaakt96jxe9s8jgy0qtdec9qwc0dqh6a2ne;233514;2;581444;347930
1643;bc1qpgv48cxeaj4vpm7ezqfvc3kr8xvuyz8jkltp7d;41000;1;41000;0
1644;bc1pknpq67qsrcpccnlcm0j4ne4rxxk84drcyllp3lm2lg06z48ppr7s6delp3;307519;139;307519;0
1645;3BAYWMsZvoxxbrQ1T99thJgkcmBtUmd6uV;132770;231;67714248;67581478
1646;bc1pjjweh2h076dv3yaw2vq0p9mx8weh90qudsa5saxssy9sgy8a4ezqvt3qq4;154663;3;1578065;1423402
1647;bc1qldvsklzmd0zdreff7nf9stkd8xczasj3kv692p;497812;743;718061155;717563343
1648;bc1p0huey8eyjjmp6dx7n6ujka5a63f3frpn9enr0a9u4xz7ju7egt8shzps3a;385450;1;385450;0
1649;bc1qvsd0df3epw82f389ckmdy8ceq2llsrpxqxpstj;800447;3;1067039;266592
1650;bc1p4txjfjytc0fyq39zm68efx8tawsqerlctv3m5dk03m30x5zmed2qp7nfu2;27000;3;52000;25000
1651;bc1ps84a4tftwxxfanzdt3jtn83h54ecngcgewkdf5nun6kdqpqralrqlheetj;20630228;3;43354512;22724284
1652;bc1pnny5keft4zln39y9x6yltuxpg4rjk0wa6dl470zqzvzxtnrayevsc0rrlu;0;2;656846;656846
1653;bc1qhkckkdshkjgtuyu9m8m0eedlg0npg42h6zzpk3;552823;8;5131712;4578889
1654;bc1qlnuqtxfd5seh99eq7j7ukr7mfc2lrrvt62hcxr;1586000;5;1586000;0
1655;bc1qcy3wwwu0vxkwf9jskj3aqldja8smtrcxz5djmw;197616;176;61540584;61342968
1656;3Q9H9JvkWShJzsZiT2VopFU4bh75jH65jg;32000;1;32000;0
1657;bc1p9srxdqx7u4u48ahj4s5gd3x5m932zm4fc4a4ds5ncm580nh864jqm37k26;117039590;7872;409473688;292434098
1658;bc1p0xsa34h4p6k7yz64yv83376x4ll6fxlu4e26s5vskltxpxd394cq3n3hy5;3959538;608;136297052;132337514
1659;33V2Vph7xbSAdQXoDZ2gv5pqc5MtBu1vux;714000;1;714000;0
1660;bc1pdr33a7thxp7a7t8gc8v0g45x8fcdm36e6wl4zg3jusxwujxgx6hqv9wchu;48852;1;48852;0
1661;bc1q4evq9xa4ht4zl47emk8s6mdcg4dgde8sh9eu3p;157000;148;13111278;12954278
1662;bc1pgmj24vm2vxak8mu9rcugj25dclpp2523pnmlg029l03jh3trxs4s439qrg;10000;1;10000;0
1663;bc1ppmz498xz4ncgxzkfxr294pyp9pet0kgnphmgm5vvz207gnkgjdlsnayglj;566420;3;1868497;1302077
1664;bc1prutwzwtnh920q8g46ndeu3utx6lctrzzvfep7em8ns25am2yg9vsfxhndh;20557088;967;20621934;64846
1665;3NYTcuupZNznhHwdWSt3NJ6KUQMEdxPEaT;1913981;2;3873962;1959981
1666;39hEnmS7H6v3ghPrmZvks6M6HMfQzasYKp;2089608;127;156381372;154291764
1667;bc1qcdjyt67ukj6u9vvk8ec033rz74zvmt7mqxt6lq;106974626;104;2252940087;2145965461
1668;bc1p7sc78vzn2delwmvpl323rlv64adcyutzgedxyczy9sss6sc7tvqq2vmx2a;628292;2;1303292;675000
1669;bc1pfpymdtkjssyhnad44x7syn6kw5fey50zsuq6gh2gj5heh4e4pt5sezepxf;0;2;42746;42746
1670;bc1qsywx5eu05p4hm3uz9rzkjsw48g4fmytdwluck9;33000;1;33000;0
1671;bc1pg9g8rs5c04x207jrhm49z93sqkk7dnqc7rqswv43xmu2utr5gfpsx7vmfl;0;2;813590;813590
1672;bc1p90n2qf62p50kvl654apn4wu3g5a044xy7hmjlkw0uh32620wlpnqw0r3fn;255187;2;555187;300000
1673;bc1qx8mpvyhk098tnvxe67nj6tc5tf89vurxe6zluf;17556670611;30561;17494376478338;17476819807727
1674;bc1qzulpql7tj0gy0p99ets2a3vxyx0gyth2ypgxl8;191132;1;191132;0
1675;bc1q300m2ywp7ahy5w2l3jfx2a4es0ku8ws0kl5gtp;1315551;4;5414160;4098609
1676;bc1pp0d55syddmktk4xc2sk8cz6lxeg52vn20juagcgxp8pmcwynnwws6vx8zp;0;2;40000;40000
1677;bc1qmutjqlksl30n7zpfry36zhfvpy56u7m6u24hau;37000;1;37000;0
1678;bc1pzqpfph2tnwu47rwqmr7gce68txa5w4l2js83kwhcu6cep7ex3lzsx52x06;0;2;238346;238346
1679;bc1pymr2nrtmpz2lkatyw5za75ulx3vpdnayugaxjx2nuz20ef7gfznssyje72;3088328;130;3088328;0
1680;bc1pg6lfaddhymfg5ve6w3ugknnypghm2gax86ck6ek7rwvyvcpx53eq7cjyav;0;2;813590;813590
1681;bc1pesplg3lju8ltf7j9vl0d4625g28f90543d9mlm7wl630u8dkjhjsrzu4de;10000;1;10000;0
1682;bc1pw5e5cw9r3uetlh5cmujagddy4set4tfvwmpr023hqnj6wceggqqqv2aeqt;808041;171;15505464;14697423
1683;bc1qgnu392vyu69tg59983um2najwxrcrzt3cu4sar;141000;1;141000;0
1684;bc1p8jh6edvr98et88nd9lvpv4prg5tvpvxtk5qz5u3zztaq8cfd8hqsmva9mq;296692;1;296692;0
1685;bc1qhfujw5aedq8a2ptl00vca759dxnl0q08taa6sx;0;366;191882204;191882204
1686;bc1p7mltq2cwvra27r359jqa8drfzz7qvdpsv34y0v8e6av7ay9ll7rqevfx89;10000;1;10000;0
1687;3JibBeerFCN5NgxkUk5mjdMwwBYL3H6Kof;2113987574;142936;6474622732;4360635158
1688;bc1pxey2ddu6rwz8k632g698rmrpsqzf4z294jse0q50wxap6zs0welqvq0xkn;30906;62;49150;18244
1689;bc1qtpyeq4wfy40d4pkk86jg4xz05rvxakh4jz58zk;289000;1;289000;0
1690;bc1pafhpvjgj5x7era4cv55zdhpl57qvj0c60z084zsl7cwlmn3gq9tq3hqdmn;3021294;5011;66687088;63665794
1691;bc1pgatm46myqp6nge34dgr3vktgmzep83m6wvp6nmf5mul4a5upr8aqhk8gn7;385450;1;385450;0
1692;bc1p32nktsuffprllv0j93a2d3q33s0l6rlh598hynkgrt60lf6upqmqasw00d;155192034;8020;623213159;468021125
1693;3PW6rDCtBeTpCSqgDHBaDGQKQ42PvJhyfF;5874340;16;27293270;21418930
1694;bc1pw6uydr6ltdfcg2m65m37qvzwhp0dfe3cqndmelylg7lz4pt4mmdsrgpsk2;599201;3;1901947;1302746
1695;bc1qlc0kplt3d73k36rjec4z84dewe7glug0mq6fhj;605832;56;6523243;5917411
1696;bc1px755ljkeha32r8uzqcnjqsl4lhkawtlnf4252tw699gdjl3p39qshrdsly;6045974;458;130396357;124350383
1697;bc1pk2782rtqc4u7l78rqkqzulmkljqe5nmwjrd023d955u53zh4u9ps325z3g;0;25;1431864;1431864
1698;bc1q203gqwzc5fekvx3dqpzwqscdejtje6a5zmcvmd;78000;1;78000;0
1699;bc1pasad5tu0vqn27n7u3gn8aa4ru4g0df8mdemkfylu8rdrsh5q0tgqlvf4aa;99734;33;2544792;2445058
1700;bc1qg8h5mdkes42wg7md43prcmmr7v6870h3l9n4tj;40000;844;63829591;63789591
1701;bc1phs7vdulmc9nwu0jp58l9grx95wj88p6gewf9zew26vml3mjqndmsaqex4w;129296;116;180762;51466
1702;3Pyxi2ozJ5jcbhSeCJYucGpjoTSzegQZJ7;17021113;110;457199587;440178474
1703;bc1qzgqaq3058h8js8swuryvcxy5zeww2x90h93vhr;17045000;1;17045000;0
1704;bc1p0e27csn36xxgsz2hv9rwd7uswrdljytwcmn4p29ml9j00hju9mwsq6jcaz;10000;1;10000;0
1705;bc1q2qurae35spl0p5tw8r2mpj4fu9gzt0wkjtrjqx;1322916;2;2671158;1348242
1706;bc1qza4xsnalvcr9wcl8djddaqn8lq3j2h9a4l5z0a;1593000;49;54562565;52969565
1707;bc1qtw9ht9xkh56txqqv9g4sya0rc60vw02rxd4uxk;907590;3;2798748;1891158
1708;3BsNxZtFwGvs2MLSfL6i9SvQLADsEkx5Bh;4570220;14;13100390;8530170
1709;bc1pl35wn7k578zg55exz799m6v6pnu563wg34t7yg7jsnmxpmvw5fdscdsmvu;2647568;115;2647568;0
1710;bc1q2q956fq2ny7jswu8juwhetq83lqyymsp4ccldv;58281;23;58281;0
1711;bc1pmfnyfj2tu4ew3jt74gpy9fwgwchdq64pqru33a9fdyzw6c6f9k5s8q9dud;55187;2;155187;100000
1712;bc1quu6aaqtp75jgx0xfs2unk4zn8r4fzjd59j5mq4;1200;33;37200;36000
1713;3KFccApQBZfA3CbY2SXWxrrdCz4HLSSpMD;2987831;107;146998313;144010482
1714;bc1pqp09pmpavdfr0g7x8cwnk2vm32ay7z95fpet9wrf4pd34fds45pq0g29h0;10000;1;10000;0
1715;bc1qc0dkysmwf5268zyf9antnxlupnxzgj3tnr5kyn;3430007;3;10365999;6935992
1716;bc1pk97h7qsjszzp99jtuwm3pfdg3xs04xwpg08llk2adf9cjan0pwcsvnzmnl;65000;2;65000;0
1717;bc1p4cj7evwcz8m8kp4k4s08zfy3a8xs08wkq0y59nw9xw08juqpq29sxya2yh;255187;2;555187;300000
1718;bc1qnfmthny8f6ckt724l903fglt0tlpcks3z5tlx3;1569144;50;778419679;776850535
1719;bc1phwv2dx28medh7lrcgukkm8r55r00mrgc22uj2eshyrs72nexq9cqzxp4y7;4886944;135;4886944;0
1720;bc1p3wxw6wkwcd5p8zcqydpz6l0xpn2lewrzrqfkd0g6efm78e9lj2as07tkql;10000;1;10000;0
1721;bc1qvwsh5vxa4uqydsv0xday5lqcxv063udxhvpg0z;215108;17;70949971;70734863
1722;bc1qcspz8q69l6tq28px8necu2qy8llsf4y4qgnufp;222243;2;469812;247569
1723;bc1qcu5efyktf59c9d3s06e7y4vcvqzggr4pff0c4l;1897590;3;5768748;3871158
1724;bc1pjrygtwc559sdwefjjsntkclnxq9xsdt0pt9cpp0vpeuxhqd4jgcq5sheem;598532;3;1900609;1302077
1725;bc1pwjn3jnvh8lf4g0facke25saapwezmg2fhj0aj3y4gz6ncjth9waqnj95lz;32855;2;110523;77668
1726;bc1qxqaa8wwhf4cxneentql2xg9zv4lyjuzztzqysp;169882506;45255;11859573806403;11859403923897
1727;bc1pljmvcvey892tvrw7vjteq2wklgr98mfrtwngvrkkstdr5sv8jt9smmkp66;37933;1;37933;0
1728;bc1pjqvpetwm6ps3rnmal0elks7f8p3gwwn2n9r6qqcmf85knthaxlcqddnvah;47500;236;2277144;2229644
1729;39MjfD3KWoD4yfe6ygN8t53kNp2dLb3ZBZ;424000;1;424000;0
1730;bc1p0ypqv5e4ymuyagjltn7kt57w0zpk46tncmusg9gyx2tu08xzh69sh4tnya;266689;1;266689;0
1731;bc1pdzhhp8ga65fsajjhcafcl3lv0h0h337xpgp2pcjsa6vzhxwvhghs6f8lvp;0;2;968314;968314
1732;bc1qf649yuj8q2akxx0altsmxtgx6h3zgnvekqkttg;10974461;5;10974461;0
1733;bc1pfytp45exzflljrfh0e99svh7sz5yqqm4sqhklehrcu6pzxexwq6q8ygqr8;15775;213;6388231;6372456
1734;bc1p9np6sc5sz6xan9usv6s39ly6897nnp49vepv4yvj5m49pg7uwhxqf2ssrr;0;2;24024;24024
1735;bc1p2fcl0namxra555vzg0y8nkl2wghphc5qst4085cp8mjpepf488mq74u0jp;0;2;968314;968314
1736;3Bk3uzrZefeCeT6kvz8hENSCZskoLsVyLa;251228;212;165700582;165449354
1737;bc1q33nlxu9xc2ankhtpfdgxml845pq95gu6t67nt9;1241929942;142;20549511721;19307581779
1738;bc1qagjysfj97lags572a3fcp9c0frrf34d0ydt0d7;32390742;555;32390742;0
1739;bc1qtgrqac5ullv9lxzdsc9zhvvwemxjlf2uw5d04g;1591706;6;2371447;779741
1740;3EnT4sdESPenzXhfJtaz1ZLvX32Y5Go4Fj;362886;153;260436592;260073706
1741;bc1q39xn3z8ujvcfykkv73jz9hw4tjpduy5esekfzm;3747848;25;38204957;34457109
1742;bc1qe9jc65memuulfjvh4faw95k6aykpgepunv3x0n;293000;259;87487000;87194000
1743;bc1pfpdeypw2katsdtzenyf8p89ge7670jquk22wfvz97y5tr0d7sjgq9ffp6j;83848;45;24862095;24778247
1744;bc1pcup045ffarxrqtfy66tusxt7ft7nm7cp3pqgp66c0je4ef7rsczs9kzce5;546;1;546;0
1745;bc1pmeqszx44zkr9lg6zqvmy0z2ts2xskxmeux8tfxvwkpldj4tu7ptqrcfzm0;6383395;124;441536726;435153331
1746;3C3GSSbnwhxF13GVwj754cJDKwa7H4ZSMW;6700000;1;6700000;0
1747;bc1qycvn0z3n5w3l6vazkef9kwhpe0z8j5fa0c6270;229316;1;229316;0
1748;bc1pjfwprqgr429xy0jgzm36wuz3m3z4jy0k9rgw3yhthva70sulgccsa0rkh4;1660016;66;1660016;0
1749;bc1p39m0u964td2ncq8teqsmjdh48evf8ex89p7406a85uspemurmjqqajvds5;546;1;546;0
1750;bc1q84txjft59ckl25kqk0ntszra55vmf95sug4wdp;198000;9;946000;748000
1751;bc1p2h6mpzreu5a9vfzh0zunhlvuty7mtnmv4hkrw83dw54m0rdm4plqefawns;460766;3;1562589;1101823
1752;bc1qe0rpmgeq85nnp4dpfwsxvwa8eway4fmz6y9jc8;149592;2;149592;0
1753;bc1qggezxgh778z4c9cpn29uqgv7k2gm9yxx00dg3j;422000;1;422000;0
1754;bc1pupa0wlysgue4wt2493ce07edekt76xgzk5tg7h6m5xmccvgcsppq4psxsj;546;1;546;0
1755;bc1ppqejs2znym6w5glsqdtr85kt2q2uy5dg00m5zv5g6sd9w6vrs3zstq6gn2;0;2;968314;968314
1756;3KTDUMMYuxGucqQ5hbD8y8oXPVUndPC9Hr;3174614;7;12643241;9468627
1757;bc1puwlyckj7vlwsvxyas68yus6h5ycp79hxf636aqmje3nwdff44xfqt60txl;546;1;546;0
1758;3N2sPgqGz6YamnFuDJy7RGKawgHF3pDJo8;117374;20;7925981;7808607
1759;bc1pl3lkevnl5edpde0wmz9ts2cmmvj4uv64p6jqygph3dlsg9ylp2nstx4yhs;546;1;546;0
1760;bc1p99wv5ga0qfgr9fu95myxn0rcqgrya3lqqntrw834qzrcu7xq2gpskuzzdw;9903280;24;21207004;11303724
1761;bc1qtyj5lkpmkrppdxwy39a2w854l9auxx48m2hftf;3655592;6;7413992;3758400
1762;bc1q2zzfl59t6r0lctpj56uz9gpypdmmchsf3wmsp8;355000;1;355000;0
1763;bc1qq3pexhuzj32kyt7rsetr9n00qsxgxy7f57tdj6;24879765;2;24879765;0
1764;bc1qx2xz3xkwgvlmuzn2c8vdy3qljhrlgvn9mgzj3r;202088;860;3275409787;3275207699
1765;bc1prkwm8hsa8d0t4pnagtvnr3q3dzyyww8l0tlv22c3yqp3zjzh7gssumhmct;0;2;20436;20436
1766;3QrUvchCHNK7FJ4Js3WwaAtpX7Bw5vdKSY;67808;9;1936922;1869114
1767;bc1pvmzv7rte39x333a4s5ynwuydqxsgc0evuaa2szgslm6avx2uz2qqxq9ek4;190080;2;473866;283786
1768;bc1qfhsjaeqv0e8xv75p07mgqk8h83r3pu9245x9jy;443000;6;1103000;660000
1769;33a5BGx8aBK2nWHjryYHzD66ah7E4R5X3n;240693;49;10445227;10204534
1770;3DPJyk9eAddqmiqjctifPGK8t7nhfb9fVY;496000;1;496000;0
1771;bc1p4563qehu6qc5qnz0un9yyznryl87uwswed3q0fuhttaggz4gdtcqtkrwsp;0;6;230279;230279
1772;bc1qc4d8p0gjyqh2qxy84hd3hsr89t43f6fln3wy9l;322077;11;1140959;818882
1773;3Ps2UGZpXwSxcfRUKaYfXmc6htQXNCJvmM;22065844;11;43132588;21066744
1774;bc1p3srjxn3c7scpcz5uqhc8mhx5y6fklvpaeu63pqdd46hhl5kqg0lqhxtjrs;306726;135;20680568;20373842
1775;38pwYjL5PVCqM7ZkQX9aYT5CLGofapQ8g5;604078;53;17607222;17003144
1776;bc1qush74qe6z5xrw2xuym2e8zha0pjcutvcn9hn3j;43033541;2;43033541;0
1777;3C3k22afmvkv7PAWbT1xqFMFevetWQ6fKW;454091;1;454091;0
1778;bc1pv70x0xqwyna5k8mveyu4kt74k244f6l5ux0033v5rsdglyxv90ms06tpye;546;1;546;0
1779;bc1q4vdag47jrgxsxsw5gs83ga6ehdj852y2zstx4s;478204;128;266888112;266409908
1780;bc1pp6pl8y63zw7z4v90ftd05hj84d2y4zaaqywae5vcdz5azhfzlc6stuau5w;765988;33;3651396;2885408
1781;34UeY4sec4QDkjWsgUftoK72nrPkJxXpEL;3000000;1;3000000;0
1782;3LGD6FSMg6czmb52x9XMYB2yPdPaeF7viW;7034211;48;78220211;71186000
1783;bc1py9s4ggct68vuv54zwzuhmlsgjcthdyx3xyn0vy9twmuhzwnvn9mqh7lfcl;546;1;546;0
1784;bc1p9l7lxa4ercksp80de73hdz392f8m5lzgsnzeglkgy6arp8ad7n2sl7wcy7;2992359;433;48260334;45267975
1785;bc1plm6jdhkkaw3lcs3ncdyvay90mqa8z04gku5ck55eq840vgqueklq96a8t3;0;2;968314;968314
1786;bc1qgtuuajqq5c2xsumnjtecpv2gdjrg3sy3qcrmtl;996986020;149;3745733879;2748747859
1787;bc1q87cf7a3eygpsw0mave7phqg0vgcd85q6vyjwcf;36399;13;1429525;1393126
1788;bc1p0gh7fvlezrjwtmq95dzcpjt07zlprrq28j59uy6twa8e35xf0asqcnx0y7;0;2;27825;27825
1789;bc1qpcmk07w0h6v9r4nm6dttws9vc7a53x72u7lqu0;1547866;7;10757636;9209770
1790;bc1p24pzagfdmvagem0h7240wtt8uquer32k7xhfav90yexjg7d8jmqsgqzklf;43006465;20;680894037;637887572
1791;bc1pu4rajutehjy4arzuzv49myh69ty58rmhvcjmys2ej70f4a326s0q4tra7d;546;1;546;0
1792;32hCLiWXf7MpBpEaqWAKXfubosc5KUW3TV;8115763;79;381675820;373560057
1793;bc1pzkx9j5tq50uy8fa930j79yhgaghvgdnlty5na5ejkz52jg2r3prq7d94du;0;2;968314;968314
1794;bc1qfkgerldce6jt8gag4reg92mhn4qxt5c8k7m7s0;1889755;5;1889755;0
1795;bc1ppr886cstn2462qcn7fz6xenj6e3dkwagjk6f9uxnm558j0fyynnqha5frn;23914;2;87676;63762
1796;bc1qlu8nmnkpdc2av27vz7032vnzfuvef0622k6f9f;398000;2;398000;0
1797;bc1p39l5wf8cutrx4x9gqp5g9gayys9qsa5ma29ecnpnqrwycscl024qn3k0e7;194721;21;3022741;2828020
1798;bc1pnqumvv9ctltcndn4x03r2pm58anqunkmzt9zs9unam2adg9vkdcssturpr;546;1;546;0
1799;1FAAqQbbMZqSiEKb77vGeZznwZ5CoVJmrY;37799889;57;3555758102;3517958213
1800;3FS8AidFpMUHNZTRcQAb1fHYikYfpWskzX;6964213;3;31957310;24993097
1801;bc1pkyxcx5mzq4683wt0jmrajfl9pwaceh0usxve3pst6eynavqggrdqzu4rft;0;2;30511;30511
1802;bc1pahhk6e4kn6zeadm2ush2rfn2sgktnznsf59synt5m760h690fd3qwyjkv8;435256;94;10705970;10270714
1803;bc1qc67c7xdn8hetwhkhq808h95982xv0n6esqr233;800961;55;11606611;10805650
1804;bc1paxf6fjszj6e8kxu7mutnx8lrw97pkhmxxzfcg79ayrjzv0v9u3zq3th3fh;546;1;546;0
1805;bc1pyk26yyk4yyhtslqnylyewwgs55dfvxflataglelarsvtp37g3masw23e0j;546;1;546;0
1806;bc1pvvk5lns5tzyx85p6s7m602637yje27c5jdvxff43jnjj7v56tcxq7vzzn8;0;2;968314;968314
1807;397aLi8gjzm1pPnzGkYviFgz3nCPWtm7Ha;1947635;6;6668788;4721153
1808;bc1p58l8k52wmhnmm6h9u0lwfwpf5nr8y7h5lnxj5d5un4rftlhn2z2qddha8s;0;2;968314;968314
1809;bc1puasq7kxlskhmrhl7ha7v05dlxld8q8hzksntkak3gy9f05u24s5sl8ftt5;0;2;968314;968314
1810;bc1pqg8dz6ddcftqgzs93f95vklcznthlvagfs5nymu3t4p2qwjw8zds8hc7g9;546;1;546;0
1811;bc1pjxugnd48r6sppxend5wtz2z0ajd5ukv4jv3pt2qw8mrnag0cfrksn8jmtt;5129278;12;10833306;5704028
1812;bc1qepr4xmw92wp7npu6wzymavxt3cqj9jhwpsthlu;83000;9;615647;532647
1813;3GrkL3Pevs9vTe4GjdVcBkmuazuD8PjWNz;266754;3;490754;224000
1814;bc1p6vd5pte0dsd96dyuge3lzuqpuet9hq70gy8et0d4ysz9sdfmk3jq94ahxk;4488;15;17382;12894
1815;bc1puqy22f9rzpc2ywwfffl922kp00per543wwp83rr9w3wjmzwvndes83c05s;233350;147;17208260;16974910
1816;3PG56nMsnaQZx7owM9EAoBKUURGg37Co3c;31017141;4804;19953558876;19922541735
1817;bc1qm3e2c0zfg5pzhp0dd7rmydz49fld39rgusua58;8000;4;8000;0
1818;3D1c6xM9xPR1ZkWb6r3c4JuuASxeA2Pnva;77672;7;2035991;1958319
1819;bc1qm4hsp0l50exvmwjtyj46ta9ms8vs879x2f0zys;3352271;8;17825105;14472834
1820;bc1pmk8asqs9rq5sd08qv5fagermrdp0x7hfqae6pg6a4euy2ed4fulq7rx6k0;155298;4;155298;0
1821;37FUjPBmWcxRP61srUAH3562csjhbs7KyF;1664048;2;3664048;2000000
1822;bc1qrflxhv2fhfhasqm40qsynu92awzp98nv8k7vmp;4693053;1;4693053;0
1823;bc1q4rmjq369l78av20vfm52wq0ngg8zc5myefuq3t;7915070;2;7915070;0
1824;bc1q7jgqxhezxkt3uraunxchg26w80seekrq3kq4agzq2kme2ue4evxs5twqns;328697389;6;328697389;0
1825;3MeQqMGK3E2sUXR5jxaA1FtxmpoEHiKUPa;2317520;76;19366432;17048912
1826;bc1qzsxfgepjm9sepxely9fpaj8crr9g7gnh8g7n5c;143000;91;7080646;6937646
1827;bc1qxn7nqvluzguuv4vsuw0rggtdl3kwfn4gnfclkk;307242;1;307242;0
1828;bc1pzr0lzwln65wwzm03ljl2wxlx4mzk3myv0fv3ujy0sy3hu8sl0sls2msr6p;0;2;968314;968314
1829;bc1qjdj0gqer8970zc2e52xdekjmglyxkf3zhcjgj5zs2gwxgk7cv5nqjjp2u0;5112880984;1;5112880984;0
1830;bc1qmsrkgg54gvwfusjym26kg33m4x2jplvq5qcp3q;28000;1;28000;0
1831;37VY2BsAmD6wnYf5bK4mEVARySevGBjSD3;11231480;253;31775791;20544311
1832;bc1paedrdg36thc7muqsfcdzzkl04y2mmm26kr8t9fr0h629dwmc6tashawkeh;1092;2;1092;0
1833;bc1q5vhjkqptjw3qlcaz44w7q5j85v95n8jqu6r7au;1094996;2;2259292;1164296
1834;bc1qjyycvmlcnhs3sq86fwu6j2g0w06kjsr249t8su;3456000;2;3456000;0
1835;bc1qfwg04xaw6dnd6xftnp8q4dyldt3x7n2qczw7xn;3556753;1;3556753;0
1836;bc1qschfcda64ky4mr80fheptj50axekhyacak9kqn;47596737;9579;106763855;59167118
1837;bc1qsscx7qhgf9gwksje0zltgyrw3ztvfl9x6zj6m2;49803819;9685;111050707;61246888
1838;bc1qpzmhrh8hcca95zk083vacquhsac3z3chsvqxza;214339;1;214339;0
1839;bc1qwrtry4d3fatr44l4qxjvs6rh4j8ehumzg8cp0q;51899135;9408;116775358;64876223
1840;bc1q7ruu5r67l968gn8j8mhmmew2uqavmgl83940rl;143000;11;1596000;1453000
1841;bc1qw9nz799tn7ve4a6gyzadhvx3sr22nl680mds4m;2712722;6;12128644;9415922
1842;bc1qhtdmlta5ayll9l4zhqeu4eqr7gweh0mm6pjvud;534035489;1090;261881394515;261347359026
1843;bc1p7a9p9d0x4det96u8ghaxrac95mfalgn7m8l8ws0ekdzsf3wyxstqh29h2x;2626467;31;35092459;32465992
1844;3DSgcVqsyo1Tjij8dPVXqXMCie1kzvZ1LS;1471499;1;1471499;0
1845;bc1pxywh3meuzel66yfk74yj5ys0yu02ha3as6fhkh7692p7erekt6xqzntknf;0;2;968314;968314
1846;bc1qr8x7dmp9dnk97qjvg92za70dh9x8pnghsp5p47;112965;17;844297;731332
1847;17StnGroPUsNXBq4AVJQ1fqGftoFZh3zva;2309816925;42461;447527140922;445217323997
1848;3Cecnt7AxzbTYzLjXjRU3euvKUxynrK4ki;247000;1;247000;0
1849;bc1pvrp9lufxra2tq7wuxjm2wkatdh92ekzne3quzx3exjzerfx72kxssc0zan;0;2;968314;968314
1850;3A2bee5KkQL7ATcv3NoHpJKYdobnkPNGvX;30000000;1;30000000;0
1851;bc1qfmjccsas06rtu2mq36jwnfsgyjcxqugg5jtc5r;1511000;1;1511000;0
1852;1LV2A3VGwjpxqYwsrforixoYnJ4diZMLUC;76000;21;2166172;2090172
1853;bc1qr392wvr59hrt7l6l65m6y8mpug2wgs3qxp3r8mny0uua6zmpaqesjzxten;567379;1;567379;0
1854;34PUEQz3hJBzCJKp6JE4Pj9kWEAzSahBB7;148000;1;148000;0
1855;bc1pk9klqzavmnqj02yeey8ualduxz4z02zdu675fpclfr8s6u553chst7aj7n;2730;5;2730;0
1856;bc1pqfzjkmt599savthjgekww3nk2fc8xag8wny9ag2fydht5tm2p7zs8y95qh;546;1;546;0
1857;bc1q3g5cvz9v09w9z9d4epxl0hpc2uhz87fyvyd46l;4945055;3;9945055;5000000
1858;bc1pflkx570xz36krg080eataq4sve2dmvmnjkpwp343s8scu4qxjhnsd9n02g;5000;1;5000;0
1859;bc1pcqms2fr4ytkjda0svyrn56h0glpzq64mflerae9ku38rjluxusxqa954sh;2206672;73;2206672;0
1860;bc1pjjgmz9d25ze92fpcc8nn489p446zgme2k8c2c79rsq75caswy2rs7u2pfd;0;2;968314;968314
1861;bc1pqlkp6hv8djamwdr767kezd6u3x7l96nghjfkz96r6mdpf63v693qqvwtnx;189014;98;1173966;984952
1862;bc1ppgu70dg6t86xs8n2s5t98h937da8pmy9ft2lnwg5mn8dejllw37qffhyfk;2177712;54;2177712;0
1863;bc1pd4sznyye77dwcx6f0g2k8vz6qmtdwqz940527cl2lmxcvxr57pyq2aqnh9;546;1;546;0
1864;bc1ppeghqtplf0nwhdcqlxget22arn4xytgm70644446vzc7xyv0we6qgzwf5x;546;1;546;0
1865;bc1q73eayy4ktvapar5vt272qvz52thsswacaacf4fzst00ytx50dgnqr4cdl7;0;2;7035000;7035000
1866;bc1pkl8ll7407350vh5mj6zvx3rzc86xn5jqyvhnw9gr54hfzkfjq42sn3z9k3;0;22;988151;988151
1867;3Q1M4MvLWGGKyA4CQU2s2dGkoARqq6tkBW;33000;1;33000;0
1868;bc1pgygwkfyk4uzmgfczk0aftkq3je8d3974u5ndvvge2j80pd2c8m5qj85vkl;0;2;968314;968314
1869;3LF74mXhUx55aFQKnP7G4n5cQjXdQiTteH;275622;5;14200648;13925026
1870;bc1q62mlmmww9x37argae4l3wk5swf5h6tsvhftk7g;5874086;19;70848650;64974564
1871;39si3q9V4KKEXaWPwvLNunWrumBkPcyLfk;1362670;1;1362670;0
1872;bc1pnxla7tc20zkmlczt4nj9jywvwp08aedq8x52v5dd6d3jlw9th3ns2yuny9;1971;6;2304;333
1873;bc1qd3f3t7jjjg0z903d62xwsckdpf3fsm9afnvj6v;302466;1;302466;0
1874;bc1qtm0nqmpcemgqhqclrvypt5xcjhkyq5eh53sre8;425000;997;1232053158;1231628158
1875;bc1ph0ppyjlm3zzdkchs023q0lcrtczxksy9684hpgupxecfw403ynrqal0xmd;18606;4;218904;200298
1876;bc1qtpdwqg2wsjcsd6pkwza6ltqjcuaw2w4hqyky46;1097923;141;425544089;424446166
1877;bc1p3yh00ep6ef95f2x4n2ur6wq7j06unjcxmh8r37fj0vmw44ymey5qnw6yd8;0;2;968314;968314
1878;bc1pd3c6c6purcyztxetfcuws8t7qnvnn2csqzyv64ydtrcue9asjg0qxk77gp;1337280;51;1337280;0
1879;3G4Zyjd8xMS8CdgSaSQTACxXiS8jgpHPQD;599308;1;599308;0
1880;3GR7Q1djbDfvjdh6ZRJ9r5vCAe9Efck6o2;45000;7;577216;532216
1881;bc1psw20jzwhatxvw2rq2l9y0juy6kdl6v752q3d6qauars97ql9mscs0tndhd;546;1;546;0
1882;bc1pq5z0hvxnewyz2kr40j4d32nx9tn0jx0vvdsvjnlckjekyhdm0j6qh7w6hf;15124902;2118;16269318;1144416
1883;bc1pt7a7dc5tt58a7e73gw4e6yr75kx2w39w903q6u563js4utquqkds5r269r;546;1;546;0
1884;1GtF3DzwPYvSKBk8QgUpjw313jUxELLchX;294401060;15;569334632;274933572
1885;bc1pvh6jdu8dlu3mtay86a6x37wp04k53exv62000pyqzcj74tkmks8q9kv6jy;0;2;968314;968314
1886;bc1qg83pyg47edqd4jdu6vyjjcq3dahv68hpnwzpmvj53y44sv9vc75qdf2vpp;1520878038;166236;21014779730245;21013258852207
1887;bc1p7g3nsrc47akv52axsw7kmwkfzq0x9ccasvl4ska22qe2vhchn2gsdwp78n;660761;154;36562907;35902146
1888;bc1qs6fyxlljr36vrtssz996gqfjue7r7vg7c8ytrx;2614000;1;2614000;0
1889;bc1qpfhhevzw3j8yqs08klhkwd4z45a8c59fwpxzsp;922018;290;241836821;240914803
1890;3P4WqXDbSLRhzo2H6MT6YFbvBKBDPLbVtQ;16607582880;955048;49992693919;33385111039
1891;35qzdZxAygN4FFUk1J4oZKiUDjfChHYZNA;394602;4;562602;168000
1892;3Q4iATTixHspoa93VfjuJ9a2dPgCWdWwEP;2987247;4;8104006;5116759
1893;3AyrcwUwGd9unTyoczVo6AnBrDpxc5wtGb;519354;66;12831725;12312371
1894;bc1pd0y8uctef4ffscxqa5eudflspnmsfs3xd4y3960wfls4m028hxpqnwa5jk;18246;97;109285;91039
1895;3A72NLxWrGeFjMHKkykDZKoyc4Ufo3EhMa;89475;16;2073384;1983909
1896;bc1pkj86ucr0txxyzvedf844hagt5972nzqe20kp4xlrnhwz7c330lnshusk40;342657;389;120038938;119696281
1897;bc1psn7tzhh0suakawxqzz3frkxgx55gdtxrvlsm95kaelv4zawc3dtsf4xtpq;249245;162;74478754;74229509
1898;bc1pv0mp8g8jdup7xvphxyppw2vds7m5x8tw2at9qjp8nacext8lhjjqxyvxu0;1778384;28;7553384;5775000
1899;1Htsb66QTw1wtYrdBJvkKx6c4c6uLCBQTC;5458126;1413;250698611239;250693153113
1900;bc1pdz4zpaqwavzxzjrw3qz94pgtun59l27vgqy7yqxzzfkx0df00ffqasw5x5;245774;282;1280832;1035058
1901;bc1p0gaxcq4eyhq2efjzvfvqja5u2exz8eqfdngfqqenwzcjdxc6k8vqrl6cyy;1227915;17;13533066;12305151
1902;38zWEbsRJgQ6KXg5cLJcUKovJR6WAMHort;1804182;57;20441178;18636996
1903;bc1p6z0kpnadnau8zdf7696mtys884lcs33flpf6a3uk348sr0z9r3xs7zm0tk;2730;4;2730;0
1904;bc1pedwn5ll86qrdlhvpq34n8mk0z0psx7a387p5mgg3gxdyazjc3vtqkykmhm;595106;75;595652;546
1905;bc1p3u9tu95s73z6lcx3f9nlxzv29m6mm7jpmu594ryy2gfe8wjfrrls45nuud;35528;5;2246594;2211066
1906;bc1qlzdswzqyhu0zgh3d3k8mtw7cxyzju6nc40t53f;35200;19;35200;0
1907;bc1p5thl80kpa9kssdsupjte2tj2cqdl57nh5mzra8rt9f232vap2tysmh6fpd;104967;21;104967;0
1908;bc1qd65m9d7lf4m0rdpu64tg2f9ut2wydx75z24h6p;5993;9;222769;216776
1909;3JUbQ6bA5ueZv9P3S3FX1SCXDf11QNbX5J;131394;3;411247;279853
1910;bc1p5n88adv3qnlhs3346ar63wsh32cy8eslsammjw8gx0eq86g44nnqwy3a92;475227;80;43493189;43017962
1911;34qhjfyhfuBQ38hZbHNc17KNLMU1eEZfHn;876914;2;1793914;917000
1912;bc1p0mwdhwpt2qf7f8fqwu249gy403squjh0vkwweq0phf042f66gnzs7ajnv3;62129;1;62129;0
1913;bc1quh9jm6p06nqnvgvvv733pl0g0y6ycxl0aas2t4;8603771;7550;695638819;687035048
1914;3MjpYyaMFyHa84j78EFDSshEjjyvMzHCPh;3233691;415;276602985;273369294
1915;bc1p3srjxn3c7scpcz5uqhc8mhx5y6fklvpaeu63pqdd46hhl5kqg0lqhxtjrs;306726;135;20680568;20373842
1916;bc1phkp4f6mqa83krdg3m9dd25ua8mstump80uxu2yvnmumlp9f7va7q0029je;460383;48;11095307;10634924
1917;bc1p8kr9nma80gp5v30lqh2srxd6dlwc9hnt336yhvhk3jlp4wwck6gsjeej5q;4190094;346;395837271;391647177
1918;bc1pxh3p0saca07uw8ul7x5dkc40my4s5q20uz9adydalcgr7e6f8r9qgsccce;0;2;22139;22139
1919;33PkmNPdJyDBQf4xQwNL5kD7yqHaBv5z1w;7152194;1;7152194;0
1920;bc1prnzqu0wvdgsd6dfcz7tmkygmgasrp7aahudm0qcx6ywf9jy8n8kqnh5msj;546;1;546;0
1921;bc1q07jh8jgmr9fhm5qf5njmhqygry5xm04h02c8cd;87390;3;14026362;13938972
1922;bc1pxlkgmsfg9fwmp6u8c3fshc9ncy22985ua9qjjakugkue2mmcae8q9me8a2;546;1;546;0
1923;bc1qxrgktah2wr7slv8fwfmec3k80sez7864dcln77;545668;7;2859892;2314224
1924;bc1q5z5ynrnxh6q6m0pmma2alkzh26hpth4s0rq6tp;31273;1;31273;0
1925;bc1pgnfxwf709ar2e6mju4t7fqv2nvmpxva9x0qpkr0ag7tujzahqduqn4k4qe;281625;10;3560097;3278472
1926;bc1pzhdkz8f7hkxljdmuzcgp74s90f6ndmqctk6k5tp0fd22epy74vfsfvgsd5;1834475;4;3620475;1786000
1927;bc1py663mn98m0mq766avf939xzp6hwyslncknrj06d9l70hees6cnjqukfdjf;4337085;202;14234987;9897902
1928;bc1qu6cymp0nvjwq5fzft6cfq9pe9hwk65uc227xta;407007;331;26672374;26265367
1929;3NXDij3m2uwBVPi2dwiLrQhPqdz28KU5zg;121612859;112;192407790;70794931
1930;bc1pu5y0e7ttjq8344pf984dxg9ucs2auneylqup70rqsjv9wr6kkclq7hnmuy;35747;1;35747;0
1931;bc1pnr0z509d56x9war5vt6c2v6yw33crafedfrz53yhy2fk747jyrnqngvx3m;2504667;9;13204639;10699972
1932;3HoxjiZzsmUY8kQmvkAKSiZaBPyyPXzBCA;2306985;4;4383335;2076350
1933;3GKUwGsFJe7vuFcjrFAXmFvras9AL6YyQZ;2733370;6;26720190;23986820
1934;bc1p74ngvx8mazawe6mfz4jrjcncv2hg5fn0yx4ezs50avzfqfr7v5cs2nhhy9;743307167;268;811371503;68064336
1935;bc1px6pkyyp0vdk0sxgscnkty968k2w5l2hqh5asjwqm4c3hndrxkmusgher6k;458496;2;942792;484296
1936;35rqLgCunP9WJ8ZZzuMdgridvt11kSKotA;673146;4;1404432;731286
1937;3EF8Lj4b64WXmdvtC5vaLnm8XYhM9cVsCf;7202299;4;18594299;11392000
1938;bc1pa4ntg9p7gu8vczgdc8xynks7lm5lz64hsamfru5989fhyje28k4ql48tn5;396720;26;904032;507312
1939;bc1pjfjmksskpfwg8fkmq4dzmpunqhs5zvk8nnzgekcxc69easlhuhkspza6aj;5269;9;15269;10000
1940;bc1p7cacky5uexrg83gq2uut7avwzt7qnjcltxn8andpxkv0at6tufvqln5322;7644;7;7644;0
1941;32HJDCAjn8VmnKauUhmQdfNi15ZRRuNSvZ;2343863;138;84756756;82412893
1942;bc1phwz0pv3628cr7q09ntertzealtj9sst8jrfg5s5vh86305phx9rqtk0jl7;1908307;780;2486482;578175
1943;bc1p5rj5etzkfw7kyevppvw6ksauraduj65cm42jgyfcadyffjd2yq6qx0c6hx;4377088;49;19525978;15148890
1944;bc1qmhq4sgtchfgh6ul75x3rsuegt55mef0zx3ehm2;4385541942;178241;835902983029814;835898597487872
1945;3LneRJNYqLhKutK4fh6HEDNUwRWJVTDhxa;767181;274;109577232;108810051
1946;bc1pc6j26puxfms3u2ekdd8lxj6vshyuusw609unyl06x9wm65lvtutqac7cxc;65883423;1651;6183463391;6117579968
1947;bc1q8xsgzh40pn9em56f8f703pklfsp9dfg6u6ed0m;73914;3;195677;121763
1948;bc1pswjd6mjl72yv05kuxvkn2y5rm65jjpthykagsl5xmkqwjt9wqmhq228ft2;1091451;1;1091451;0
1949;34DUcJjntDZYucWKTCV6FxTbXYk867YU26;4176549;1992;577976626;573800077
1950;bc1pcqms2fr4ytkjda0svyrn56h0glpzq64mflerae9ku38rjluxusxqa954sh;6464896;232;6464896;0
1951;bc1pl35wn7k578zg55exz799m6v6pnu563wg34t7yg7jsnmxpmvw5fdscdsmvu;4982072;205;4982072;0
1952;bc1peer5u9sxayn3xxh0scrlz9ma9tuwz4f0lmp3t5kjauq3z7mryj8snxxf72;0;2;65000;65000
1953;3MHSitYdAvhLfFR7EhTkvBhh8194ScCeWd;9554668;52;243230742;233676074
1954;bc1qk7ylsp2a85089znlrk2zwgqxvqeejzzrh7p4wp;141578707;68;253373728;111795021
1955;3FK6HhgGkVn5X18odiZzP4V9GjFmRpm7BD;1184624;2;2434624;1250000
1956;bc1pgszna2tjenqcxnwnfhyvk7480jwc90vu3sjjcvwrqycc570m0xpq55y79w;175013;54;9595339;9420326
1957;bc1pdpx3e0dd6m2qdg26qd5ly2eke7xapnttsk4dx7xnmsnnfpkjxuas57s4el;521271;1;521271;0
1958;bc1p36zjyuyk6f5ku7wzw2j466l9e4q77xlwqdlgmc5slyq8a25sx3wqqgp6ym;4367692;132;33640011;29272319
1959;bc1pw8j7ak73hnxz3gt43hl64f5qskjmksy7g60zm3wvyvr6dh2gm3zq03dycv;10000;1;10000;0
1960;bc1pvrwnu0fxknac0q4l00dv4vg9lmnv8hsh9uglz2w5aafxszk53s0swu9u2p;80680;1;80680;0
1961;bc1pdjlxt7v4572fqkrlzdsx986l6zjtvl9s7ymazc4cv3rpxgqz3wlqhc76uz;114901779;7901;411890273;296988494
1962;34ZM3tBNQ1niPoW81Xi9mE5uxPAhHrSopv;256916;3;363481;106565
1963;bc1p3zqekjhqc8agp2k5qz2jpcjg3qa8vmxa6uuwlmjag9j2r0cp5mlspdvfps;17472;32;17472;0
1964;bc1q7he49hem3tu8wrapd26dq74nju4aycp7u5fvca;1020000;1;1020000;0
1965;bc1pquz62anahzfwnqf9wagynvdp8hv7ehy2agxlgy72h0hxs058zqfqk8ksyq;25194532;105690;328907910;303713378
1966;bc1pk2wergh5k77rn9x9g377v9gtr78pe4xe325a3ygs3fwww0wzsv0q67k9sm;599731;355;5165439;4565708
1967;bc1pllc94r0as3du4x2kk4r2nl8zhx3q6wascqk8vx8uzjp7uk0dt0us9rk260;3375577;18;3585211;209634
1968;bc1puhqz37cqumjl5fuhjzve79kc3dd0rkcf4vuhhu33y4jmndkctukq2jmwn7;1092;2;1092;0
1969;3P4WqXDbSLRhzo2H6MT6YFbvBKBDPLbVtQ;16613608558;955117;49998719597;33385111039
1970;bc1qa7qqv0u02m7huf8dynpm8uk5ljmflplcq492jl;236939;9;236939;0
1971;3GNUFqTd99RbNEWzt2yBPwPTY97wLX7eic;6978956;4;39858501;32879545
1972;bc1q3whqpk73va7mqfde2a5ldgm4eh04adl8u62l6g;856517;1;856517;0
1973;bc1p8pfhqfcmpzjwcypaetx65unf45zvs8fz83we58nm682fuuk6rt7s780f82;30220149;774;348211450;317991301
1974;bc1pxulc0vx6shtllt5r3t0s6uea4hgen2qytau4sqxxeuhwy8053gtsmtekpy;629322;191;18325833;17696511
1975;1BQWr2qXXjd3UbEQxxfoBMmeMhCYyZYwgu;20000;1;20000;0
1976;bc1q0n6m0s5ecmnmephy33ac0j54txpdprkshufrq2;292551;4;755640;463089
1977;3Egy4CKh7W4QiWdubRtHQUpqWKeBNw8CZ2;3165423;1;3165423;0
1978;bc1pd7z5t5u2p5hrec3495tsp6daxyp8js7qhf2atgg9dk2c6mz6qpxsujlwau;4181695;8;23385956;19204261
1979;bc1pu0lg3yrhs2awqw2mqzag9gr3ljgf5q0s7re80w7rjyr63gzszjfs55j5jj;2275000;1;2275000;0
1980;bc1pe8es2vf455ecpyx7f67f2plyfwae520t7sqkzqd8mn8xvse8atzsxlzq65;6685;17;8323;1638
1981;bc1pw4q250q95nwkxw6738y3wsa0pp262flsygw5trzw6lmz2vyxre8sl8l6sr;2286073;2;2286073;0
1982;bc1qdq6g3t5hj7vp8sgufgdxxguxhnc39g0hsy8r2e;270853;89;18450316;18179463
1983;38pddFad2GUxn5tsoLpkermtc6ciXaDAut;12176469;8;37978275;25801806
1984;bc1pjfwprqgr429xy0jgzm36wuz3m3z4jy0k9rgw3yhthva70sulgccsa0rkh4;1660016;66;1660016;0
1985;bc1p606k8cythrdgesfxn35k0na2xfsd55xlvaeamutn48lhu5zzhjaspmrsac;10066;16;10066;0
1986;bc1qvxxnp3um4y55hpvqmeaaazh9850wvl2zusptvl;907000;2;907000;0
1987;bc1qxvs4e4ef7epn6whfhvw2nt6cp4euv9x92yr2k7;158200;27;2848716;2690516
1988;bc1p2cg20tal85xj46pvh5j6srgj7dq6kx00jhmlp3jzysa7xwa82lpqf5tjmh;211870;44;17147277;16935407
1989;bc1pp24k0z78zsxzjwh7fq2tputjs4ltjh3xr344mxkrxz8eetp7w8xse5kcv8;75019;100;10307824;10232805
1990;3AcYcRkRCp1YoEhZn4k4U8A3Yqe1wCi8on;738195;1;738195;0
1991;36WsVTszB4SHEVYKYgnC99jyJoYdtfxgf2;147125;13;1179809;1032684
1992;386NQhw6x9J7Lev3GgkUDMqs7V7Ub2ciZd;9205452;15;197385103;188179651
1993;bc1puvctg4rsmv4g4lx2nya5g0wwe0egper4sfhn0j0a65l04uvz6v2qj9h3tq;704338;753;6057598;5353260
1994;bc1p4v3x6s5la2v2cjkny8mc9tk4wvk8hz94crgwxjzuyvv2splna6uqm63jz3;546;1;546;0
1995;bc1qs0kkdpsrzh3ngqgth7mkavlwlzr7lms2zv3wxe;46615300;25888;4421205968;4374590668
1996;bc1q5g4w7sajpqvd0syvghsqvrxcf2ysxce0yxqjkx;368194784;1919;368194784;0
1997;3HFzzkVpBXggmRjK3pNWZc7p1s9WepdMg4;130852;1;130852;0
1998;bc1p7en40zu9hmf9d3luh8evmfyg655pu5k2gtna6j7zr623f9tz7z0stfnwav;72735115;202846;2865275914;2792540799
1999;bc1p5r9u0dtzk2s8a0c75y3c442jmve5djffytaj6c9gefqyqhu5vw9sk3nm3l;3105000;3;13989996;10884996
2000;bc1q8svdvdquy4ugctn955v3uk55sshvgwatxs54e5g5p2zf42ccx4hqq40vcj;3441427;1;3441427;0
2001;bc1ptrfvnu6y6han7663rx0qrwac0xs3726edd290k0krr9tchh9wkas53z234;4822;4;4822;0
2002;3LDKSmpPMQcevDD4vhS9EX6nxspJXPx1H4;1694279;1;1694279;0
2003;31rAadnyCLYDh1AbaKSQU1XDLxSgspvCr1;1315139;1;1315139;0
2004;bc1quhjnu68wtnczedlpz33vtusjcz09jtk25dg0je;6588942;25;6588942;0
2005;bc1ptpzjdprsmq6pqkzvy00ckm6njrcm6trm755gg0vpwy80gexvph2sjzt5j2;384993;19;4956150;4571157
2006;3LyzTYuzZSJbf7cQL77PbvBNxnhoViuv2u;5000000;1;5000000;0
2007;bc1p5hpsqy4yl9ehygw0zxvk8fjk45fk97t8v7zdu3yc307ysqknsx8s5nv73v;3775000;1;3775000;0
2008;bc1qk5ta05y6m9ccxrggf907uv5rn7s39d587jt528;2000000;1;2000000;0
2009;bc1q9r65xmyfqxtlyj92ap588d6w39vhvtnwnrvyuf;11826932;1;11826932;0
2010;bc1phkp4f6mqa83krdg3m9dd25ua8mstump80uxu2yvnmumlp9f7va7q0029je;460383;48;11095307;10634924
2011;38hUCBYQvA7Nx2QvgKchsaEHoBm3opyX4a;2526446;1;2526446;0
2012;39EVV66SrKh5QJNeLSP3dXh4de1XegWron;394680;10;2993412;2598732
2013;bc1pxpyrk0hjysmspmpkp56ylremr0rugpsanha8qe96xnklv9k4kc5scludq7;300605;512;915433;614828
2014;bc1qelu5kgedyjvnksvact04e40ql6zf28da9gd29r;141403;7;321150;179747
2015;bc1pt3fhfhqwdve0tdal8s2m2kx4l226hfzljnjzl6lrs732znul696qhxv23f;1427622;55;27056123;25628501
2016;3BjufCNNiehzxwuLp8pGPJRo1232J91MdT;74592571;99;2470648149;2396055578
2017;bc1pfrmm8vk2qpgsesd3mjnclh4awe9mtezxvkk6pl52rwtrenpmk7sqn0gsd0;863316;139;52704198;51840882
2018;bc1pavp9ea9xudstm27xxpvkezgj2hxqcmrxte670cktnpeyvxfs7vesc6ykc8;975000;1;975000;0
2019;3NwNHzCnb48P42WYEV7FHcEL8onoK1sSLU;719601;124;75004351;74284750
2020;bc1p9xvhgr7dplkfme5njm4kfe5ygu2tt2mqfv9c5lr9ltz4ql29cvpqm47gwx;758654;2;2300668;1542014
2021;bc1pge5wyafxcsf2fvqfdk6qh5rm0l5zyktex44dm5u05j94krfplddsac0h77;20975000;1;20975000;0
2022;3BuxWGupit2JH12jTqcwTmxbXPseKy8qtV;2463180;1;2463180;0
2023;bc1qcdw8ykggfg3xv57l8cap25suv0z92qrsx0rc80;361744;1;361744;0
2024;3G13tZQzVep5iD2dii1FGP1hzpwykifpCS;1140072;1;1140072;0
2025;bc1pavdwq8wc2lnsxra3387l9chj4utnxvuyeez9a0sfl062ds82sfkqaagksw;775000;1;775000;0
2026;3FRe277cn7D2qkqe74fcHGakagQqvVozMu;15513509;64;396578581;381065072
2027;bc1p5ntmk8ldutjqr4d6skfnm8gwplsjxc34sdammcjpm60xscugcv0smz4en7;727081;489;19390800;18663719
2028;bc1q9vqsaqvw8n7sgk4h0yvny2kfs4x7cmd03esjce;1200;41;46800;45600
2029;1qVNLs4dUS8Hs5xiuUzMApjUk792TAR3N;20000;1;20000;0
2030;3D6xh7rCGysWZTuxm5U3QWxTd52vivz7HK;52471254;404;2158545890;2106074636
2031;3NeYQXvgC8JgXt4mUrDPFChHKZPu3KQ36S;843137;133;139948154;139105017
2032;bc1p6cc2m2j9xymd5h65mxcv70vjr9fm3pz8m7yk9am3vke9g9jv50hs903ka7;3975000;1;3975000;0
2033;bc1qp32szg2w60kn3mserdjpw7tjnqxu4ch2xmkzq6;273921;4;1808343;1534422
2034;bc1p9es6v2z4hgu0tl7zxjl5q7dv8a8vlkda3cuv8jfvuplw6mldlxwskzfyfs;515717;176;14495298;13979581
2035;3BNGsa7XGhakQ8Y1JE41tYJ3zjN5NJHpsc;1562;1;1562;0
2036;bc1qmvymsvepz7v38qx36363zq7kwp0pvp5lyas4n2;69236;248;65164167;65094931
2037;bc1pgfyy0he8lzm3nuu8unnscaq4zzvl7e04rd68vx04ay2u46yttaxsf947ma;8003753;1080;513879159;505875406
2038;bc1p7w30kmfdf9nfzucsqkvnckzn4anqy3l32cy2xvw6j4rlvkt0fr6sda6xy0;947849;2;947849;0
2039;bc1pp9hwkymr485jdj8vrc99f7evt0gt0j2khqafnaf0zp5xzaekt78qpphesv;40460;37;3317694;3277234
2040;bc1p6ayrrj64xvm3v90j8paym4h45hdw2jfckvamrvqku9tfngzfuphsrjq039;475000;1;475000;0
2041;bc1qgk28c4uu3vdwlqhv5hlek0rx5hjffhkw62l4mv;133795;165;19611734;19477939
2042;bc1qy75nf2l7xw74gse49ctgqyjt830eenzcjc77263satfv4u9lkm8svflpkk;289980;49;4936240;4646260
2043;bc1qz0peyg9fykpueestpxmd8qjlk9llvjxdrk22eu;4100000;3;4100000;0
2044;bc1q8v8426qtu3t7ma75zfe42ce4j8quunp92fru34;725000;1;725000;0
2045;bc1pyssjjq6tgj7v9jqxewcyag6vg0ajdd6vws5ej83r8n9khuzxeqssp55n7m;119779525;4;3719924099;3600144574
2046;bc1pwgwcey3pm97epfjmhx9m2l5zepm6avt8m34q7hh7k0ntlaj7ct9sss624w;1092;1;1092;0
2047;bc1p5n5es43xzxcrfe8r73n3ql2ngfjtpyvdk23z2ym5f44utte2xkesuz8n0v;9296099;13;94642505;85346406
2048;3EgiM2fX8X7KTVLYgyUmTpUViLiEm7NE4z;4918008;4;23917536;18999528
2049;bc1pqtsyj3j5hugy9c46j7axfujjrvaxlvhsdmqn78zl2ygg3ams0quqa2ayz0;546;1;546;0
2050;bc1q24f833pqzzm9q88wd62rc4h20sljafdhjdt6e6;20000;1;20000;0
2051;bc1pthd8w8u65vcptw3vd29xfecppvm32atqy6799v5u72u3g4nzma6q0xzv4v;69600;11;887674;818074
2052;bc1q6fmqp3ytm5nzqv00amknm63axjue2ueq3nj90k;59535549;11409;143161118;83625569
2053;bc1pj7ac3av7wez3ukmj3n532p6nf33jvp9n9wpsmjcsypsnjtk27ckqycte39;700000;2;700000;0
2054;bc1q289z2y6f007pwam6m5qzh4f9sqw3arrsjx7njc;744737;1;744737;0
2055;3AmDSg2iYjeppY382GZ8yCR9F3EGWr278G;1049503;9;22737629;21688126
2056;3HhrLqTqjWxz8C8tczieqeHiSMh5het22G;22563;8;560657;538094
2057;bc1pmvv4c2m0f82ccq2ldw0uzx29sdv623ypx9x8l0meenr42ua3jqysmdwtlr;9712856;24;26435808;16722952
2058;bc1qgh6mywn30vyvf4gzsetn5zvrf59gh59jxzgc58;277102;1;277102;0
2059;bc1pqluhp8yg2vk7pc4g65zs6ewp5uzdfh7q4s7f0fwa9ya5ckeyc8asytwfe2;234029;114;121274685;121040656
2060;3HncWPkSi1i2U1jZnXoeKbhtfE9PDJMJ98;5529825;55;44165363;38635538
2061;bc1qz62t5dxdq4rhq6plfdudy2v5ty77cft9a0dr6r;13857411;552;466555789;452698378
2062;bc1qpxs9wrd8gkg62jlv4h920r03rtmphrn9wv008p;20000;1;20000;0
2063;1HAnFEgmKvYEvQAZ7L7GEbA7f97xUK7ArW;20000;1;20000;0
2064;bc1qa3zk5mnv29hcr3f5vczattnj878tfnkxfqq0zj;19713849554;224;1802081517848;1782367668294
2065;3F8FUXV2bG4wivMeGiBiSCSiCSWV8ZHCq5;601721;17;17771836;17170115
2066;bc1psc7h4f3r5d3kw6pjgznes4eu0le47x9vaq668dpu9ntg7pvaeznq7swskq;0;2;29000;29000
2067;bc1q88lezq5lr0039lcu8hxjz97qf0r04m3yvsl5ae;147558;1;147558;0
2068;bc1qfr3zh2jzncznyw5rvpz0l00knkn49jadvjq033;1559528;5;1559528;0
2069;37ocmSDAr6xZ5TnqDc4Eit67EL1JkVKTWo;20475000;1;20475000;0
2070;bc1p77lw7uxg4jfe3fxnnzmquknhz5mwnh7wwpmdefpfq36vn8f7ffmsea7fz8;21076000;1;21076000;0
2071;bc1pe9e3498s7xd89y67ycwa9sc2srw0w3ka20rd96tey4020h73e05qxlxj2u;3108235;1;3108235;0
2072;bc1q0pjykytml9fcujn4v3rl2rq9fwsjj6qzuem3ed;6941453;1;6941453;0
2073;39oCzjH3KueAxA9GJcevWSxsADsKegNfjq;3444158;2;6944158;3500000
2074;35sYhVPAvKCk4NYUGCpgAJHamy3EN3nQTW;955062;1;955062;0
2075;bc1px5pktj94hht3m6x6y30m2nqsax7cu7x00nlfztmz3ukw4ucfkjaq6n4x59;2628204;926;312481869;309853665
2076;1GahGHfByuDRyuczj7rDVs42Q1dLzSMUwF;20000;1;20000;0
2077;bc1qqfpqqy6h4xgmy4ucrugpah4q2x6qpwu9yrn5qu;2977850463;26511;1217880722143;1214902871680
2078;bc1p8khdk9xpeghfqlfg3hvhkkyq9ayu0hx9nddf4v69lqdejdm6hkuqahr8we;3783263;9;4414148;630885
2079;13kMHP8XSVUcHY4xStbByduqae5asEPaRR;144470;135;26638308;26493838
2080;bc1pnnuxrctdrkkj3zd8cpqd2qz40y3r9mvd34ezs0ndhcramcvt6j3sdqkdt2;669231;67;41885409;41216178
2081;bc1pmnraygexm85kezyw8x0nskcnwqlwu5u2axsnjr7czpcl0n94r0pq5xx74u;8382743;518;308547086;300164343
2082;bc1pwff84f2440j9q2w2wmtt4fal8nknttx4stvpv37tt072afldaxcqsyf2zr;2168943;15;5856608;3687665
2083;bc1pa69ez4p7nfk4938tfzstx9atyqrnhsse5dw5zfm299mhd4dmnyyql9vaag;648437;217;83639188;82990751
2084;bc1qw8wrek2m7nlqldll66ajnwr9mh64syvkt67zlu;68335484030;377768;315841962636387;315773627152357
2085;149Yu8roLzE8Jq8SxysMdj5tNyQJH9WzMt;1833265;5;1833265;0
2086;bc1qg9da2ffn6h6e9l999m78yt8hht2m095amrl32x;248063;92;2697735;2449672
2087;bc1pm5g8p09dq5adydm2p9qmjcdzmghjpndvj9vca59fwapz9hqcqfsq0y86cj;10000;1;10000;0
2088;bc1qmhq4sgtchfgh6ul75x3rsuegt55mef0zx3ehm2;4385541942;178241;835902983029814;835898597487872
2089;bc1phgh7zqk90kzf3n42cgttnzpx7rj2nf7tthgq93ugestnyfl368zqhsvsfd;1501018;1459;159378874;157877856
2090;bc1p6xsdmslnaaq8atyru9k6gy3k5xjqp87gff7gzlcxrnces50uu0xscde34k;5336302;5;14810004;9473702
2091;bc1pea92rzf4nv6gf0xghe8rkvz5pqmjky6xsfsn2pl0fjwk6h7rwc8s9ctur2;2003138;1221;272407758;270404620
2092;3HcVSoDEnuQNRUzMjYCKBj8FjcqyMmQe94;492381;2;492381;0
2093;1Gew7FKUTsrLiRMehoqXgd6TR66Pvvcuq9;20000;1;20000;0
2094;bc1pc6j26puxfms3u2ekdd8lxj6vshyuusw609unyl06x9wm65lvtutqac7cxc;59147273;1650;6176726695;6117579422
2095;bc1pau0adv33gtq20n4frkgs7rxk6cn7293kj3dk6r547act6d2e586s0cqx23;750000;1;750000;0
2096;3FfJVeb1w59LmTTVqPcavrYmKfA54Uc2XH;2589212;16;5965444;3376232
2097;bc1pe74zwdpw3mwajjzj67xxprtfxmlqz7xcwu880j2zfc7tdyzayl3qevx7hg;1735123;2;1735123;0
2098;bc1qajprl0e72l8pfzajmpw407zhp48adlcwyelycr;100000;1;100000;0
2099;bc1pp2vyysywhhhl9ece44ed4mjh62e7qqv4dssn6xnpccdr0tuths5qgwu2pr;58171;2;137842;79671
2100;bc1p4rdpqkngh5m0x50y5tkeutg7l5ejknngg0rjllgetxmn6jk33quqfs0gk4;1790198;2;11850896;10060698
2101;bc1qkxrvjhx80pl9xesur3azqyvugahxuzu9ghvwhq;1652511;3;1652511;0
2102;bc1ppxk9dw6htkr2lvg9vc2kd3aj804nslfhq7xeeeqdr95j7qkf4plqm0aagw;1200;2;1200;0
2103;3HXPFUshhkd7TP8j2vf79vcmh2n8SfXMLf;2171271;2;4383497;2212226
2104;bc1p2dhglnnu3ek3gnk9d77rawetwpf3d2mgleplmcp7l8g2tyqaprxqqzm6rp;840849197;20;4259221226;3418372029
2105;bc1qm34lsc65zpw79lxes69zkqmk6ee3ewf0j77s3h;1936342267704;1370639;4533925815559021;4531989473291317
2106;bc1qskevcd3xwu0vt7yjgqsxy6mpfs5sdrjgfey96k;55763762;12581;541839913628;541784149866
2107;bc1q7u3pfcu2j0hdn9f7y7ke3qz6ct2ueltefdwy8p;20000;1;20000;0
2108;bc1pf83ygxfcqd8v2pst070jxgh2suw9cfc2w3d8ggl4r7jtpjj64xus854lk5;333;1;333;0
2109;bc1qxpuc0yygcswfeuhmd5nm0vk93zz3wmu7hsks0p;102749;221;34985953;34883204
2110;bc1qzz39xlg8sm7xacnz8hjxw5962h676s6mszpskt;1200;34;38400;37200
2111;bc1pd3x797q943r46eztpw7qhpaaesp00sae86akg33u56p8jhxa5essxv8wzh;374375;6;2614212;2239837
2112;bc1pl35wn7k578zg55exz799m6v6pnu563wg34t7yg7jsnmxpmvw5fdscdsmvu;1303392;55;1303392;0
2113;37RJkdkzPXCMYSTq74berJYj9FmNn7wFP5;36467165;9845;25371646039;25335178874
2114;37WByJG4YQco3Go5Yu2ti2RrQLWExW4dAe;5052000;1;5052000;0
2115;bc1qlq6dvzgfrhls03t9x7p4ppmeuv2ctqq0x3sndt;56884;24;56884;0
2116;3AekcTcyxpq2Q96uwHoVv8yTWD8fGBa7e6;5975000;3;13969000;7994000
2117;bc1qx8qy3nux9vqj5jyr8ldh3eh7cqw9xv2d7n9xf4;107712;3;201392;93680
2118;bc1qsa9gvd8p29n8khvrz6vtfam6pvks2ulpwk6dtp;366810;9;4409412;4042602
2119;37jAAWEdJ9D9mXybRobcveioxSkt7Lkwog;1697136626;355658;13392772398045;13391075261419
2120;bc1qf0u2va86t0ljk73murr68mxvn7k3fpdy50a588;445274;49;6194225;5748951
2121;bc1pwc3an83wegh5tnzkz88lpke74uc6j9hn7m8m5qu5h67ce0zfr05sg85cj8;902482;127;23043606;22141124
2122;bc1pz9f3md2ma6kwwjmmuce95cq7gfuw748zp6skazmkfnxvy8jnlwnqfek4hd;1492729;5;2063729;571000
2123;bc1pjh9ey8j04uaw46wzjhjr59yf0gq4kt6ka0x2af4rgr70rts62c6qavse79;283249;107;14829086;14545837
2124;bc1p5djduygs0du4ffymc73aundztxvjlc6x798yjt0w4z2vh7wee9rs6wjq95;10916;10;1275852;1264936
2125;bc1q4puw4q9zyldpsa99pdayejtmm9fz64ertpax5a;183007;8;183007;0
2126;3EAHVwYoeQrPjqGJALoMPeTd5iH7hejdix;356307;7;16949991;16593684
2127;38T1cBzQvLTPdrmtAC7ZJSDKZr2ERMcoKg;2195064;53;81961163;79766099
2128;1NDxDDSHVHvSv48vd27NNHkXHYZjDdVLss;174797994;646;27458690680;27283892686
2129;bc1pmyhw8xzp053y6kdv258st8jcxmc5jltj2jvw9yp4nj0u0mdwhydspkyla2;0;2;30086;30086
2130;bc1pquf7k6443tt6kany34fccqegkgwa670neuu48rsfdy53gpv0rwjqd0zlv4;205390;1;205390;0
2131;bc1pm7fhf47ecj7jyqtgv4qmlqr2zvlh3ktjvxy0qsh3tuvg7n8eecfscs9cnn;146510;53;230552;84042
2132;bc1pvplpuw2xdc9vspq7vultv0yj7g88ttfjc3z7hfxewe7kfzq78rnq2ae73y;287141;1;287141;0
2133;bc1p349envul26dmhahl66hjslw3g4l286ssqgjxhrwkqrul9uzrwwesc04wls;532489;4;817489;285000
2134;bc1p4u8xqlj2ddtv3qdzr8g4lfta3ct2ffhatyufd877zfqkk9wh845s0enpkp;1161081;7;3430284;2269203
2135;bc1p258syjdz0cthr9slkldeuvzf94nvrseq2t76azn0kvugrkku6tmsvtm2uq;93425491;2101;812464984;719039493
2136;bc1p65g9y6mc9c5uqrdqzzgtv442aztfgv9lemyafankvwxpa0g5ca3qnzx7nv;100000;1;100000;0
2137;3LmB8teYGkH4Ez7UzFc1AQcD5CTgyjxLmp;395829;1;395829;0
2138;3MoxedxbAZu7Vz6CGA9HWMxrQ1osEP1TQc;110809;3;628449;517640
2139;39tNviiBkiqR1r8LBhLVUu48G4ZFNDLpwH;138114301;3;204341614;66227313
2140;bc1p0awxkhxq3cn84kme8vyh7hz2kng3z5krgusf6ty0d2jxgnlv8mus90096k;600185;319;73295244;72695059
2141;3H7tojdKbJ186DFFc5PPHrgmez7U22zWC3;2098794;301;268322379;266223585
2142;38sp6vC2BTqcAjnobtUS7annYbAejMrUbS;1037368;105;27207737;26170369
2143;bc1qq0rvgjcq2a60drfmtg06wnnw9djx9j7c49496c;487748;28;21123438;20635690
2144;bc1qq6gpmemujczrrnwzv709lgplv5t3pwu058v7rz;975000;1;975000;0
2145;bc1pwuwyys8d7c2ntynas8fde3kymsvt35j6uuxdm6yfhzj6nk6yw75sjj3a5r;300000;1;300000;0
2146;bc1q9lk7u0gy20qmy8p74gpx8ah0yc9a5kjmjnfve6;8584286;1;8584286;0
2147;bc1q8j8hkhuphydqfpyjs2urv60gy63e8a9ztj3t2v;75136;1;75136;0
2148;3NQ8oMvRAnESxjYrd221nLWE9JxuxMBJr3;167321;36;20228240;20060919
2149;bc1pgzhq95l8r2elpaenfkwth562gnewftfxs39day4h6lv0nadklw2sj2shym;114084;4;1378041;1263957
2150;3P4WqXDbSLRhzo2H6MT6YFbvBKBDPLbVtQ;16607582880;955048;49992693919;33385111039
2151;bc1qxuc7yxxqmwjcd8n7ackgdj4vmvhecfhax64jwv;729000;20783;306670000;305941000
2152;3N3xNzSCmyip6253fxkdXbdADZiBqQ7Wit;881815;44;6743876;5862061
2153;bc1q260q6ee23h76e306fn6errp7rw3ufcrgd2dk02;1297260;1;1297260;0
2154;bc1qlnxt5rhqqgq8zcvy352xa4t64qxtntkt4hzzgurpusprntmtaprsd3p3sv;31257474;1;31257474;0
2155;bc1qy8gu2pmr8s86qgz445q9va6mj00tsfuj8g93af;93840;1;93840;0
2156;bc1q27sjelk24zvljfnmrss02yyhndvk20al3qj0l6;125083;81;150516369;150391286
2157;bc1q4tu5x53j7a9y4ja3r3ae93r6lm3tak7tnz4ezx;47587094;3120;1331287266;1283700172
2158;bc1pxjgtmmqtg2y7r3jczd8fa7l2kd4gj0a9tsct8n0jvh7ahjp206hqhkas0y;1362967;29;4881522;3518555
2159;3JnwHjWMaEQPcJL1XgvrzLzRP62ZW9c8ym;726693;58;6907783;6181090
2160;1BHzGyYhG4wtWq6USC4X4g8Vh4vkvZuv1P;963554;42;10515415;9551861
2161;bc1pd2nvelghstx2ssj3dadmvzsreqnwpek3x36cqg7ew8dr8aarmr2s57rq6u;458874;1;458874;0
2162;bc1q7cx5wljdnpdznlaxy7yvf0py8x2wy2cxz2dc6e;73781;1;73781;0
2163;1F4r3AaXuatgZDWcx9mbi9XLRtmhZetVr;150987;7;2523872;2372885
2164;bc1qxuh3y90es9ek5tzm22lvn0uz8jnzedtd84yhrq;99327;76;66135121;66035794
2165;bc1pjfwprqgr429xy0jgzm36wuz3m3z4jy0k9rgw3yhthva70sulgccsa0rkh4;9241736;233;9241736;0
2166;bc1pa6e2ng5tfeuua7js7qll75cy7cr3smqw8war2nqsfzvtrzmlvfhqa969fz;46956;124;57330;10374
2167;bc1p8064meczgepdtsx4yr9zvg33jat8wu6u79sxuazaphpuve0n6j3s6ut4uw;1422;7;9193;7771
2168;bc1pqu5jly95lyjpyr36vjwhjv8aq3dsen9etqh9pez9e7xe6vplp2wsx0hyml;2784;5;2784;0
2169;bc1qz3p2kvjllzynjn4xx3lczupr6t8jlf2hdw3vln;2864806;1;2864806;0
2170;3Jrh4EPRprDAePtLaEBiWgCNStWkjpEkVN;73645;282;157204585;157130940
2171;bc1pl992nwx7g6krxqrk0472ztr4hmzrkvjyqcvaa55lxsy7zyqekvnsl9kk85;10000;1;10000;0
2172;bc1p0gaxcq4eyhq2efjzvfvqja5u2exz8eqfdngfqqenwzcjdxc6k8vqrl6cyy;1227915;17;13533066;12305151
2173;bc1qdfghl23ylf6vnjnex9yfuhnuwa7yngscs0nl4g;254916;1;254916;0
2174;bc1pvaa4njs8xkaznqtl4cjcdcrzjc5uja9hvft28d9ylcvwnhkte6xsycq929;1175713;1890;168096036;166920323
2175;bc1pwjna8h2epv73aa4atmqfztm9mj25f957vdemprn7ezukygwcrz3sm5xk49;8121976;227;8121976;0
2176;bc1qkfelded25frgy3pefxv8k007cdqnty9u29nznz;265064;177;274710422;274445358
2177;bc1qd8j0yj2405kz5qh9glwt4k8lgcxmpngf6k2pv2;4911843;4;10411843;5500000
2178;bc1p8s9x0h65ncyk5hyfefgtal3fvw8pycjxplr0nk2m2wau8jfhu0us5fv2l5;10000;1;10000;0
2179;bc1p97tzhadxh5ns7k3jldk5lq7auuhlxnp90rrt84xqwcq2qyal3s7sfjy2uc;8990416;225;8990416;0
2180;361NJC5MifVRcRq6nhYydvNTHCHnhsJPtG;151215;1;151215;0
2181;bc1q8u5c5ma3j4w877vufr3lgfs37045usytejaea7r50pc6mpkl5uyq0cawus;111928385;1;111928385;0
2182;1DywJMqHHMWuP7xyfkRqJZCEe7GdEKFRcp;276814160;49;6597204055;6320389895
2183;bc1pxprknaajmznn52ftxn0jqtz4xgev54z96qc055r9el5cng2hqt8q5f2e7u;0;2;209007;209007
2184;bc1qhdcx90alnvmy52e79ljh0kx33z09laaag89p5f;1950115;13;1950115;0
2185;bc1qpz67wjn3dmee7vqy9d5xx8gh2wxex637h692dxezdazafh4pz74q9trmf8;124297174;1;124297174;0
2186;bc1p60qq9ywrv3aqw7djazdtr3gxpx438cp502w9dkf9cdu95gu8rjequ488g8;449517;882;562832601;562383084
2187;bc1qy7macfxa57xr2ue4mpww05ed6k006fzw4j0dqz;25493225;138;570919142;545425917
2188;1JyFnrhNDsd69pw7BhkfcKHsVjXrkA96YQ;2805030;11;2805030;0
2189;bc1qks4fk8mpavr9squxhs9qyhfz6ptjvpgnkhlzdq;1000000;1;1000000;0
2190;3Dtj1jHtHT3AubYpXPVKnmjd85MuBT37fe;3422950;42;7055915;3632965
2191;39sHQsGRFxjs5UshF4cQPLSdjaqFBJRdwo;76874;9;409044;332170
2192;bc1pnme24z2z2l7azw2kyqx8g6nzqr2ym2nt0x2xykxzw5t44630tjnsunf67t;0;2;169480;169480
2193;bc1pqpeyc7uxxt7zce8paljwu6vja6lk9e4xyx37r9ezcvswvas3j2jswgj2hr;962;1;962;0
2194;35jeQB3htjvMXkDpzVHUVrFPpEx6xbchGU;4535454;6;26849320;22313866
2195;bc1quh9jm6p06nqnvgvvv733pl0g0y6ycxl0aas2t4;8583291;7540;695618339;687035048
2196;3AXTSvhRg6AP8b3bbPMR52DXFk3YmBJ6a5;58531;11;1905224;1846693
2197;bc1q5wppzg6g9qvlpydy755jmke8snmadf9hxpvv2c;0;9;634320;634320
2198;bc1pl29afsp5g4y6g49udaw2s4kf6cuvzvazkt87mwv9yrfef9tqwecqh2aajz;288646;3;917538;628892
2199;bc1pmuf9vy993d8hfsss00yj7jrenxk4sjfdfrk7ylprdyd6kkh2d6uqws8vja;0;2;1970991;1970991
2200;bc1pwv04qy3wtnt9gpkpuqzuvaps4vqy2rr38sye8xky48g4sdwscy8supx8jx;0;2;1971452;1971452
2201;bc1pnqq8ktewdaupyp5kec9ta2rhuxc3q20ktdjdfp6egd5888qmr9wq046s7q;1190000;10;2810000;1620000
2202;bc1q9u6pmhyduuf550vf0ek7ylah782mkuq7yhyl9e;2664262;3;8788368;6124106
2203;bc1qzcgyf99l06c0mqme7kn3ktu7fcv3kmk8jk72v8;383242;1;383242;0
2204;bc1pdfkrzl9m6tjp8mvcfc446gx5vqlhg9h8mpmyh6hs6q7l2dhdr0gsv0caug;390000;44;153346664;152956664
2205;bc1pav8ee4p4c3qlhpyqt4ay5kystjkz7ma8e4klypatx8c2nnwprfkqv6ac9l;0;2;63780;63780
2206;bc1pxz5p4vcz8mfyfzmasye2mmwflghpz8lh4r0rl7pvafhekra2mhaqmznxev;306513588;14426;312410720;5897132
2207;3JzkdG2mbo4D1jM12EuWRocFvyLC3dxivR;250000;1;250000;0
2208;bc1pmgj8v54h8yvtcmj46mwsjg7vxj2vf2f478nm29gtupa4xgw6sl3s0n5arc;773637;4;3462374;2688737
2209;1KpStiyJRJBumFSkXHUnAPVndFDhGTH385;44435847;28;339480318;295044471
2210;bc1qpr7w03uwjkvkadu6zt8tmupj8lvj5s8ddsuq03;254218;1;254218;0
2211;bc1qxfsc3zakgwjp53hexslgd7qk0xatrzega0wq7a;21325277;14;21325277;0
2212;bc1pz5yxdx6ug4cfk62jlvwxy2g4h3l8jrr8avsk7zdqgjpmsujrw52svvjcmc;0;2;169575;169575
2213;bc1p8xh0640w974y7n60dugm2kd00nd2dvnxeadj9tza9lj64fs3j6zsh0tcaf;3423415;6;40442349;37018934
2214;bc1pgs5gkukh3j592y0ts06znmkdvzcfqz6juzztsjta6gmn5l5t2wnseepj8s;23722034;453;2416110895;2392388861
2215;bc1puvcjpl7t2n02jw6jd2h7t6m5vtpdxm0j87gulnw7wh8y2ddgkdjqkz0nnf;389470;116;395838;6368
2216;bc1pxk5vhmh6h9nts8ajvy678ezf7wjnuduu4nv5f0ay3n0zzlc832psqn4hrx;357747;2;735618;377871
2217;bc1pfjdjwvuyzm3fzftgz6kdvmwegyapntlyy08ahla6rnk00hluactse2pdm3;0;2;1971285;1971285
2218;bc1q5yckn9txacv7fyk8dc5wg099lzwyuuq4fajm7q;34469924;1;34469924;0
2219;bc1qnwv6w4y95c5kx29eaee6aqpy7ll9wsxr775zrq;1954713;1;1954713;0
2220;3JnTRHxng3QejfL7mFXRshT4evgqrpy7PN;2792508;25;159076357;156283849
2221;1JzJCm5inE5YFa2ZCxZSMmBMWA5MmtaVnR;1573825;38;3617458;2043633
2222;bc1qx85fkvqmxykzl5ppf745f2w79ukea33re9ce2f;1360837;309;87559314;86198477
2223;bc1q972sk8s2zcf5ex2s74n6zldcsd2p80hrajcuzk;33326;9;190112;156786
2224;bc1pcfvj6eck44lv4rx55csyg2cp3e8jz9hu30c2ku6eudeetvhu2nlqh8jkxv;0;2;10000;10000
2225;bc1qfats80fn2t7pcay357udp00e2uspvhth2vzdn9;5920918;2;5920918;0
2226;bc1p7c5hll8jrgzerp7cu2lpvx794u3myksr46jyvc0vnfglsme44x6q60fdur;10000;1;10000;0
2227;bc1p3fkxvsamr6jutyw789vj9ka2kya9wtcaw7w45g4mzlf9tzuhnfeqyj0a4k;19516;22;20062;546
2228;bc1qnu38gvwkqg8glfqxfkewl39kaqy6lvc5dhzm6v;288723;4;288723;0
2229;bc1p8navshz3vrveft4zmkytuqwh05mhmj76vz0pevt5spp4r4sp4ywqxfr36e;1572726;191;27453681;25880955
2230;bc1pphld73cg3rzap9004dzszr8kkvmyqn0mfcvua70rgvcnhf4tkc8s4mw7h9;0;25;392448;392448
2231;bc1p8gltat3z2wqg5jknxv4tfss6jhgeyfhv48j24drngqcf6290dshsmrerpv;10000;1;10000;0
2232;39GWqvFSkiCvgVtCQ5gCwKJU3jAPuTDh4s;4328927;628;1031068210;1026739283
2233;bc1qg866nqxfzdkhqqzmf2mk9algqynwtgfvu67vsv;4473316;3;4473316;0
2234;bc1q6fmqp3ytm5nzqv00amknm63axjue2ueq3nj90k;59544546;11412;143170115;83625569
2235;bc1p5y3czhgwyfv4fm86npq4zerjvyjt3tzkzt2wxvmm2n854a05f9eqk67cr8;1971009;1;1971009;0
2236;bc1p3lkrp4zayepywc7q9ctcpned86pnmhjf60g8rn8q7dm6ry574pvsqydnr5;1092;32;32514;31422
2237;bc1pd5fly6rnqjth9wfmyt63guzs9gttkkctflskwmyxj0gwc5zwr4rsx8m64l;10000;1;10000;0
2238;bc1pk2wgkuvdeh4s2fwgnggem5j6cjcdle32cmuvgv57g5fwunj6jkcqtcgyc9;10000;1;10000;0
2239;3AqssmKqDYzW4xzQkg2m4AJ2PRZ3VvvZRF;412800;73;27875128;27462328
2240;bc1pvatc8za7auywrnkm9kwfskp2y3sc739fln5rdpw5pp25chpr647spea9dq;0;2;27066;27066
2241;38qQALqt8xthEwFdc6n2FEQF51JgRSbCzi;3178018;3;3178018;0
2242;3H9ziSdgg4VF88Ys4iibfqdoxXZKruGhtX;133102;15;1324048;1190946
2243;bc1ptrajuc7zpuwk0wf46yvukwtjkp648v4t4m39jk7a3yptyegcsa7squ5px3;71850;64;93111;21261
2244;18n397Gp8S6bK7GyD7cb7WivsvJyE2cgM3;8890974;30;25432097;16541123
2245;bc1pwmwn805v9jdhcwzylggv4kg7uxuutcrtd0hk5pafryv9ngxlp5fszzh52d;0;2;23000;23000
2246;bc1q65w9ansa2cxgzvdjnmdcg9ugfxw5jn8ety28sf;100000;1;100000;0
2247;bc1plt8zkkemrpa226wq5w2lmnf74wkygvyc680tekcjrf7wu3fyudxqz5jd9k;13500409;426;783601238;770100829
2248;bc1qhxml8vux4h37g9a6yrd9rhwl49hkdc9dmr64vq;20426045;1;20426045;0
2249;bc1pt22wv9mvt6raff8hcc3jjwgd70q5u9mknlygthudwvlev8ztjwxqe0r7k6;546;1;546;0
2250;bc1p4jdufcvf8jgdd2amgm5r4jwfqzs6kesp40jfj6jw9ha24r6lda0q643205;1993148;20;6609154;4616006
2251;bc1pj0crv6zkx0ehuzqanw46t64qgr4sv0fynhgt5f5cznsf0hdq0pnqc90g5r;83206072;479;6106428861;6023222789
2252;36ppnMddwkg8EMQzjrPCSbLkVb62GU3WPr;6801203;9;22483881;15682678
2253;bc1qt6w9f4pp04n03fu9008umudgsh9eyfkwgkwwyy;449005;1;449005;0
2254;1F1eeHd1UYdAMdKS5PLhrzp4gh5WyykoAE;547792;310;604175186;603627394
2255;bc1q03zyc0hv27l5r6afc3j6a5nvhe4x4wntcyyw6ylnzxulppu9fdkscrg6hq;5141155;1;5141155;0
2256;bc1pnny0etw9v90qrnha3jeap8lsu6rs3q9xqrvhat4spt6ja74dnmpqqymmwl;0;2;1970970;1970970
2257;bc1p32kwuwp3wwhxscvc590vsywt28x0q96k8j7ty4gq0y3m9zk3d88sjgakcq;0;2;22700;22700
2258;37TS8VNJsAGGCvVP3MSS1BcTwWFbBfNS2a;369206;21;1876418;1507212
2259;bc1plcztafw4f8ftr0xlsqvzqqk4tngmnr0zn37mclmc5st8ky8ha3ysxrskh9;260060;6;1243391;983331
2260;bc1p4l3dvkta59ke2yc9sksy38rychpg33gacsrlyc8kdjfyzjvt3tkqkc44l5;0;2;22000;22000
2261;32B9VgqjpkPm5QVFs4RLg3cYHLsdT2mtkm;69245;30;6077421;6008176
2262;bc1qschfcda64ky4mr80fheptj50axekhyacak9kqn;47611171;9583;106778289;59167118
2263;bc1qk7rckjz5x0ztgauu0acv3edp0ta73zne2f28q9;771459;1;771459;0
2264;bc1qwrtry4d3fatr44l4qxjvs6rh4j8ehumzg8cp0q;51945334;9417;116821557;64876223
2265;bc1phwz0pv3628cr7q09ntertzealtj9sst8jrfg5s5vh86305phx9rqtk0jl7;1908307;780;2486482;578175
2266;bc1qzjkjfv6nh5vc9yhm44qlwvdfpvff685m6a68tf;72201;70;45863761;45791560
2267;bc1qwfgdjyy95aay2686fn74h6a4nu9eev6np7q4fn204dkj3274frlqrskvx0;23849380620;1904777;226175970047406;226152120666786
2268;bc1q6d752wry928jjdsl7zajvhx6azuthxa5zmqyus;234548;1;234548;0
2269;1NPfcMnHdufRW3Dnhi2a5dM91o5oX8eBQV;1297412;27;9374731;8077319
2270;bc1pk7dwyreg7ff657xphyn3z2x835leascsjnnag5vdulz5hs5kguhqs9wmns;84719;17;18602038;18517319
2271;bc1pgxml9fjm3seqymlne0c74fecqsmdcg4nfc9l73zeq4spxvt5ktnstytzhx;0;2;63780;63780
2272;bc1p3hdy8dvwrnla9ptj5ec92zpj3uju4vqj62nnlj0vq7zd74nxjjwsflrpk0;54409;35;1406783;1352374
2273;bc1pkvflg3tc8sh22aps4fklurqpxa6p06zx5e8e4x2jvy8y23gzr0xs7tl5hj;789853;1;789853;0
2274;3J7cUjBZxvGRCwFBz3q23zAsnhFfZrDSSU;1745739071;38431;1694350449977;1692604710906
2275;bc1pf56txtw5mmmtp87x4pzcrl846u846suuqa2fxk8ju6g40rp85u0q92um57;613307;367;35112118;34498811
2276;bc1pamsqj3uzsp0htluj0mhnens90yl7xx7lz43qz4r4mz24p9pml43sa2fh0f;161282;4;361282;200000
2277;bc1qr6zuapy0n7f0cjz2q5dre5wlzqx8p9rj0a34sm;1902500;24363;521566293;519663793
2278;bc1qyfanfss3qp3y9sssp6jg337c7q0uz9z8dn8nwd;125378;7;508251;382873
2279;bc1pv5x7njksmzfq343z7079qzgpep9k5pyvl2k3v8s0p0lag7s2ce9sqx6z2w;42335;1;42335;0
2280;bc1qhdej9ufkgvvvqwz4nhqdqaxug9sxq2ftd6c99u;1158813;19;5693897;4535084
2281;bc1p2dhglnnu3ek3gnk9d77rawetwpf3d2mgleplmcp7l8g2tyqaprxqqzm6rp;840849197;20;4259221226;3418372029
2282;bc1qmtzll5hcxpn7zlgtrehhhchmdsphkhx2y0dwc9;1003971;1;1003971;0
2283;3QHD9tsuCjNred6rA5HMpb5VQ8NFn9WDgX;159627;175;75344588;75184961
2284;141nQPQ1rXAn854MXf1SnuUp4nPvrHQTom;25469047;236;37709300;12240253
2285;33Szb1c1twKWZEtzz1XhJhPBQriaGRjGsQ;537792;522;18256517;17718725
2286;bc1qclp3rgsj8zq4x75nku84f64kqf4nd5evn2cffe;174677;1;174677;0
2287;bc1qycz62e05apfgknxryvxq7qefer6hzeujz9krds;1934881;1;1934881;0
2288;bc1qygksxc6j526z03efd36sxcs5k2z6xdnkr0x96e;782530;24;14945484;14162954
2289;bc1q7dqlemjv4deyqljfk6f5yjpuyxax06w76ex2xr;564706;3;925682;360976
2290;bc1qcqe30ue3lpx9r0cf54z6kzw4lwy40ykzyp2t9n;254916;1;254916;0
2291;bc1p2uq0dhhd8vn4075pk65287c8r3p0a8krzgxcnxpur0q595xezsqsem6cth;546;1;546;0
2292;1Gpcb93U9As9DamiXrYZN9RSitkQKDpvS1;5282473;23;6383870;1101397
2293;bc1qknyp5emc9u84a7300s0rtdflre9v7clptn7lers8p409x2fnw4vs5v73n5;13180862;1;13180862;0
2294;bc1qf9t9je42wanmyq4shl2qm6qa648k4h682z6yxf;695675981;6;695675981;0
2295;39YoEqaYFNN8mL4JtEAe17M8xjo3arDVEn;27482306;4;74411262;46928956
2296;bc1qvf8f8e9eww93p7taeel3hsxjssn7kwu65kpttsq8mf8m5alscm3sxcfgse;0;2;2809279;2809279
2297;bc1p7rrrg2gdfqa8v9pdh84ud3lhvsjhya5nwcxs2pm59jqssnx89ars6s7s2p;1969345;131;54337258;52367913
2298;39HtCSTtCdSZ9WLDG4hCZgDZEtikgMVM7B;19239641;264;304399752;285160111
2299;bc1pf635puyyz3mxfypw0cfm0dwec9rlzezsp3sx7q98m25ffnfzesuslse2u4;0;2;25000;25000
2300;1LMcCJLDwkZbq6SaqVpA4aw3ZKiF42USNR;8426412;24;15354963;6928551
2301;bc1pd3c6c6purcyztxetfcuws8t7qnvnn2csqzyv64ydtrcue9asjg0qxk77gp;8632488;223;8632488;0
2302;bc1phwv2dx28medh7lrcgukkm8r55r00mrgc22uj2eshyrs72nexq9cqzxp4y7;7992472;233;7992472;0
2303;bc1p5zm2uyj6tawkq62pacl6sfr7u3yy7hfzs6t5r6jckdx733c69ukqnjlu4r;66900;1;66900;0
2304;bc1psg4dcmql6heq5t67w28dunsyx9sffhvrfsm4nwmjncyyppamt7tslex4wy;0;2;169575;169575
2305;bc1qmvpdygey0d4ss75ena2gejj5xrep3gma6wpdde;16179260;512;770459301;754280041
2306;bc1p8xxnu88azy3xlrnevp9l3yrkqdnj43apxut977fqvd0nn47t37xq3wlnuu;1970867;1;1970867;0
2307;bc1q8aq0z7dg6exh6xvf6v4dw5n2zew73cgah2ytkwc0g2enenf4ywmsyv3lxk;13294401;1;13294401;0
2308;bc1pa7atwupp5dgnxh0usg60722ycpfkuehmys76llvaxdlqyr3gsyrsfe7a60;829620;3;1583979;754359
2309;bc1p78yugnem5kmlramr3r25sqtspawyeswpruy6xjx3sm9u8zhv4ffqlenfuq;3822;5;3822;0
2310;bc1p3c4wukf2q9234wfe86wtut9khngzaf558v9cq4f5nv5d5te45qwsagx70w;10000;1;10000;0
2311;bc1pn5xrng7e886mk7g5kuz98g8dlcef4qfquse23vteda85tys47txqvwc7ue;149842;2;318948;169106
2312;3Ghemk9bjo7fK6tRVcqBNHTHxcyimCUXmp;1080817;3;3409370;2328553
2313;bc1pj0pxz5ltwke25cd3flrzm8rhax5mgfa54law9lg0c6dkdsru30qs40ug02;6462995;5;16029032;9566037
2314;bc1pzcqrjzhtpfjxqj4a808dk9smc433tw8tvpw4ec97f8ca8m6xwz4qgj542g;0;2;1971336;1971336
2315;bc1q5xdmrs25e3ak54gvsacgy6a3ph4wtm4lywh0ea5qnefry5pq6e5q99yclz;185223;1;185223;0
2316;bc1pcd6mj27t0sc0m59upek3mrhvwatxuj2u742zeqpr84048yu486tqh4tuk4;195604;337;9784055;9588451
2317;3P4WqXDbSLRhzo2H6MT6YFbvBKBDPLbVtQ;16614945536;955113;50000056575;33385111039
2318;bc1qxuc7yxxqmwjcd8n7ackgdj4vmvhecfhax64jwv;704000;20778;306645000;305941000
2319;3Es7o8DQuCx5RU3wdHNX4q6vWUCZKutzWj;19201120;4;45492692;26291572
2320;bc1q38lkn04gcjsewn6u3f90jpcg9k6gpgaw5h4e2nuxxsm7625k9t3q3963dg;1372022;1;1372022;0
2321;3P3uow8qpvEouUWUJq6XwmNYVzXCrWgQ37;71469;36;15598468;15526999
2322;bc1qtsyc35wutsymlca6m8tahvph8dlyj2xc3k2aqv;195403871;1;195403871;0
2323;bc1qzer2y852eh9408mw2nkkvsaeaz0qt47utpfzfn;5034111;645;355405074;350370963
2324;bc1pgn73j55rxxqlffpyvdwrejfjny2a302jxhrxcdexhzpentgjnqhq6usfry;3276;3;3276;0
2325;bc1p0vncsyxh6jr7m7ypwj5ptvq508unquts8e26ddsq2gpkhm0sfcls7c8h4z;303657479;14240;310191529;6534050
2326;bc1pz99qdjnvplfhg8ckrd578gknxqxsvdne8r8cjcnvnuervzmmen9qe80zpn;2000000;1;2000000;0
2327;bc1p8s0pv9d0sz8gxhw0njn36up769ncckp6rdt6h5vkt7cnakp37w5seqhnv0;2063923;5;5118195;3054272
2328;bc1qwh2gtnh8w5edkfg664mcwhp6eprxz48n3ckxq7;215391;24;6260647;6045256
2329;bc1pfta5nr5h0xswal90uqdasc83uknsgl722gd5h5v6kjqj7tk6nq4s4xczva;275950;4;922870;646920
2330;bc1quce5z6j5v4zcsrphtmcux7g9gwru0w02gj5tmf;545243;1;545243;0
2331;3NwcBigoMhqNxMKpRBmzSCTMhrHt1EW54k;874800;1;874800;0
2332;bc1qyqsdga2k00dvmkcwrsnfazy96ue0m2mz0ft5lz;2191266;1;2191266;0
2333;32SFaSkuzAyFEf3riivbpLFWvW5X6ywqHm;1000000;1;1000000;0
2334;bc1qd70hngaw087ej3h0ws7c0ju03rnfvkw89yr9u9;170920;5;170920;0
2335;31nrdYTo6j7CQVJMWJWDYffFP7Y6DGjjHT;4239448;94;639104773;634865325
2336;bc1qu2ydut4vmsawtx36dcmgv3h88myt3y6cy43mz9;1650000;1;1650000;0
2337;bc1pkgv0relc8ufnff3lt0f85ha958an3xvw0h2wv5g2a7hajfqeg8eq3ywlfr;10000;1;10000;0
2338;3Li8joQ88YQ7q8LfYB15gQRyyLEuRCvnb7;8425671;296;185047093;176621422
2339;3MPpSQorNdZW6vNYiE4wBKNM8yD2wLz57j;53581;205;18166874;18113293
2340;bc1p05wf44vtsqlyn9djlnwgugtqk2tg5ptt3u3cn5289vpqpxt7txkqwcflyk;10000;1;10000;0
2341;bc1qwglhaq72aydytapvxxp9mc2jw0qk8tlat0xxvp;3991550;1;3991550;0
2342;bc1qs0kkdpsrzh3ngqgth7mkavlwlzr7lms2zv3wxe;46615300;25888;4421205968;4374590668
2343;33KizG2sHLHtJJSN7sdwXchZXGmnBxkfrE;169865;9;739975;570110
2344;bc1p02q5h3076t3k3f300yqrz7flvgy3r2pgt6seav4cua04868txadqmqa93h;1092;2;1092;0
2345;bc1q9qwpx2dxncqr4v5qm3g0dae5z4jz8msl6rphzs;7231305;22;22121426;14890121
2346;bc1q5g4w7sajpqvd0syvghsqvrxcf2ysxce0yxqjkx;368194784;1919;368194784;0
2347;bc1q327jg47x6emnc2kztx87ue5tywaksgjergwrdz;153100;1;153100;0
2348;3FeESDTG6LM4JUayGZvKWMRCBGP1q62LB1;156682;1;156682;0
2349;bc1q0nzuhaetmz4f9j6gjlxwqvx5d3ehxp4mkwlymu;208199;1;208199;0
2350;bc1qfan32ax6at04m46czh93rr7tn7lx8c23qm99ex;754100000;2;754100000;0
2351;3PhfeJjHR9FdSvW476xSv97rgFUJUyr29n;2606713;39;27891273;25284560
2352;bc1q8p28jml8w2p7jy0fx4vt8z5lkdu6lk4dmwr9ax;1794533;1;1794533;0
2353;bc1q95enntnhrf60flj9yekuvwg6qumer4zggjjmhn;103902920;1820;1291007019;1187104099
2354;3Nty2qHpu1aj4AJugyGfcc65hL5Wdvm87c;180000;1;180000;0
2355;bc1peraundrzv5fkl86sj6unwlq8uja9ayqulp8v3ptggh30kzp2ekwqse7mlh;10000;1;10000;0
2356;bc1qcqjffa94w62d2vsqtwjhm4uejapgt8z0u3p4d9;75800;1;75800;0
2357;bc1qpwl3cxgpl8lxfr73932jkpg4nczsg3r2ga65kh;491490;1;491490;0
2358;bc1qpxzywhg4cgvwp6a8e7ctg95aqklc6dlzeg0vs3;731600;2;1475800;744200
2359;bc1qr6mgphcuwuqejf6lzn7e4jdzvx6m7zq075uw7l;156547;24;2006362;1849815
2360;bc1pt4wt645zm7c2llyahl4x4l4w4nc4z727xdnezsvt7lnllxlfqqzse2pp7x;1760569;5;9791040;8030471
2361;bc1pv30s0xw955usyr08xl6ea4qcueng3ek5ahf3642za87qvntxpxns4r0rsw;700000;1;700000;0
2362;bc1pvxmn3wnke70pqw6ze6jfw9qluffhupsgh7za6xrultpk32tk4r6qswkzjy;715429;3;2216616;1501187
2363;bc1p03etar5k2znerplcxph6l8wcj5s6klrjgn0z7hxhfw9um7d74a4shm2g0g;66900;1;66900;0
2364;bc1pw0ksc3jq8t6a6sxlk3uvpkwq6xu4ptzvxq2yk8x7r6y3j5sra3es572hh9;2184;2;2184;0
2365;bc1p9rskuv73l47qqsu555y5h45gsf2kfxw7sr7pp3cnlcn2xujecrhsjuvxqq;81000;1;81000;0
2366;bc1pwz72vl0kxvn3qvlrl45w9k7ppx9vl97ka0nl6slu945k9dg7jq8s4nzukh;2602758;1370;468442124;465839366
2367;bc1ptkc9uq4anmf3r9wrm5gmlzx4784x5d897tyt905vtwxj2gy503aq68q2m7;300861;1;300861;0
2368;3DcFsTcAwQLEQhj3sGdiQgbNFN9EmTKstU;1880714;5;15630734;13750020
2369;bc1p3guk634mfmaqf0ntsz347pmtsc3e2t87dakuh9f3npvkrnnxgz3sy256ue;22900;16;25426;2526
2370;17fDhoCMEprjnpsMxXmyK2bj6oDwiAXb3;398166;1;398166;0
2371;bc1qq77nvpagd5jk0rs9r5w0suknhyfqhpugtkrxwe;1168964;99;24095008;22926044
2372;bc1qe0f06cp6evg46efe0u4528lah80kaxs6j3c5f9;981282;27;139146322;138165040
2373;bc1q6mdy2my2w7dhc6gauc78fdjv494dwl4a80m0zj;76300;1;76300;0
2374;bc1pw2qwt5tw8g6vnhe4jv4x4ahww8r6u6wuz2d73lu0r55y7n483jvq9esuhf;0;2;773000;773000
2375;bc1ptu8cplut7sykd98fqmvv3ctmrvr65jprnykfd3657vjrkt6lf75s95wrpr;3090364;2357;1696637907;1693547543
2376;bc1qwtmwve43ef9fups6t8849mlnydqxmhhnkmhghj;1205504;172;100337936;99132432
2377;bc1pxzvn5fqrha0cfae8gtzf7rzasaqz4rmrqsa5j0kw29h9yna8vkwqnl70l0;3314989;4;9158976;5843987
2378;bc1qqvc4wflc5ns69mwzysrhh60q9d5jzhjufw6vv3;209405;8;1314812;1105407
2379;bc1pkgne0a5xwsre5qsn48df8nnuerq7dyz6tfnqptxx9t3ax8npq5tsunp4d8;10000;1;10000;0
2380;bc1pt0n6ye2jnsnha0fcwszmlsdyzrh8jr53rcx6zn7ka0lkayplpcvqnt93x4;93750;62;198290035;198196285
2381;bc1py4wwpz60fxl89spxzafky5smu5umyuaxcpxckf4n857vd66scqws8p0ndm;6023280;4;23964760;17941480
2382;3MJAvsk4Zo8ZKcMcwFiRVtUXDUE6TASbBg;9299264;204;216693839;207394575
2383;bc1pqgvw03nzpn6las7f80mkpwm7wxynplj7cmt8zruw7a722mm7dz4q0zysh3;277321;42;29160726;28883405
2384;bc1p2mmdvqvcde6dsuyyxw4ch7pzjtlhslknqpjrnuyrpds7kjen0x5qm82uqg;10000;1;10000;0
2385;bc1psd74s8ckswurtjfw88hfkzgrcq63khk47ra74fknul3a2sg3207qjtnngq;300861;1;300861;0
2386;bc1pvnnyre5yqksgg4r3w6k5n4gu973633zp84qt27hh6e6nn550yg8qu6zcpz;10000;1;10000;0
2387;bc1qsca6e83rxap9xel9a64edscw8t9m6mdrc7p49q;3849814;4;16593400;12743586
2388;bc1qmjd7v5wjcvz3y23n9rs4l6h3ued3lkxsdm9p0n;1560973;1;1560973;0
2389;bc1pkwmhq48wwus6lxu3zpx8f6t344qw7vuru20krwwg2pmn0m6m5n5sa6xtz0;546;1;546;0
2390;bc1q6fmqp3ytm5nzqv00amknm63axjue2ueq3nj90k;59533750;11408;143159319;83625569
2391;bc1prutwzwtnh920q8g46ndeu3utx6lctrzzvfep7em8ns25am2yg9vsfxhndh;20275088;954;20339934;64846
2392;3Qt5nDbz5Vw1oecVD4m5VdcS6C9FP2UxJP;1000000;1;1000000;0
2393;bc1pjl4759vsr7epua8e7nxqca7s6l04l0lxn7ndzyja58tgyhymnlgqfu0f9h;4583248;9;9218652;4635404
2394;bc1puxh8hwgj498sevh49hfx4xh49annpypjkmk8lp6v44qkkxm9kjesddyvfa;774561;1;774561;0
2395;bc1puzdnl4hjh84nqxfvwjjegc25tqacnlfsuq4lg2jhpyn6d56zu3fs5pdn6e;0;2;38000;38000
2396;bc1p52a03zf4ry37jyr8pfzx4lsmz7ezu80w96990nmk95g2fdm5qeds6u2skx;139087;2;314609;175522
2397;1UiW61F9xnBnnC1J69aPJhFm3ZXvZEkCm;969315376;39356;14401800045969;14400830730593
2398;bc1q90pkp5dvs8902nfdgx9ls7ysdxlnzyyd03m9he;1126985;1;1126985;0
2399;bc1p0jls4hxnz82cneqvk82zlas2s89vkddqayem2hm5qqnwq8hwxugq9ldhfa;23666;59;28404;4738
2400;bc1ppqjjrsvand4pnjhqk86x7g0qrd0he52uzmcrtv58qhh8j7htedvsz02wve;10000;1;10000;0
2401;bc1py34gw6q385wd3t4u0urdc37k5dj88r8p0ylpf6zzd0humkl9vxeqqgsecu;6017916;35;353266921;347249005
2402;bc1qkfwhgafqj5f782fu4vsxu7hsa24ycc4vpgj45r;748264;1;748264;0
2403;3LjV7BE4BJPmcGDbtCmszpbpTHqr9HthSo;1000000;1;1000000;0
2404;bc1peysv2kvr84fg57ph6cu9chp8u38dchmhz2c8ag50fp0cawxv07aq2tzayw;66900;1;66900;0
2405;bc1q4xhnfyydg5545fwvshz3vq659w62nh8vakare3;39075;14;438180;399105
2406;bc1py83w978da3qvm9n4fyrw5t43xmelqzr92jvl7qnuavvnzmd3p6fs0l5mk8;66900;1;66900;0
2407;bc1qtn5a3se0xweqcwsxhny4ttk5pjzkks9lcjapy2;1009850;1;1009850;0
2408;bc1q53k7y2e3thmr4fdh4swl50p8z2ujzgmczkd7jw;5345028;2;5345028;0
2409;bc1p7ajazkpu4353hatxu06sm9swp8jtesrg5wqcgytv4pzdtv2wlpnskztt48;10000;1;10000;0
2410;bc1pkgd736c6hfn2cxgq98rk3c6lgrahgav2su5mrntf4vtm0l7rrwwq9nwz4y;474805;15;1304610;829805
2411;bc1qhestvs6nfqeg48g99947s6tp3qvdcrg5rl78y5;176827031;1;176827031;0
2412;bc1q53864r4pewvgsawsta4xs70xrmzxxqa4qqm74h;231990593;1;231990593;0
2413;bc1qj76crszarpquqnm8tyjw9497stcy0u2v30a0cl;161436;1;161436;0
2414;bc1qu5nljwhll55x9yyhlty5jgyjvjcypk5ufg9n3x;271321564;1;271321564;0
2415;3J7guQV52hFKeSYyWx1MgtNMJ25T6ANeX7;156000;1;156000;0
2416;bc1q93qluk6ssem5th6lmmlhng8lpze4mvk7pe2dfa;513352499;1;513352499;0
2417;bc1p4qg3fav3se8f9ntp4sa5km4gwjztk0d939swy3yglet4vx00wkcq0syuk4;4189977;14;24638589;20448612
2418;37jaevJoBDT2tDQofGk9Y4zj5Zrs3vvdDm;1273653;9;5511271;4237618
2419;bc1qp2ygjq7xakl090gk729ryy52lsneahm2gjp8d4;12523;3;89200;76677
2420;bc1pv5dg4p9ncnnu4thwrruelnupg8d5u3c4grsyd2qjgd0w45edpwsq8ppprz;10000;1;10000;0
2421;bc1qx64se4xfa6cqa9d4y4g3yngscn7x5jt3uvtuyp;624415;1;624415;0
2422;bc1p32nktsuffprllv0j93a2d3q33s0l6rlh598hynkgrt60lf6upqmqasw00d;155083461;8017;623104586;468021125
2423;bc1qclzajreqrv9plzc2k67gwt49fzcc9nt5c5qk9v;15000;2;15000;0
2424;bc1pswjyqu7vda5whzan6m52pltgrgyd7r3ddnh3la2jd49jkd27zuxsnz8afd;1092;1;1092;0
2425;bc1pfjalxkg53s43vkazav6e7wregpkcz5wyp8dasts9vrepp6dcnmuqtq7f52;16669;10;16669;0
2426;bc1pz5cney9nzxfyq39glxjawpfk50y3j22vngun6a06yk845uzl9naqfus7nu;630723;2;1383666;752943
2427;bc1ph6pp0hpw2h5ch38uepnqh3pdqau9y66z7tukfrj3q2ralazqn2pqaum5xp;0;8;199723;199723
2428;bc1pxmk38k8gn8c9l04ch5k5gvj93da6vralgz6pm20lx5mucw9pg9jss9y4s3;1016612;6;1766971;750359
2429;3BiTozPyHwscztSJYMWf18NbQEXS4Y638R;4596998;67;45448665;40851667
2430;bc1pggrlehg2d59nmmua63ztgp2g6jpg3rds83e93duzx6zw6l0c8ahqe4caps;10000;1;10000;0
2431;bc1queg9atlxegfh5nvhdyzr9nvk9pz95mj2ffp6yzag3f2k0n90q9eql69g8g;832606;1;832606;0
2432;bc1pl2pt406lk5gee5s3t3xqnfg0tjs9h4e75tm5vwa9wa5sd99tuajspelx22;56384;165;127497;71113
2433;bc1p7xps7vmfq99g33ffycvjywmk9qga8lfwufdtlaj0t7kgmdf7z7vsq3d3vv;42410;9;328560;286150
2434;bc1qzkkqm4qex5l3jd4407axs7fdrrsmwlf43f6wkc;643848;32;11599659;10955811
2435;bc1pkvsj5wqrva2a5zud8yep2pcf340dn03a2zdd9h5sc5y7c8rcwsfs42g7m6;4460654;181;375971405;371510751
2436;bc1pvgxkz5h4prr3wwfl49ql9eg5waxdahmnzquzarn7dckmw64xxpqq0zhxmt;159500;2;342300;182800
2437;bc1qvlmefde86xp34hfelppk3qp3kvmk8gk2jh2r3w;1567693;1;1567693;0
2438;bc1p8kw3zm0alfy8rnr49nk0y4t0tqpzvfvgvh82v0sdjt4ev7hulg5swhhahu;378467;1;378467;0
2439;bc1p5mrunnuyv2dv2sudxfr62akc5ehe64nsfcces27w9kpjlwry96usy56w3k;450450;330;54187852;53737402
2440;bc1pp6c8ncw6lj93jdarxsh09xnh7f2p7xusjhpfdld4pzpsk5em0tdqgq0vdt;10000;1;10000;0
2441;bc1pvcyw6kg9pkfz5hxpks6tt0zxls738ayahcw576alhjpxcrctvhdq2pneqd;560;1;560;0
2442;bc1qatqm0r7ejvfprwdw94yuzyn9jn7lz4gkm7uchg;5471237;32;119567825;114096588
2443;bc1qan0w06yu6e3tt9876c7dpc5eelng9gy5w07hvr;253121;3;822117;568996
2444;bc1p7g0lvls0tktcmhymt22y72dayertfem65tsl4lww90waxa70ukms7cqrt6;472830;1;472830;0
2445;bc1pegkayjtykzlyt5vpjev4epfdt4w3t4qtna5vwgxntucqrn49p9sqqpuexq;10000;1;10000;0
2446;3KrfD6hFWAz8rdvykM14t6FvEyAC1rzCtH;58574;1;58574;0
2447;3M7fNZGkRMuRTLZsTqcNc533BDdzF8SWqi;9815181;1;9815181;0
2448;bc1pcszr85u7lxphu2ffdmu2sfnekq58c8kc4dxkqh7a38dn6w6ruvdsluzkr2;546;1;546;0
2449;bc1qgj8xmt0tu7657qys5uv4jhyme8um62z5kunhcx;344200;1;344200;0
2450;bc1pffppfl3ey95s5kpf82vnq7lu743lwuehxx4gdr2snv75kfc5h9rq6g9x7w;10000;1;10000;0
2451;bc1qcxmdr4sah3j9h3ww4m6wrevfsvzzyw74672ppg;122660458;1;122660458;0
2452;bc1pwd0haahtncp9fzxtr4r43rlv2yz55t03fvph5t4hn4nhv5surcuqtntf83;330;1;330;0
2453;bc1q2fwwkyq6t3rye5xrywvx9jmzezffmjtuc2lltd;564200;1;564200;0
2454;bc1p8pa6q3zpxjz8dm02f5fnraehvhrfwefqe8p9ucn0xdktqf4h0fvqvdvgum;300861;1;300861;0
2455;bc1pe5fe4yjt7jcqv6ujp8vjrc7q3sxq855x73h0rdqz5dxk0sdayvyqaz4cyl;0;2;18850;18850
2456;bc1pmyqpnmvx4sulvn4xcdwvkcshywlt2yr90npm5y3gwp47thepcqksuhgpwv;31221;25;42305;11084
2457;bc1pg094elv72vzstuv2zsvmwetqnj03nmtmr6hsvfnejdfssgn8ef6srqu8v5;50136;1;50136;0
2458;bc1pp2zgvy3t93paht6zvrkk7ntrgzhlqwfd9gtfsc6yxzfg2sf602xqpkz48d;66900;1;66900;0
2459;bc1qkanut3zdxrrhj036msyuec0m2w5eqsx7msk4ap;75128;12;275128;200000
2460;bc1pelhgvrhktlv2mg3f7a6fag99xx65akwz8kcrwtj320fva2emg07s4pxete;2234338;175;201592471;199358133
2461;bc1q8nt2y2p9snqlar6edgrmzfqxl973px28mq4xdj;168758;1;168758;0
2462;bc1pl7vpdc6z3t7vs9f53js6qtlas0hh8x02ghqf00lu7q04cz44kcwqm02qj4;10000;1;10000;0
2463;3P4WqXDbSLRhzo2H6MT6YFbvBKBDPLbVtQ;16607759955;955050;49992870994;33385111039
2464;bc1ptc9ft4zfgywephf049yfyzejrjkjnpvv2vwv0jenpceewxs3dwpsm32ynh;10000;1;10000;0
2465;bc1pmd99vgq7e2xjajlndm00ph052uvaqasjmxmm7jxrf6gnh2u0vmusm5znrt;0;2;66900;66900
2466;bc1pvr976hgy4ehkcagwghy47lchle375pueevgz7ydhx0eunngwcfhq5ymqa5;0;2;66900;66900
2467;bc1q8npngvtfqaf77xnatl8gjnf0ta95cppn47fnh2;13583212;7;47691102;34107890
2468;bc1pgn73j55rxxqlffpyvdwrejfjny2a302jxhrxcdexhzpentgjnqhq6usfry;5460;5;5460;0
2469;bc1p69chnvgjma25ehdewlgjdhkpax2zc7tyjynwzt837678lqyjzpdqt959vm;2964800;12;5688514;2723714
2470;37ShxoP2p91c9RkSAZxhAhDmHgMX2JCfUt;900000;1;900000;0
2471;bc1paa7ywz5l9an5usl5uhyqdtu35gxnpt95yuqkkj4cc0369e0ezxqs8fxerw;55856;170;185443;129587
2472;3HTBgVmCk8jgJmnDg4AoxpgbXfBpgC5R59;39233;37;27455860;27416627
2473;bc1pks8z8sfzq8s7gw6w42tx93jyfnye8dg242jwg6px2jjhrw26dgmsahas2n;209203;102;235709;26506
2474;bc1qdlgsketph66f48khg0mlyxmlf0md7h438fphsw;367098;4;1543992;1176894
2475;bc1qhh4sfwwmgkp2jnuq9kaaj442ywmnw8vzgktrns;200525;4;877700;677175
2476;bc1plu3wvpftqnhmst9h3w5gcdh7ytamv24qlcyrlgpmf265892vu2rsdzqxj5;10000;1;10000;0
2477;bc1qxg4kzju7jdpvy6ltq3k0phddjfz5c8n8xt8yd6;3790200;6;3834600;44400
2478;3MWFXKUWGdSJEfQJSGmg2J9Jrk28RnUaqJ;7048281;186;351095990;344047709
2479;bc1qnujy56tdsfkdx9dkfs4qrdhp4gzdwlru7n06yr;404200;1;404200;0
2480;bc1qq7j7lxsfyqyvaatlkd8a2hwpwu9g4k6u38nh4w;5646300;1;5646300;0
2481;bc1pwjna8h2epv73aa4atmqfztm9mj25f957vdemprn7ezukygwcrz3sm5xk49;10239560;283;10239560;0
2482;bc1q7zu0kf09xzj7a9fjzdzsjjyuxw7rrzey749ut3;83101;1;83101;0
2483;bc1qwevvfeng4rf9zpcqkt8cnpvt4ggvgh93r3xvl4;28809;34;3741651;3712842
2484;bc1pnrf9mtv6a46aeffdp6zrvmv65u7hduz57x2gkwe0ccfayfzjgtmq8pfru8;4457604;139;179879103;175421499
2485;bc1psjpxnhcqfam50ekasewe3y76hzqaknl6hy2mrpwxfazfdyl3epfq0np0c8;662266;87;133068468;132406202
2486;bc1p5shes3jxh2cnx3aq8l0e0x6jq3z2su0f4yn99fqjx53c0dtmujdqtqwetu;248684;250;526390;277706
2487;3HUSyoz1fwdZLAf7ZWzjHdycLYqExi9f6f;278647;5;1141806;863159
2488;bc1p97tzhadxh5ns7k3jldk5lq7auuhlxnp90rrt84xqwcq2qyal3s7sfjy2uc;12405416;298;12405416;0
2489;bc1p5xfr5ww5l93xt7sughh8ztxk7arlra3swegc9xvqn80wwj6ruqgq6srnc4;3615;11;5808;2193
2490;bc1q9hdkvkcl3kfuh9rgrkgq0pvk57deuc4f7wu0h2;926400;4;3781200;2854800
2491;bc1pxlexd9460vt6e5l9y6amzy8d9rqtw2lw9rtdgvlw2dykx67ujc4s0q7yzj;546;1;546;0
2492;bc1pxt88cvzdk4wdfqdh4wxcnvyk0meuf4k6rcct2yuc6gaqq9r73n9quv2xft;10000;1;10000;0
2493;bc1pkpgzznzh3chk4v86f7mfkz4wc878fnqm00gum0wrd6adtl4n9mmqlaexyk;88272;20;482838;394566
2494;bc1pcf8qwr7vd6hj743fgvcn8ujlnnkj2dlgfky88ml50ggkyhccmthsjjx8x2;10000;1;10000;0
2495;bc1q4dnn3p4675cjndny0el4d6c3ekuz5uv9l2mnz4;326400;4;1381200;1054800
2496;bc1qzefggx5h20wj0zd5lacp9py74wapg0gu8n8lcn;1124386;33;98755341;97630955
2497;3BRZYnHuQ2v6FmxabRpu4ny8cqdRTvPrJv;7993853;15;54809458;46815605
2498;bc1phzck6huwvyel7j7dggxkg8zycfauwujs3zfujfhmfh8luqstetcqks64zk;330;1;330;0
2499;bc1pmyz9elwrr58p63g9fl8cxs8fkgzppu6234kgjknn8yhd0ya77m2q4ypadq;405463;5;1148747;743284
2500;bc1qgzxa32j695mq0g64nvnwxcxzamculhnzt5fqs0;330;1;330;0
2501;1A2WJt96bQ3d5G8VBgSgegCBR7Y1h6xhKg;21000;1;21000;0
2502;bc1pv8nn0kvzh8cpcz30yrxns77r504xe9fyqnmtes2p7hjcdxq5jv0q3lr9l4;2184;4;2184;0
2503;bc1qvs2hts5u0mk06ayecd3m85ps5w5emuxtlxeg9x;46058766;9581;104491114;58432348
2504;bc1plh82wya7xy0grpmuuxk0450zepl5prah07fqp352h204vdq05gxqjsy229;1000000;1;1000000;0
2505;bc1q8c87cp8yhkw5gjx0r0rj5y0fev6l7xql4f3zk4;4582566;1;4582566;0
2506;bc1puc7jztjz50e7vs3ktxuqlgdchqhsj3rwv2fp50j4d20fqr34sqwqqpvaqp;10000;1;10000;0
2507;bc1pyjdczylyc5742ag7mn9u6xyrtvse7pms24ju8yr0crrdcuhhr8rq0jj25n;1483226;789;24588048;23104822
2508;3QydUm5XrvLoZW1rWDhd9a7bqhcrs1uKGP;10000;2;10000;0
2509;bc1pdl5v0qp2uhusc3jy25gs0q7rqkw08cysmzutu5nhxdg37krynn7stm4k67;10000;1;10000;0
2510;bc1pn9r4azdplmvf03qsadmyhmx8x5cyslsrdllshws8g7c320eg75lq0yn8qp;66900;1;66900;0
2511;bc1pee42eyrllqt507283mm06c3lrpfs2rvan7gqfrggkjt3rs835pmsvnvjrt;73000;1;73000;0
2512;bc1py64v0zz9dw9ew79q98fcqwwnszhzs932j4n73etx705vdsxtu6qss746us;47730;1;47730;0
2513;bc1pks2fl3wghkes8urc9xfwtsj9aqwz2qwfaf5ata6k2tnf95x2sfassjuekl;896707;867;397250990;396354283
2514;bc1ps4vmq67s4kkmzq44cp0hu2crk75x8spngsttw78rg7mlzg2yfg9qrskgy4;10000;1;10000;0
2515;bc1qclfr9cv0sacuuyrc8dv6q87q7zhwlykugss9uh;563752;4;2330608;1766856
2516;bc1qrv0nqtsp9ulwp2fwvly4gg0gkr4k602ka6zvrk;1500000;1;1500000;0
2517;bc1qmsvxsqyeyedkzm0u36m3j2fzm9za2ww5z7nwzy;3919295;1;3919295;0
2518;bc1pn8fawssyelgtrec8093ldj0zekynjdvqaplh5nsphu0tpk6zuyrqj8cpmg;10000;1;10000;0
2519;bc1qfnkndansa0tvdzqlnpxzjun0nptr500yr5y3yn;256110;26;256110;0
2520;bc1qgakrkv4nq27vtlxn6k2wpv0gurqw9526q3np0t;878831;4;3590924;2712093
2521;bc1pp8vzvky5ew4v87sqljxs3nlh0z5v3vzweg4kwf2uvffs0n4qer8q5fdnsy;0;2;746000;746000
2522;bc1py8k4k2pn3yp74qu96ldqwmyrnryqmyc3vzcemkaw0kx980qr3pgs4ak7jd;0;2;66900;66900
2523;bc1pglj9jz7vkzv9pwlvw3skl7xtlvg639pcdjna59gqnttp2l9kszyqutvxyd;10000;1;10000;0
2524;bc1pv0wpk0c45syhqr27eefw3amlv5p5vadgvlxmzd8r5dk4wmjlej4sxsmy44;100700;1;100700;0
2525;bc1pzhgfw7yqh60ds6qmfksxa65kpk5kc8y0c3tezl0mqlsd4acm87vssqsqj2;0;2;10000;10000
2526;bc1pxzuc39v9qgkjevezca4c092598rpfdvpfrwh9mgpr830m6hslswswfgfa5;624972;512;62688102;62063130
2527;bc1p7er7crs8vvzxnc8szj8p8dzcm6jux6j65k7aryx4y6pnp7ttn3aq9fzh6r;0;2;66900;66900
2528;bc1pvz9g947dsd5pkuqtrzjyg2cmgpu69p7avgw778kdr358gak6lydskqrt7j;66900;1;66900;0
2529;bc1prutwzwtnh920q8g46ndeu3utx6lctrzzvfep7em8ns25am2yg9vsfxhndh;21286534;998;21351380;64846
2530;bc1p68qep8g625kq0na7yrxadtsaz2fs9cejzl5na9680mxfkk202cyq78jut2;10000;1;10000;0
2531;bc1ph0a9xtam8we3p76lskxgndh283rgmspcsed9s7n62ltnztz7lvsq8gvvmk;303987;46;25073536;24769549
2532;bc1p7x25xlqn3us3xq4qyuayta77wwx389rc76dll0q97hmasqnc77wsgndu6g;10000;1;10000;0
2533;3ErgnfdoKRLuRoEUdBCuP1ZfBoYTTubZqr;3139524;196;429196190;426056666
2534;bc1psxu6wennk35jfk26wwclc49fzyutyqcmpyc4dvxj7scmt7gendnsptza6x;13000;2;13000;0
2535;bc1p6rquxgazdtae8ljxtxjjmhvf2qe7w05v9308ywag2dt46zvknp8q356e38;995737;1093;12801997;11806260
2536;bc1p9s7qka83udzqmkmcxhprm9d5y8zzc56576kv5eutkazytql987hqkteg5y;96287;98;15420477;15324190
2537;bc1pd9heq93h85ewtjsls5gmxkm5mux5ydy2fk9jpnml8d36d27ssufsq8v664;10000;1;10000;0
2538;bc1pvczd84s55dgypvng3mrr9r9kmd76f9yzruvxz8pl35pzze95rutsugh7y3;10000;1;10000;0
2539;bc1p7n0qzv5w0hwhjk6vvl3sjx8a79wmatwtqf9tsna894yfl6gdlaesjj7r4x;93005;159;26206738;26113733
2540;bc1qmtxfznwv0fct4708wu3fmjejfv5fvzkg4wjatv;216400;4;941200;724800
2541;bc1ptywc95dah9s4c73d40mtaxfw52xartxyq3lq54e3pr5pr7y900ss6v45ut;10000;1;10000;0
2542;bc1padh248t7z66xatyszs8mzp4yt59nnw7v577fcm3vs5rytt99c6gsuy0rv2;0;2;10000;10000
2543;bc1qjpqgt5tca9wp62ptp3x67mnyxjxfd66vv9s4nq;1391654;1;1391654;0
2544;bc1qwypuzq9f82p76l0vg5f59s7dpf4vhtpsrmn4fz;2881400;4;11601200;8719800
2545;bc1pddt07pylwztawd7juvz6xxvh2weq8s6x04qyypgah5c8mavkhksqhpk248;352439;528;844956;492517
2546;bc1plkk4upp49m3k0ewx8ee9ledajceur9l9j6umg5xx4gt5xcl0m9zq0g7r0m;4914;6;4914;0
2547;bc1qv86ufkcv626tqv2ms5kh3azw0asmzarklw98rc;484440;4;2013360;1528920
2548;bc1qhhdxzue3sxl49k76vdzn0szk4utup087cm4svv;415184;4;1736336;1321152
2549;bc1qdsvwaxtt2dn7tww3rg37zapepgus3zx5j8e5um;3747900;4;15067200;11319300
2550;bc1p5mgzza0arp7k75m95vafjj0mf5uap7wzaljvm346zezztr5pkdps34y9ke;66900;1;66900;0
2551;bc1p6pcn2nz0q9sc9g6w9j5vtq4qquvds0e6tzxvmtvlqyn7kej90yjs2j070w;0;2;66900;66900
2552;bc1p95cln256pcudsygr2u929fsal7l7lf6w5c8v2w94qm2790kx5csqwt9su7;1473000;1;1473000;0
2553;bc1p0kkjntm4ayfdcaysrkwplnqnetsf532t7qxjrsa46puvf3md4ess8nsv0e;1092;1;1092;0
2554;bc1pey4jx39ly6ccg06p8h58j296xgkxylwfwpps00s2vyxl5qygsw3sdvfpc6;10000;1;10000;0
2555;bc1qsscx7qhgf9gwksje0zltgyrw3ztvfl9x6zj6m2;49874913;9707;111121801;61246888
2556;bc1qtf5ynw8hvvyqegau5ntgkwkr5ymj95zep3t87c;0;2;164200;164200
2557;bc1pmfxkaxrfvsuspcapyspkucn5p2ju70am5fv90spf4rxflww4f8lql6up9e;11092;3;11092;0
2558;bc1p8flejk99vunyva5f09adat4grxx5tmx85jy9z7ca4x4ndyz89zqs6cmsm3;66900;1;66900;0
2559;3LAv9ZzcVArVqvGTTNiGBZcG49yPPYSGUn;5320418;77;157488384;152167966
2560;3JVubFJkWyk9fbZomFbAcyvcSC3gRB1mFy;44341;79;36911383;36867042
2561;1BkMddVZ6WJfWpXw1ucCZMfX32R3hjykpt;21000;1;21000;0
2562;3GKwTA3M6EF9RAqba86kudjfHtufgadwmP;814368;9;4659026;3844658
2563;bc1p90pa35kfwr0mzse66kz8dn7mtms7eqcvyamfhglpe5nz65lq9f7qrh6jpy;2894556;3;11802556;8908000
2564;bc1pfk4luld6j7ek970xd6tn82zkw9lyvrypelzpgf8ux7wkqcm0yylqqyhkju;236870;1;236870;0
2565;bc1pj9yld0f66n7chqt4avzm6nekktj994ayhalvnyu3astxn6hs0mgsdcsxvp;7518299;7;9518299;2000000
2566;bc1qjt2ppsyxcvaa38yrd6ntewp3k4s8vr3ekdtngq;164200;1;164200;0
2567;bc1pjgew6dlqtw2xmp24arkyhuvj92q30n7qfqrpc8ff58nk39lufgdsgdx7ka;66900;1;66900;0
2568;bc1q0da0w9pnkl73t59ptw6jqn6aqqvtff2xa8gjfr;803386;7;5187893;4384507
2569;bc1pvvruqdn9z8rjdnq4ll3zha8q7x8s8ymkl26myz6kjafwzt2pmuuqezhz5t;10000;1;10000;0
2570;bc1q789vwlsfxdssttwc9qsylqdche0ya2jaxwz4z5;172388;1;172388;0
2571;bc1phpj26v5cfdh3v6qp4rqlchl2dwtpd5my9haqs4p9rl8p9tmsqslshg9rvd;10000;1;10000;0
2572;bc1pktdcsad9np7e2tms43nwgv4mt8ug2vx0vj3tc4u8m0m2n93wyc9qjke2vm;316700;2;656700;340000
2573;bc1ppgu70dg6t86xs8n2s5t98h937da8pmy9ft2lnwg5mn8dejllw37qffhyfk;9260056;269;9260056;0
2574;155oTSiiohkbJxxqkxPsTk7Yzfw99ssUSx;848263;1;848263;0
2575;bc1pl35wn7k578zg55exz799m6v6pnu563wg34t7yg7jsnmxpmvw5fdscdsmvu;11083312;270;11083312;0
2576;3ESmShv36QMDDfeR1znYikyinPrhWThyRB;1461387;89;94326551;92865164
2577;bc1pqmeyhwahxgzj094gkf7m4e78xgv003zsav3wn5qu5zye82e92r4s3zuvdj;10000;1;10000;0
2578;bc1pm0mgjg87ykycntasncpx78w4gevd0hd8ykpz539kylm9waasuwaq67pn24;55874;66;609437;553563
2579;bc1p84hkzcxgvumnzpjdd5tlrxmfc0zdta94vrck6fe9e9gnpg84cj5st48qpn;0;2;66900;66900
2580;bc1pkwmlwhk7fkwj8w4md4dtupc0kcveyjflsu7zdcs3xegkvfa7fdrq0ly52x;0;2;10000;10000
2581;bc1p6wa9ef6jmwx2mppdu87ldrp9xv63e6q9k2y6v82265hyl6sdfs0qzlrktd;10049592;282;10049592;0
2582;bc1plfhq93zn7e94rksq2ymruh24r63adp5c5r95tajm2s5q8pq7eyjqwce4ry;3592913;37;119656472;116063559
2583;bc1pzwuhvlx6rcnv3vk53twkr3guyu3krmx4kwrtuy4lex8g4gp7548s58z5cw;108048;1;108048;0
2584;bc1pukdkc4rjge0m5rsfd855w970wpvqe7la9s3yzh2zexrszee5u7lq5w76lq;10000;1;10000;0
2585;bc1q2vu767enzz4h0tvudjlg50e686uwpj0ht392uy;706400;4;2901200;2194800
2586;bc1p0vhr30a5sra8pjwg4l024a7e73n9ra9kgzf87m0zu80np85zq3wqueq8cz;0;2;10000;10000
2587;bc1pk2gh4y6facf0kfphztlcnjfkp8zh94zvx2pgleq2mwhr70spztjsmepts9;154198;299;30521884;30367686
2588;bc1qaau64wyktpzpurcfpjsmvhcpws39yr2g3cej6w;163960;1;163960;0
2589;bc1p87c4hxr76ujlxsgfpjy5pxkmw3696m94mcwxdcfl4suxxhmmqh9stuj7r0;0;2;66900;66900
2590;32HNMJWccbhmTymrBBT2uheuE8ZjjxzfBZ;91721640;1;91721640;0
2591;bc1p5paya4melc2xu0jjpyn4ckp0mshcn2kewvrhmqfvwpu8hxagyvvqj55a6g;10000;1;10000;0
2592;bc1p50thy4smn43usgtpgw5z392sd0t2xne93j0aptq52sxfd0ea8zmstnelmf;66900;1;66900;0
2593;bc1qella33zh9k0yqf2m2jj5mtq6g7achgfn8mldcq;174200;1;174200;0
2594;bc1p78yugnem5kmlramr3r25sqtspawyeswpruy6xjx3sm9u8zhv4ffqlenfuq;3822;5;3822;0
2595;bc1p8mqsy7cx74xt38kssc6xhezhgx02vkvf90q0p0gxxrgq3uvh5d9spl5c5w;10000;1;10000;0
2596;bc1pm5l3l2q8k69jm3xvjf9ynsrlwg4qvz5pdux5da0ehflfpe79ee6swlz6nr;0;2;66900;66900
2597;bc1pp5znrfe44295gah2vp7enxp4qjfujg32k4jjct3dz5nhxr4def6ss9a584;330;1;330;0
2598;3HS3mM6WqgpVYLPYusELJxFZ7Ghn7GMBES;15162146;4;30424692;15262546
2599;bc1p4ctmejalnndlpqjdxvrnmx6mkr82xda6k3d9088rzyx2ldd45gasvc4th7;582536;8;3245064;2662528
2600;bc1qguzk63exy7h5uygg8m2tcenca094a8t464jfyvrmr0s6wkt74wls3zr5m3;286160229;900;455474229;169314000
2601;bc1px55zzj6jhpm7scpypxe88ym29d75cvz559g869eu3kf9wagtw5nql0s67f;66900;1;66900;0
2602;bc1q4k8lq33fgcny0apxjm6vrkp7wwn4yq8tsw44pg;682400;4;2805200;2122800
2603;bc1puvglygtxyl7hgdxa3m84u32x0rehujnkvgx9a4fys9tpzlg3v2rsh8fjee;144808;1;144808;0
2604;bc1qlr4yqdljvw7kwjx0m7tgu9wx5wnyxer5eqpql7;5472189;37;1629906872;1624434683
2605;bc1qd5zugu9524wc3tmr0eg38tgu7y3kxp5nla20lf;307311;243;650061240;649753929
2606;bc1q59333r5muhn0nv2038te3g3jt3j6t2nwp6nvqe;70649;156;35252756;35182107
2607;bc1qmpzxxg25gd2rx8x4ql3c68qtr0va0ym56345k7;43592;3;43592;0
2608;bc1q3xlcpsstr9j50jlzstcd5gn3dddywlmvvke40w;23225;1;23225;0
2609;bc1q55w5w54fv7yqclmn9jq75mc2gc9u4mctqca36x;126988847;1;126988847;0
2610;1KfFmdk9s4aUg1AibAydijmmHTV394jD32;5776472;345;47665488;41889016
2611;1PVnekrLwYov5vULNM2gJngjisKTJucQB1;116828;200;33001159;32884331
2612;bc1qq4zm4uuy6k94us35ddw6egw68xmygxhlnmxv45;60914;42;892535;831621
2613;18PEnv31hRKRLVcjSVMseXVFgA1fbV4i8x;2401117;32;2401117;0
2614;38rB3GWc9qwnAQg5JwYgAZbXhM8ddKAFTj;32409;1;32409;0
2615;36FQ27qpit9EPiuicnJLDNZ5KLv5vkVdP3;16799619;147;21243716;4444097
2616;3Ay155Xo7WpRzMBs7H3UTNzFKgZ8AdGBrv;20543;94;3155902;3135359
2617;bc1qq0fp3rpxpc5l5uad7kudqy8z284gm5hxw9dw22;32451;1;32451;0
2618;bc1q80ucsdl54ksun7usclug29r9xz99a8krgp8nxzlhffkg0zykachq499hqp;23279;1;23279;0
2619;bc1qtz0rjz9rn776sv6djug8f93v887vu0f2krtv5p8st0cjhsa6xkxqw3k35x;39615;1;39615;0
2620;3E7tmFbM5ffLSWcpBh1Ge63bDqEnZ7GSeW;240293;42;3910957;3670664
2621;bc1qg87helv7zw289n0n0xaq4hanpv7p07lyn5qeft;9537;1;9537;0
2622;1LfUqhyXYCDUEJsCSGg78xi1BicoeEsFjn;2124360;53;2749077;624717
2623;19p1KTakZP6aTa4QxFr14mJab6DkxrXKeg;3663769;14;3663769;0
2624;1MhRXXwbnxgEb6jRZbMa1Zg5J4SxUJLrjL;371665;6;371665;0
2625;bc1q7txv7sdyyqfkwny2qsp5wft6j3yplwx8tnscet;10969;1;10969;0
2626;bc1qt58j2a0yekpzx32dks28yjxjpmdlj6nrmnjghd;719246;98;8592518;7873272
2627;1AK9FErwobT6w7FMRL33XV3JKiAECy5Y86;86436;1;86436;0
2628;16DVXaTgdY8zFo9V9uxaHRP3LMjpUJ2Jru;5512770;48;5512770;0
2629;3JrUMXrZko7QEjq4VMPNX7pmfmngJUwhqd;1381040;8;1381040;0
2630;bc1qvsmpzz3vfks37f0cv92fl4sr9tsude060zgwvs;32614;5;91157;58543
2631;bc1qgvtct4km3x5u7w6n3av52aj00lhgzg2yr35zhz;5521630;542;2820284799;2814763169
2632;bc1qsld2p7mv6fcc4pteuzzd87wuqtsvcqz37m8qzs;182083;7;225857;43774
2633;bc1qqvrynxdjr9z37rd9j2k790mvlunjd4y5jfpl0g;77277;1;77277;0
2634;1LQoqCgYiGBAQf66bEJPdcMXWDytgLVZp4;38311;1;38311;0
2635;bc1qj5su8xjnwaqxk0hhq6dp7udvypnpdt2q5fj7zu;1535858;71;868689061;867153203
2636;bc1qmft7yp6kpfnutgn4sflwd9hs3gfsfr7thtyept;100881;6;100881;0
2637;bc1qqqe2t6s0mumt0tumvvna9nr8m9nfufqg35qevy;70299;1;70299;0
2638;bc1qk9fsp3y58mgv4nydrt8zt8qm69j8ckn7pazusg;100360290;48154;3304711405443;3304611045153
2639;1GWJa1omZ5GWTe3KRo8Xdq81yxsjTYsYpT;11186760;37;17429313;6242553
2640;3LSa3Yxq52NjgG2EUzzW6jDztxEy7xXJ4F;1630806;395;14460507;12829701
2641;14JD5mkfEvqhMZ9dyrwpMeGTH1xc2u3JpE;668426;8;668426;0
2642;1NiNcM3xSQse45nZ8nSwA69GhV9ADeWff6;12239299;61;14549955;2310656
2643;bc1qcaxlunztn0ut9fjjp3p2guclgxmdgqxu9746c3;40108;1;40108;0
2644;39vZiXu96EqtSsSx7aqEnpK6UKFengRarX;1524040;16;1524040;0
2645;bc1qtcngsd545zyhvrhlqgtv9ze6xv90yz6a9xyj82;376203;16;1376246;1000043
2646;3Eh3EgqHpAgxdFGKphjih4MZ5hZbsahfvf;2107539;61;7756394;5648855
2647;3ApjHeLi7iRp15YbMk6wrAhKKBQjMxXbLA;179787;90;4490224;4310437
2648;bc1qs8rp0s6z9g5zup2k3f6kfgupakwvaguhmut90zsxedy52s68rawst8nstg;33561;1;33561;0
2649;bc1quh9jm6p06nqnvgvvv733pl0g0y6ycxl0aas2t4;8505467;7502;695540515;687035048
2650;3J9vghbULNfHJL4SdikqBA87gjYBvQH6eC;299431;2;299431;0
2651;bc1qf44s7ukvdnlh03hcz0fdc7c5z2p4rxvzte3r2h;79500;1;79500;0
2652;3CG5Kp2LdH1zxAtUGA9ML8PozcpjHbtiFy;3769833;933;41334930;37565097
2653;1P2Uth6AUYk3dcT4JHNWzVYvS7v23Jr7zV;1889618;9;4241492;2351874
2654;3AMaRWFscaeDPJGuc1TEE7GN3yrmdA1zDS;8124729;833;23129940;15005211
2655;bc1qhz9v7qd8hlr2zwrrpzf6f3xs40wxz0a07zqcmn;331915;76;40208382;39876467
2656;bc1q6nddftfecehml44t9urx20weflk4jqgzfcr98v;150227;22;150227;0
2657;bc1q9kdyuvugj330tpeqzcevzzhxs3zk5eptrtlqen;778066;127;4006552;3228486
2658;1HbE9FARVGjEDH5HjUjkt43WiU1wXD6EH8;79198;17;732201;653003
2659;1FbTsjnAGQJTeJCkRSBH9eTppkQ9TENYVr;2645215;510;65695681;63050466
2660;bc1qmhwt8n28kmfcf5qc2xng7lhvkxat5ae3a89wna;14756;1;14756;0
2661;38AMQniTBcjK1HWzAEwju7sM9q9tNeV5Zt;94299;39;3010339;2916040
2662;bc1qmpxap5fg6x4y7c65777rpw0rz99skt6ymq4cn2;236046;20;1942851;1706805
2663;1CBS1dSbpBHhiN2e4Wb6juo7iArP721aEd;4272418;28;4272418;0
2664;3HWN59xGhfSKWRSriizHi3aAqZpP2VB8wd;306668;1;306668;0
2665;bc1qwwrr9c22uag9wthfalw9acee8gerpz6acgyy3m;1315;1;1315;0
2666;3CrY5Xx7yFqpQXaV4EeQb6z3s26vyarFkh;56518;40;1848352;1791834
2667;16i1wAqQmrtH1EGtrHgqiUW2P7NJcQg62s;81645;1;81645;0
2668;1P2Bpk3wyGZ2MCvwRD2QB3YGTbho5xR7hp;7268082;426;47651510;40383428
2669;1BY5W8FyNKqUTDrw4ZC5pAkEVJBEZXU4hU;617415;51;6903412;6285997
2670;bc1qg6nplz58gxcqnq7ryz9plqynprd2xv8fs4h5qy;400478;299;49067689;48667211
2671;bc1qlg4wvag8wrx7v2gxda0wxu3gqwwc376p957lc4;31766;1;31766;0
2672;bc1qq0wqzwtp2ay5gpkwm0yj5df5qxpxrevrxs0x7p;9522;1;9522;0
2673;1CFqTrSWQq6fF4JrvRy1oDEB39DKvEHJq7;906479;17;2406754;1500275
2674;bc1qedwr3h4ndgxgkfnam7vd49uw6hrhjw9z73zqcj;69410;1;69410;0
2675;bc1q7hgz70dwrvytr9cnqj8a68dlv8qq22dhda5ttz;23501;1;23501;0
2676;bc1qxsha9s5nw2re9juzut4yj2q9dl8pcfe3n46ef6;26182;1;26182;0
2677;bc1qy4zqg2vlf2el0gf8654062ll3ux4fuhurw8gty;14202597;1577;592534886;578332289
2678;bc1q8q9hsf0we729lp5esvu68adx9myevww3gmlgad;13480;1;13480;0
2679;bc1qh7wckwaysqsrjesg7nsqzqha8kwer6fqcer5hl;12582;1;12582;0
2680;18LMBod6Y9WxHAvLXZJAKFveb3iczWsDua;9892407;89;12798216;2905809
2681;bc1pv4p59ftxemtctjq9qrn7u33qpq6sd2wmntjdav266jqr2p5752sqgf0nls;0;2;20000;20000
2682;bc1qvn7s0clsp6kjfu74sknpgljmjdtnk8z2ps7sd4;2225556;1;2225556;0
2683;bc1q35gwy7ducxqlcaq78mnesp7w3qjz7dvh43ter5;15600;1;15600;0
2684;bc1q4l3p0p3a2tc3rale5xpd80qf0jfnm4nauk7dq6;199975;13;246303;46328
2685;3G2YvSQPnXL87TEfb76pTboKYKRTiyxuTt;31327;1;31327;0
2686;bc1qyva3mdfe42qjqmt5xkf62dncalz7gftslxddx5;94264;1;94264;0
2687;18G9ML97io4VD2s1bvJdLVc2RwuM4s9fvZ;12233120480;12889;777854659168;765621538688
2688;bc1qynygs8d3ju9cpum9pepmh94qk57tf67paka78g;9689131007;39411;18120380838908;18110691707901
2689;bc1qgq3v6m57av275el8ul0wm26rg8a3kdtgfmlmu7;39534;1;39534;0
2690;153JjhZjgVNyBmZXgwCKa71uWg3Xo9YGZ9;301334;702;96198105;95896771
2691;bc1qhxt9npfzjz6javxulqs9c5umlpl7szluq3n6xr;358266;11;1059633;701367
2692;bc1qcakap5nz8v44lcsqflqusxzwu9uds2pxw30duh;67589;27;67589;0
2693;bc1qwalfkc6x0fm4v2wsdpdtwnfkhxmzq5tt82vadu;12788648;291;95090579;82301931
2694;3GaWzVojewEryreL4qXCbxoSUvTHe7TFAf;3778888;32;3975276;196388
2695;14fnbsRqUXdt6muAZDVZpp4eboCyGjojbh;15666;1;15666;0
2696;1BA1zQ7sLcahrUWPGrmH6jrKAoQ7LEQXFW;13237730;47;18662869;5425139
2697;3KAK4hzzydfHbdtfCSCNqDFAY8rQxAyhQv;2069283;6;3186940;1117657
2698;3M5LXgwWbnMxQriMS8DkRmPN5hX1Sk7dnD;3146320;1;3146320;0
2699;1eY8H5rNBW7bwS1AfweA7zLoXYrARHeEb;2783991;16;2783991;0
2700;bc1qsvxpc7uq4px49ar8c0wewfqn3ly798h3hp7kn5;108198;1;108198;0
2701;bc1qksdquygepae0lgtmjh508ty59zqqsxpr8vk5ng;97942;1;97942;0
2702;bc1q5qrqcu67zkkw5tff3v85cr3th7m8j392mfytv8;10889;1;10889;0
2703;bc1qnrpy7g5rds72vcd5cxm5quplhchuy59qlq7c40;10899;1;10899;0
2704;121vR3LDMktGq1Dnwjemf69sVQFeHgH4c7;3477939;58;4458920;980981
2705;bc1q5lq86ty4z429fmqqsss2l8ux7a0a3fn3gmfd94;355629;1;355629;0
2706;bc1qyxmp8y8jf02ev463zq3tmjq04jk6n0e7rd7jzv;23500;1;23500;0
2707;bc1qj8yfecuacy0jkxa6p6674z4lahauww7w3u5mt9;30841;6;99540;68699
2708;1K9poXV5C2x5JdRrSLTqUpk4sJRqxbVHSe;55134;1;55134;0
2709;1LR7x3RncsQc84WjsgcMpkyhQMCmhLfMtf;330581;383;164240909;163910328
2710;bc1qt6y2dnvadphlcq9gsr68z7qtj0a97adswvj58z;390794;460;129962486;129571692
2711;bc1qcc5ew8dm4lwjuncfcjs39j26m9j27sumn8yl4y;18679;1;18679;0
2712;bc1qfxe6efwmh2j62jy0yfw7sqwk29kawv2ppkwfzz;31615;1;31615;0
2713;3E2oFyrBMwT1GzzdusVn2hYHw1RNfnaCXK;890797;33;5232771;4341974
2714;3CZS5NdwT1jrY4qwvS3YcuXV7B13eYANGv;83117;3;203230;120113
2715;bc1qelkwpcwemzwyrjfvkd0kfcnxkcrewz9rqmmx0j;41268;1;41268;0
2716;bc1q5c6fj35uyjv4rdatqmu8grgdrg05gy37tcxct9;108352;1;108352;0
2717;bc1qwdl43qkwdvfl36wcgzxqk9qj348f6srtg8x92n7qcyx47ltunn7qhrfpu4;9529;1;9529;0
2718;32ECwBjAjTKuUwYz6Pz2xsoiP2EnPU72C6;2570460;117;13728405;11157945
2719;3PheqYbSqbaiC9rNuRKgv7NGoA1NuXq9S7;32840;1;32840;0
2720;3NaGnNxctAUkcoEiCDjCuyaqhZ3cQp7YNu;575845;66;44029925;43454080
2721;33PuCSbgXj7PDRBqWL3xsTeHAvhBayWeNA;331411;3;331411;0
2722;bc1qmc2xad22xackcl7gmkqg76wfr6p4a7cedr8cl8;269265;5;269265;0
2723;bc1qzd8vlqk9jajrynwa8r6hjnfs3l6xpagyzd9ljx;7016;1;7016;0
2724;bc1qdpdj5wlc34glz7rtusxupuv5mxy8w25ptv9mpp;1624322;120;24759069;23134747
2725;bc1qdtv0f9ukywmqv5986mnzsaleyxvq2stn30ydwz;71264;1;71264;0
2726;bc1qxzaccdsqr5tl2849r8xnlmn2cy3lms7xskz3zy;334803;1;334803;0
2727;bc1q2zmlf7dfjt5kvcgg3s96v230gh5rde04fn9y6w;62607;9;284944;222337
2728;1H8f42NiaXfCt8XsbHWBfiQWdwqrGcvjAJ;122206376;2082;122206376;0
2729;151FngS13GLhtvGAEr4BVvDD1LDcsURxVP;197763;4;197763;0
2730;bc1qsq8cax3664g4fjfyxhty8axm4zt6a5wc8cjp7h;24711;1;24711;0
2731;bc1qwq5vaja9t6mjg5g2w40u0jkzam50ptu0mp7swx;67969;1;67969;0
2732;1477mm4UHv11P2Co74BAJqAtBo7WPzVWJd;31348;21;946788;915440
2733;bc1qv9ggl90af8r6nsnjed4s2w7n4zu2px3f90crf7;79020;1;79020;0
2734;bc1q8j0xy89rerk7twt47vc96kssu3cvsheae9vjt9;32483;1;32483;0
2735;bc1qn9rattennuzqt3akctdvknfuwrn4mmg2yxd5qm;91329;7;154790;63461
2736;bc1qj3x0h8rcc6w03ujt9phhxlcjgnrtdq2mcsjn5l;49811;2;49811;0
2737;bc1qknw9hwfr3xtl2a8aqwrsmrs4s07hrgcgmrafwr;3669182;331;24958297;21289115
2738;bc1qqhq6x8jfapfl9e3g0kam9g6mqk96nt3a4cg5ug;442797;1;442797;0
2739;32xc4Zgnfz7G9gHSR1TByLsxAfssNXhETp;544107;1;544107;0
2740;3Bj6Vb8KdatjxEd5T5ZescbFc5iGsZYZFx;3185131;177;209114878;205929747
2741;3HweNkaJE2AGTjnadUtT3FjrwshkpRQVbc;1038055;18;5795503;4757448
2742;3HbVqbZL9VLNk75NzY1EiE2Fjwx27nCrh8;47469;1;47469;0
2743;bc1qxtvyagaup23uyllh5ytlqfj6tg5kujrlmwukxt;23550;1;23550;0
2744;3JESbTGhBoZwWKgmBNDyDS8vjSKNgMM8xS;557746;82;27462233;26904487
2745;1AnEfP2NgVcdCnQMjo9A13Th34ssVu47f8;956729;12;2754258;1797529
2746;1Dz9kRArdbpNAHpgmTRxhhmmBLT5TN8S8r;407864;15;407864;0
2747;1HdPUhRdUbVRPnz1K6WzVUfzv84VDKaxNh;68747;1;68747;0
2748;bc1q27w9jqv7jdkkz2mruutk5dqmvuhwa5fcezdv6t;37719;1;37719;0
2749;bc1q9t4kw34r5pkm2ym0e8tjx9c7asvfu7t94cj94y;58766;1;58766;0
2750;34gWc6i3pUzHbz2Ae8r5UgYGc4j7aS5dHF;550574;543;21690899;21140325
2751;1CJji8zBBVn1qpaNNVsh9EmcXXx9xntshz;7905061;62;7905061;0
2752;bc1qxc6pth7dx969zjvkktzkuuz48l9ypuvnvhftl8;7882;8;322736;314854
2753;bc1qywvp480ma8dw885m5denc4s0ynzpa0v3ggf0xc;55319;62;4030702;3975383
2754;1Mkv5MgLUbXXKb1F3jD1fNKKhfE3RcJZKm;2892890;43;20999995;18107105
2755;bc1qez9d7tvzqjt6zhwwg33ypwpkqx7yeeptyz34hj;29171;1;29171;0
2756;3GbT2d7cp4PN1RKQFdD1oq3yRQvpSsEvcU;430659;15;3126795;2696136
2757;3FUZjEcYC82HT3RtAYWMYjbXeyKEL79cWU;1564880;2;1564880;0
2758;1CFZnSUj9STPq7nTzKzukmwDDdqQeMBTuM;21828650;553;21828650;0
2759;3PALBh9TL5WCNQEvFRiZPYJuntcCwNhT11;24804;10;498880;474076
2760;bc1q24470ulnx8nnwmglqkdm7px7phjqgq4knfc52p;39417;1;39417;0
2761;1mdUFABDcYn5JS2cDJLu9DWXxaSAs9uEj;24475378;151;24475378;0
2762;3JwxYQTFPSbnpyGq6UQaZvSuFjUnKAvYyq;2607684;54;5528869;2921185
2763;bc1q22yuh02pkydkcerssp0usjgzfxh5fqrk9n9t6w;62746;57;5621472;5558726
2764;1MzPHC5d2qemAa4gBKJ5HWWGP5LkMo9duG;2889507;68;3752379;862872
2765;bc1p6ptp3heyeazvvs7z3lsuftc6f4aak4dzhh5stzhfymzevkthx2pse5jm08;262275;21;1387658;1125383
2766;bc1qqyamx7xpmeacfy4v0md29s9wxw0w5399838s4m;28710;1;28710;0
2767;bc1q8d2y5zyg60klqlrrlw00dadu69er8fregmt7j9;11016;1;11016;0
2768;bc1q4gwf6jauwqescexnpadxlwy69mze99xjwcc7aj;250218;1;250218;0
2769;bc1qu3g57n0wrusufslfzka0ltxmvsgjtg89r6txga;42347;1;42347;0
2770;bc1qucss28752qxfjy0yf6mngj85l9qay7y3x3dmq7;146923;1;146923;0
2771;1M8P2NotZ9rsYBD1gF5B4x4WEkWZnx2M9A;16617505;200;17735582;1118077
2772;bc1qzmykdjchlen9ju5eaqn2nzpxul5l75c362jenv;45673;16;665499;619826
2773;bc1qen5jmvp9ycfn9yffw8ddv3dw7rvemcjz3nwak4;95026;107;11084560;10989534
2774;3EHHN78FCTndBEtR8uiRY3tnFkTPffkpJh;320800;11;1458549;1137749
2775;3CfCDofbAss3LPQQneDNbpHGmf6qdczh36;1533376;6;63755706;62222330
2776;1M6JQvQfotNn4CJF6VesJXEHxeAn2narez;500000;3;980000;480000
2777;bc1qx8laupsx3kkrkma7w4c58v4wpaal4ym2xkzgg5;31848;1;31848;0
2778;15V19grUZxJgRfhLyF4unoy7nRyymuAZWe;26485803;664;94381187452;94354701649
2779;1FBu5V6RrCrhrAiJymnBQ36nFQQJBj41Xs;12336109;54;18101821;5765712
2780;366PH6xr1gLReaQtB9PvP2dhxCr5DRvskK;146759;1;146759;0
2781;1BNbDbyhSvw9TKCKFcw4Xgib9boNTVhquy;42652954;154;62880185;20227231
2782;bc1qz6tenkncrljqt72sr2nkgu75hztm4kzmktfdja;116972;24;4698659;4581687
2783;1Nvr5bGoHuG5hSUzMgiZQ4xxNsw94tWYEY;23042405;101;45130508;22088103
2784;3HjS63LRoDstrwJnHGaRrsP5DThDmtnRzb;31421;1;31421;0
2785;bc1q4gd60xq7yj5v095jnq0f3qytqh94v2jc3falw4;85929;53;20478917;20392988
2786;141nQPQ1rXAn854MXf1SnuUp4nPvrHQTom;25469047;236;37709300;12240253
2787;bc1q3pt8w6zynsueru8lgzt9zmxk7648fx54uuhf4l;155835;24;2160256;2004421
2788;12yqadDfz6UMem49Tw6JXxD4pmBbFVt9E1;1302128;22;1302128;0
2789;1BMG2MDEY4CoZmz514qnEgCZfFP4jEfdHd;17377;1;17377;0
2790;bc1q2w5ezurv0vgfs66lx2f4qrzzcxsyc4e88g4x7r;71238;1;71238;0
2791;115c9w93eLYLEFBk3d6MrraCdmgAJ1PeUn;2795518;17;4974351;2178833
2792;bc1q4wy06ztq34pjt48n8k3hxzn6suyq7fjc958l96;2196212;198;11181862;8985650
2793;bc1qjz3j7h2h0gs6qlg7zd7emwd73dw3qqgmn3scsu;172713;351;39008522;38835809
2794;bc1qksz7udmktz959kws0eg2nq6zz7kgz202gelu5k;110063;14;746213;636150
2795;bc1qmm6pfm7zzm6dquzrhzcydsy4apfllf8v78z3as;805387;878;359849566;359044179
2796;bc1qqfxvn9sq30ws250r9ffpzvt48skvjddsxsh4r0;27185;1;27185;0
2797;15x15hw2zVxfMBf7oo3Q6H5urTSajVeAdQ;814019;7;814019;0
2798;bc1qmlmxk3z9xufdrms78ldauegkkc59tcadsamp64;24805;50;1360480;1335675
2799;15SgimJv6bVJtMQTVasqYnhhfj1KthGhPX;616939415;4117;942379228;325439813
2800;3352QWHxYvo34aTWYBrKLsUSrHe5TXLDJB;655341;42;1174907;519566
2801;bc1qh466jtjpu9zrzduhrw638l0xph2dnxeq8fmpgg;303963;192;3280586;2976623
2802;3M9h1LsccHE2dw6uaPsDznWNb89nmqu9vF;6298625;23;12072235;5773610
2803;1DHukWr3sN4VAfEiioX4jVQ1UrLLFb1KVQ;1013417;195;90999210;89985793
2804;bc1qr9xktyrjsk5qv9335xzgj0ht2js8d96xwrvcc8;275000;1;275000;0
2805;12sWEdmdE78BrDzeSvXc6VV9pj8P6CJDdy;1270712;8;1270712;0
2806;bc1qcqag4kh2mdvnfge5vwaa672rcghhjv03fne3j0;2341948;1;2341948;0
2807;bc1q37m0pprm5xlyw9w2uxz6legh0zs87k2s3mgkwh;1081312;113;30412669;29331357
2808;bc1qljcp3wtvpsd3q7reymkppnmvm8zz8m9yvekcudzjvvkq27ra4h8q32q5va;2157652;1;2157652;0
2809;3Fm6eTZueA4JR8x9CMV2aqAJD2E9imV4va;32436;1;32436;0
2810;bc1q8lvl6j37nuks3crs08ujjrqwy7zwlfph2d0czs;32284;1;32284;0
2811;1748knCZR9Z26RwPz5SueSKMAr1o57Ue91;2359114;16;2359114;0
2812;1966RyzaTaJG8L9zgzA7gFjKfyiz22DPL2;54904;1;54904;0
2813;bc1qxk26vmq6rmk678fxx89runnawlxuydcre8wtvr;319758;7;710372;390614
2814;bc1q758vzzesxkfdx94nu5kds9pkr29tqgjq290g3e;17704;1;17704;0
2815;bc1q40556jjl2skyyynaswmc4xcft6x93aryklt50n;47048;11;217033;169985
2816;bc1qfphy0rxqvzx6gyhqt0k0t0n5try85ehavzvts3;57841;1;57841;0
2817;bc1q7ct8994yawp54pcm85jl8asngme42kg4wr96ux;48555;67;3420880;3372325
2818;3KdjZv9vFkDzFq7ATmnk8DG1oDJeY6SbC1;675000;1;675000;0
2819;1DyZAnqq4wXjXNuXfPSQEphwMFfw8Hcb8K;1025762;15;1025762;0
2820;1NyMT5MTPAouuXdwZaixB5nE2sWLSdhVWR;3083443;30;3083443;0
2821;bc1qn4r5m6u0m22d2utc329a3u2fppzqxlp8mr6thm;838316;1;838316;0
2822;1Hkp5ENPmqFpZyfbqteWL6dCTtMojNf5Ha;1840704;43;1840704;0
2823;bc1qv0vj83g65sz403wz8hzvzq3z6zsanhlk7a50ln;28898;41;83052639;83023741
2824;1Likyp77CoanJeVt1SNmXpcMjG7Mrez5xJ;2399416;14;2399416;0
2825;bc1pu220tldmcfnvaug5hqha5q67708heugu2kfs8m3kl7jnct3p30dsth0vcy;130823;263;157286;26463
2826;bc1qp3wgzz2gnfluc07my58w8g38rlrwspsa0vmx6d;8402;1;8402;0
2827;138VXbcRHohSHTynNr2Ga1C3k6YyU7zRcB;1373069;117;13659463;12286394
2828;bc1qmztxrq2erlrljnrunl4pl5wqq09pk3pcjeeeaw;91867;3;91867;0
2829;3KrHNCkP8P59KJzh5RRaLTmV2bEhLY4GL7;63817;9;2615615;2551798
2830;bc1qg9058y755ksvc5ppz6j4gse6j730q5a3fj9jd3;536537;1;536537;0
2831;3EogYVukqr9nGZYg9XDEn3aZP8q9rWxaAb;55546;1;55546;0
2832;bc1ppdd7fd6x4ea4kspphpd33pm8hplqwpktee6c2r2xuk58psjaywxslen2mu;2092;3;2092;0
2833;bc1q0j6w8c2rxh3xf7jyntvtfqjjamnuzs7uymz9te;0;2;108265;108265
2834;1K2GoxHCSLLcVP2n49RCvdsR9D7WKUeRmK;13941326;64;18670027;4728701
2835;1GcqPXzCe366vhnmPVXhVKZhi9UMjS2Lvz;79220;11;669031;589811
2836;371oPj7QabdefuQYYXwF3PTobyto9qbDsL;2492806;507;128324037;125831231
2837;bc1qh4urhpd3f44gl4t8ujzmgncnukpna70kyqzay9;45481;9;259077;213596
2838;bc1qn0yx2awraw7tkntgwhg6jlzglhpph5t8rsqvvj;0;2;127209594;127209594
2839;bc1qawytrrkqur5wz80zdmfysvf0v2c3zr283tdy9g;289762;279;99198653;98908891
2840;32mr9FUntNLqTbkGRc9UEr121h8cgEPywp;443332;92;25085266;24641934
2841;bc1qqxupjtau6dn4jjhy4flh60qum6zhallwm2jsdv;64825;1;64825;0
2842;3Fn8EqwU9YUDFKgXbignFyPyZvKmmkPZDr;16974541;635;192374614;175400073
2843;33qvfawXMAVXZNfWP9YmVDjqdcP4ipWaTf;1015323;63;5564931;4549608
2844;37HT3QhgmuwvGUyHtznMGrxgTVXZnrKMEv;412655;4;1251555;838900
2845;bc1q9v97cha66yxpk53k4su7cm9grhpv5xvanp5pdq;5959001;1;5959001;0
2846;bc1pvwfjv2wtgqettx0plcs5fz04e62vz02s74cjldcv89cmaqmenqxqu5kkj8;104614;55;156717;52103
2847;bc1qq2ce6zdc8r4gs5lu47p4p4c63p9ptppuyztnh9;15683914;1;15683914;0
2848;36pdkvqjSoVmd8GThbAfck24SbZiAErd1V;200000;1;200000;0
2849;bc1phahpwfxyj458gts4pndzz50ws6lc8ee3klpsmyhxaft0de2j8dgqaynppp;577549;2;3182549;2605000
2850;3GqzXKRK8BksLqG1aBwL5cq4Y9RkZq2pFv;1570158;1;1570158;0
2851;37C7iSYok4brpQiVdiHFRk9UG2fZzFETcJ;504750;9;1958325;1453575
2852;bc1pgnqt5xfrx2gtw5yprxpzyz5809enm9mpt0l39mq77mmplsmjqgnqfflc95;526200;1;526200;0
2853;bc1qyrlj7ezkm8vvzu74aexvf8fmkyply8875tzlez;180000;1;180000;0
2854;3DJ9Hq7eyrk3MmqrNaoASLyfpXTcMrYgEo;1523168;1;1523168;0
2855;bc1pp0qljx7snvn8qfml7ldc3ach88xmfp8s6vvgw3l2zampdsx2v7ws9j9c6g;8673897;4;14639463;5965566
2856;bc1p4nyjdduzdnc83rzmk0zdz9ycmhktgr77ucca7xn5uvlqy9lpg4esxuc5l0;401000;2;802000;401000
2857;3KB3wYNdZbtM9NFQ8xr2aCJrStw1Kc3RfL;2961700;1;2961700;0
2858;bc1qkz646ax5rfzadkssxsz2uek4tmepn3u9rnjus6;860000;3;1060000;200000
2859;bc1q3x4qfhex8wyrlg3wuxs9v3753cs6x5m4j5fz7fq62ym53zfx4hpqglgnxv;1495;1;1495;0
2860;3M4VVXCTLba36sZ67eo3qibnFcTkruMU8Y;2406302;18;11548773;9142471
2861;3GcSck8uZCncF5qJdJ9q44swgixF6yB2gq;74125;9;4111451;4037326
2862;bc1p8eemycgwy28v0gkkl5ezygzwr5cw4yspl45n95p2fsxasgjckkxs00e3uq;1303550;3;2303550;1000000
2863;348BRk4H2NeWWyRCrXdy3kKSVr2Q4XK7Ed;4639789;20;12114824;7475035
2864;bc1qe8xmuss7qs2ja5pzmu402we0jzccrxme6vwwgd;31590;1;31590;0
2865;bc1p9j4shgy73758yyjwrvaj5p3qchp8t3kguy0xd6nwgk54ewfz20eqwte87q;500000;1;500000;0
2866;bc1p53hyxte4rlayszyhxjenq4u4e8f2tyyjv5cjvftzmdmyh6s706ksnmv9h2;4959000;1;4959000;0
2867;bc1pjxmmq4py0mslnr386nwztp6s8nh7654m7alf7m2auvq6thv8r7cqrh3xzd;644952;2;1304952;660000
2868;bc1padmmn2slg8zzuwuppzef349uj9uf5un45uvvhe937ae99v48lprq57rymh;71039;623;81276466;81205427
2869;bc1pzsfl89pp8g3vxqsu6r8ecmf5rg6ws9hw646q7q9z3fyd3w89nuhqtu3qz9;2148341;25;4457887;2309546
2870;bc1p9ftka7ls40l5qhmt0dhwcevlj76ajg84h3j2apqfcx2ywlnl7vvspwzjkx;260926;6;260926;0
2871;bc1py24zwruwnhrgx0cfnsn5c4ghj3qqq8ux57lgc49tluctmd3h85ms3cs4pw;0;2;546;546
2872;39oZgCC5mXsGLggTuZFKjkCULTNDDdwhNV;3405257;2;3405257;0
2873;bc1plqmc5jmgqnfld2sgznwcjk644sp7ge4q4fr29aj3p6he7sr7hr9qs84e5m;355030;11;677975;322945
2874;3MvMwudMTSuDwku1WjigxnjfqPxa9LAhPA;100000000;1;100000000;0
2875;bc1pchqlzjudw45hyspqsqu3v0cetyz5pq7nvgchdyakql0vy3asfglsjdjp4t;18380;1;18380;0
2876;bc1qd7a3gpqszd7lk7j0q9furczw9e5zt6tral4f8m;87061;23;87061;0
2877;bc1pyjgg6799c9fazdv3tmr33cp5maepq84yes9hfvua2j7sewskxfws0jpc5p;86265;33;86811;546
2878;3AvLPqwXCudqkxysUMJPFSuaKK4Znwd7kk;111964;15;2876211;2764247
2879;bc1q8c5kwjq4e86er48xnaqkmhcmvmdk8tmegxs82j;1564969;1;1564969;0
2880;bc1p87ryweh8dwskqksm64fa8x5wuuqr5l74wmyzef305z6jg3rs49nssgsasm;199760;1;199760;0
2881;bc1p5zv9pqrzpez8lg5zg7tulev5h0y3wlwtlthflvqlyhsv8jmye0rqf9v6nt;2420521;19;12290468;9869947
2882;bc1psxs6wmy8xzwv3p2dknwkqsjyrpeffxv8c2pw820eflyej26zk4xse78mmm;10546;4;11146;600
2883;1H6GfHFaK3YWKgkHhRWVvX8uDKkAq8dvwQ;384600;9;3015228;2630628
2884;bc1qu0gfpqd60l3wl0ws2krh6ntvdhqkqcr2vl5fqw;223112;104;12272584;12049472
2885;bc1qtacn5csc2tk8pcyjr3g5tjd7yldft2ftfaw2q8;62694;1;62694;0
2886;bc1p24ksuj3kax5z8pu9w6thk56587hutzhatq5d0r0m242nnehlrzuq7h8ty7;0;9;2730;2730
2887;bc1pu0rl52zgm0fh2ny25wj7v0q0fcxkg6lpkg2sr9cs4dkc4898k5yqxqur5m;11638;7;22637;10999
2888;bc1pzchwvvnj208yc6ftfhx3y2f2lvp6tls5uhp606um7s75dnkfrtsq4evjes;3638;5;3638;0
2889;3GyqsJfV52Gj5wTa1MyLvJBGYL9sNpX94w;357506;2;734269;376763
2890;bc1qp8cf3kwqs8uv7nvrpwurh5g30et2vf8qrp0kq5;914837;1;914837;0
2891;bc1pyn6lw6yummqrgzzlqs0ny74yfs6e7g432d422uvamdh5llcm9xsqtnl4ay;629247;138;20622240;19992993
2892;bc1pfz0a6gvdaz6pml4f5wn3atq2fdvk8zmz3vkmv2kzw87my0993h7srttnvj;132769;33;28135161;28002392
2893;bc1quh9jm6p06nqnvgvvv733pl0g0y6ycxl0aas2t4;8505467;7502;695540515;687035048
2894;bc1p5srrc75p8jpl5u2s0yek5z3ej8ccg3kjx2q9jny6e0wthfha43vs5gsnxv;1037504;93;42942490;41904986
2895;bc1p2665dpd0gkwnjj9eplqhd2zt7q2d2ctek2k0kj9yn4n63zcajcsszl3tsy;278516;23;5286664;5008148
2896;38R4mfxq6QKnvfLCZ3EyKDoeKptwYQ3Goh;4961700;1;4961700;0
2897;bc1qf5nuys8ru5rs78vk6yf3vqcrf9rd3vex8w2zryrwg9dygnk5evtqmlvzun;10156157;12999;107199019399;107188863242
2898;bc1qvp8y7ezmysqjg2xy070ffs2eaf7y9gr56y2d6g;45127;1;45127;0
2899;bc1q2a2vxdq72gv8k6dd5d5rccm5544e4gmksvywzrewxr4lfjpwr7nse3rr68;16765;1;16765;0
2900;3KVVhraf7PCSEzFqKw4Nh3vYB97zkZXGqU;1199866615;1;1199866615;0
2901;bc1plewfk5hhx26fwnrx4t2a6v4cktc7v58k908es2yvsd297khdsmps93qz7k;0;2;546;546
2902;3LxZG1bFAVYQWVYXZaEa4sQ2rtxLJSUWGQ;752341;32;40523105;39770764
2903;bc1p944a6ylc8mqsetkc69mhjt0k7p7yr2gq99urcwk0e66npffelkzqaeemqh;7644;3;7644;0
2904;bc1pz7xc0ntpvpca25q647quetzsu6xup2zyhtmjq03krqs935gcaxnq5zrn26;529736;20;3414228;2884492
2905;bc1pnkzr8pj5zdvzm5v7jwr2a05hk3s3mc4a4e3s5nt6cgfrnjp9evvqkj3pz5;0;2;790000;790000
2906;bc1qnr24zgme0yqdg3h6e0xuytkj5s8h2v009p96v0;4725678;1;4725678;0
2907;3LoS8GJofYoeFLDu6sMFTpAuYzqafuCERx;39480;3;202008;162528
2908;bc1p8kdv3avdme052vz4e3pl4jta3xusestlk8nyaft579k7yvaqxvksdjk4hz;254125;2;525125;271000
2909;bc1pef83h4cgllxx72z8ychqehwmavfl9ujhq9x5z9ws6ghqrnf88ewsl8tx97;0;2;546;546
2910;12YX9ChRU6Dkngc9qxz2LvSJQzWFmAZ41s;7530000;2;7530000;0
2911;bc1pw6f7zg8anal8zjvhjmqd7ftltfd0ryvy9vgkkrlujntvntu3qhcsquv50j;308091998;14457;313956960;5864962
2912;1G47mSr3oANXMafVrR8UC4pzV7FEAzo3r9;43451786191;1240081;3615687981597285;3615644529811094
2913;bc1p8hz6dlakdlnf6jap9vvxcylw08q36nc9q6dz5vux7t6mnu782x9s82ajks;1103240;9;2578262;1475022
2914;bc1pvq4dvpy0umudxqydvmwqtww0ux5e4dnmlgawhzdvm6cvua8fyqns4j6800;191918;11;1164851;972933
2915;35CDo8qSRaiZMffpN6vDjveaV8zndSTay7;54237;48;1402192;1347955
2916;bc1phkcgyx0pj0lff545j8x6psmpequj4kxuu305vd7pzx0jet232lwqfzqqw3;13989600;2;13989600;0
2917;bc1ppfsxecu82vr9vklezn7krjqf5zx7vwna38erwfv46pedznnl0xfq4fxml2;6552;15;8545;1993
2918;bc1pgzsgnmkcl86q5tv2m5ptdscgr8xy6w8cg7pwu03snq5qaysn6j9qnq0cuf;1752200;1;1752200;0
2919;37AznyiDk7yXdi5pSKW4jTnWPgFRuW5Yi1;9416;7;261719;252303
2920;bc1p0yg297q5262qmfxehnk8vh0xh5xlql629kakky6th4lxq4uxvrcsth4p3a;615021;342;1396766;781745
2921;bc1pyeempw875cmd3dcdsa0jkh9jjv4cud4m904tzn06922h8r5yc6zqemtvvs;538993;11;2275122;1736129
2922;bc1pwavmcwh88ftlm3w7mthdwdgwpavezatt06ms29f7mw3yj5zrjalqvylvga;94282;224;281642;187360
2923;bc1qmse0lxcvp25yqun4qtzjh3gtwrhhnf7r6fudyk;191990;2;411990;220000
2924;bc1phk9fk3akp4x8lrxxn5jhmtfgdal87cuq70rqdj0wf48ha7xr20hqcvql9d;10926;7;12072;1146
2925;bc1qfwz4hz0ycr977kc4xrlxhcns2pdgn8dn3l36nx;22179030;32;46692075;24513045
2926;37Xs1je18TEmw1Gjp4RiWUAHtrmQGxKzT2;0;27;9951319;9951319
2927;3CZS5NdwT1jrY4qwvS3YcuXV7B13eYANGv;83117;3;203230;120113
2928;1PRk3b3saR2S3vgJnBoDXgmGLWZhZffxse;7916977;3;15547186;7630209
2929;32mkpCfdepRiNhg2QCVSw5WYzfyaHEph9S;18905363;123;342914757;324009394
2930;3LMLrfSNNYXFEgWYe6scsvVNovYYFSeMZL;2553796;6;5974302;3420506
2931;bc1qy9h5xc0sa5ja5tt6yax4jx5cnady2fau0csgt74mm382nl3mzl3sny2t9z;1122162;1;1122162;0
2932;bc1qajm9am5qpl636mjjp377qe64gyq7e7xtw72wr6;8272074;8;39417334;31145260
2933;bc1qqm90xwnr5mrm6q0l8gljsnpmxxf97suw9xzlxq;8957575;1;8957575;0
2934;bc1pyksmy6fn0xq55sff2ghlhqn8cujjvhf9acw38zpj35gdzzuud5msrhc2s0;479100;1;479100;0
2935;bc1p6cmdvajqtnvtdzlaj3xq5374z656pw078y72hk8h8ld0xfrx5ahqmj0cpt;5075283;75;215122122;210046839
2936;3Caw4ZWMqrzsZy4BtgRysWCtooYdL4k4FN;1928403;1;1928403;0
2937;bc1q54pzmkmuvjdqvw2ry4xz5drsz5p80h4v59e4hmpze476lvry2tdsvje8sm;609785;1;609785;0
2938;bc1qhmhq66rlh046um3k26e3d5wr8av6mj5vey6pfy;781684;1;781684;0
2939;bc1qtzyq27l84ugumfcpt9e3kwcggfetq0rghwfx6x;0;4;105743;105743
2940;bc1qr4yc8uerkztnzzfadnc3qwarz25s60359xky5e;3307359;503;126001857;122694498
2941;3ASsgp8AgppVvxYwnnHAUkFJq6cT2WymGn;535948947;75634;19239363615860;19238827666913
2942;bc1qpc3jmv22yew0ss5pxhc7sn7pj0f3392j5grh3u;1745207;1;1745207;0
2943;bc1p24qyd26vy78czg63jfu0xr0xkqva7wyyaul6mf8dugjnzwnkgpws5a80m9;94282;189;260348;166066
2944;bc1pu9er4xczhvycar4x8vnrz4kxpdaax63kg66j2vkdtzj24e8ehsys7yzu67;500000;1;500000;0
2945;3JnHA6nsApAyDoS8mNBk32SpVVquoHc6Yg;2223786;559;562840127;560616341
2946;bc1pqvrdk0sak0pxgsld47c098st0c3cqj85dpak9tcp7z9n0yl4yc0qk4cw6l;2000000;1;2000000;0
2947;bc1ppkse96vcc6julgerqzw7g4xtf5krhp86armgem8aw9pqxnmnpujsx0cmnn;0;2;25000;25000
2948;bc1qqhec3zmhlt2xwq0eawm76zuyerlk7mley7at6h;177021;39;54407884;54230863
2949;bc1p2d3uu2at8uvguw60w8gyw0vc85uxdjh787aeq6vk7pyl0cvmxfkqeganya;500000;1;500000;0
2950;34bqUtpM9oduxF7Q4U5YVgfwW5srEuZcuF;3140000;3;3140000;0
2951;bc1pz4hauh6e0lc76pmr03nyzfurevpg9kdepsm6chnaxmkyx6vd7jysflulrx;2184;4;2184;0
2952;bc1qrukguzhtwu7xq0f3vp4rs9pd6teyhf6jj4ttsq;3085080;1;3085080;0
2953;bc1p6cc27cm68mh5x9gec9xlzyfek5pe4gr56tuq9xf6anewdpyj69wq6gemnq;1092;3;901092;900000
2954;3JsSBdSVeVHZvmy7oEZ72Mg3pM7mARth2H;9673835;22;20232946;10559111
2955;bc1p64c27qzxvqh0csf8zu59qhf96zxztn2x9p4rf69jvufassy0hxfsz2e8hs;134894;26;15075027;14940133
2956;bc1pzhdhjmw2klpy5tqjptvcch8w0axpnrn2p49e20u6w9pawj8k2ctsepxca0;0;2;546;546
2957;bc1p49ufed739egwk6zqldwhn5k736czxqdhj0k6444tp9nxnrttn8csrkaw0u;453908;2;1422908;969000
2958;bc1p4qg3fav3se8f9ntp4sa5km4gwjztk0d939swy3yglet4vx00wkcq0syuk4;4189977;14;24638589;20448612
2959;3FUZjEcYC82HT3RtAYWMYjbXeyKEL79cWU;1564880;2;1564880;0
2960;bc1pshs4yn6zh4wxa8kfm76267kqz444f7al2m3ajz0d9gm0luud9ucq8r3hkh;1092;1;1092;0
2961;bc1qjcqtq3pv5zfkay8wacsnn0vd5u98agft4tc7uj;72122;1;72122;0
2962;31mnaZq1SKx12CNG2Azdwv8qwLAZD7RaiH;650000;8;1979136;1329136
2963;bc1q9jg6nzghd4pshdf2v2ljv8u2uetjkax596m2sw;1560649;1;1560649;0
2964;bc1ps0rmxj4dy4vleekqze93g84a26wkyd6rks398l5rm2vjnccmekns6pgks6;303010;150;170752848;170449838
2965;bc1q7qlu60w5dj3feuv4q4p0c0w0r9vpkruj7fvls0;10799936;1451;13202170002;13191370066
2966;bc1p54mmt76vp0972yc5cyjzw8z2fjuk77ptukke23sexh5dlk2kg5ps7x0arv;84626;7;184626;100000
2967;bc1qvcp9v3aj8v02g9cgknxtj59se85aexytd462rh;293296;1;293296;0
2968;bc1qsyefhaf7wrqxmwjypxlchyhcpt9zzxa23a7fg0;629052;1;629052;0
2969;bc1pryrt7uctu400c2vpeyfasjtkjk9vs6qrvntg98zynz8gntw7kyrswyh05e;1341944;395;70120317;68778373
2970;bc1p36wgwmu5hvugvsgrfwxr2nx98566c8g0swvzxd4qz8gxh4etuqeqnyez3l;17391799;867;240285230;222893431
2971;39nsH8ZqWXjFCMjKR5FNawkRcbp4y1Mncg;2961700;1;2961700;0
2972;3CqzLYM3NVUGDks7hWmqeF5Lg6vp3A81vL;1961700;1;1961700;0
2973;bc1pg3h5j78u3aqfy8yyc25q0yyqxwz0607efl2xfcl8cjt7v83vhmes5sclxt;988410;1;988410;0
2974;3ADUfUKoJoqsXYPBb3sNHT8bdd76yP4FKL;15420493;6;52229513;36809020
2975;bc1qlyngtc7uljc4wwnqgg4zj5nt3lr27e8w4lwtxj;1892086;1;1892086;0
2976;bc1qekpdxfj3pvgcu0arkth8zchrl7fwcn7x8xhq3q;296721;40;296721;0
2977;bc1q72r8yf6gdkp7k8wy0neku9a49h5d29ma0qnqqk072fhxv2qxxr7sfnxv5l;3841671;1;3841671;0
2978;bc1p5r44qd22q0z3luzcupcr2kc53nz6tyf0zyvctz6tl4vyt5xa79ws26qztf;4638;4;4638;0
2979;bc1psz7xgsex2xm5wewnlnl4gpnr9jk6v4cneaj7fm48vmvleal48dds67a0de;102261;10;3216822;3114561
2980;bc1pp5r2d7fs07p36wkx6p4025ml2fvpfpat078m38y2k20qmq4fquyq4zjhys;0;2;546;546
2981;bc1pku2grsznrpz4r8azn38xyv0jxse7hps8vd6uyhyjh2r59jjhsj4sphahlj;1092;1;1092;0
2982;bc1pt0rwejkpum6xrupqzfvx853hw2eh8nnav4mt0yg6x5an4mna2akq5ryvc2;195400;1;195400;0
2983;bc1p6lr0jt96necsvg6nk8xtm74llpu33apj9g26qnr7qp8d4fda2pgqsna3eg;980000;2;980000;0
2984;bc1pzs0s9nvw2mfjr4lq9tse8z9nk8fyfn9af4wnlqvmstn2ckujwnnqrwnqu6;733375;2;883375;150000
2985;387f5ma2m3WZvt1oFxfREEbzsgRqYzfNt8;105914;396;256273376;256167462
2986;1A1zP1eP5QGefi2DMPTfTL5SLmv7DivfNa;9975752803;11565;9975752803;0
2987;bc1pfcgrz03xj4umfpjvutc9azsk258s2d4kque6t3rn3dfgtja6xpsqvq5fdp;9673961;1;9673961;0
2988;3PBvCXn7XSLo1epHP6rTPLkHJw6cidwyps;76952;2;176952;100000
2989;3GVLaNWzoxttB77Mn5E1puKXw9LNNjLeje;380300;7;16911090;16530790
2990;bc1pn3alhkffd2vezk8000d8fm4tg2r4aq0rts4xx98vz0nhjzlf3msqzvtz2a;385856;138;26361774;25975918
2991;bc1pmtz0pju3rjzwen0kwr4f93u0h0fgc38g6zfm5s3gml6pt7wjx7ysyhvtf0;218848;65;4252112;4033264
2992;bc1pppyu5s376d554j5j8tykfv22p4j6wzhjtw2z5edp0jelugnlcnrs3tf268;17800;1;17800;0
2993;165q26JrfEiGmQGa6ZieAqLpqFDV5BCE9v;6359376;38;10308178;3948802
2994;bc1pcnv3zq5ykzu9pkmsdn64ky8lvkt39vtcqxz9ajalvgfulgn4ndjsztl7vd;34574733;41;184025138;149450405
2995;bc1q3fpzs40y9x0gy7afqalqfs7gvcmxp58xfaq768;250364;4;250364;0
2996;bc1pmhad2ymcrw4knljdce923qfwcp67k0l7merekxzpappfa0t9ahnqtf85e2;5439770;136;148955489;143515719
2997;bc1pyru0yrkw2a9pzcx2lpa4r99290jsvefxzkavamjz230tammg8s4q4yugd5;79925;109;18504416;18424491
2998;3Ke21osfhEbEryUeqdwAuAY8VKxm5B9uB2;82171421;6315;166307381;84135960
2999;bc1pq5z0hvxnewyz2kr40j4d32nx9tn0jx0vvdsvjnlckjekyhdm0j6qh7w6hf;15124902;2118;16269318;1144416
3000;bc1p9df9w6fky5375rarfh44cx2ufsm4vfl7ga66l4g5j0mthxraw9aqe4kd8v;1092;1;1092;0
3001;bc1pmm37732h6dm2qswjhdx4v3ecgp3d4yeea2kuv73gdwyklftckjvqpwnphr;134666;24;155212;20546
3002;bc1pmx8cgh8lmk6zdnesvack9fekx7ff75djcpwzl4wg7t0tdcvhzweslvv9va;697506;1;697506;0
3003;bc1qk06au9gwzkqyf9gauq724etesr2zg2q2c50s4n;690000;1;690000;0
3004;bc1qu5y59y3pf7zwenrn9plxua3uaucmus6vzd9ps6;5430848;200;390856613;385425765
3005;bc1pj0pxz5ltwke25cd3flrzm8rhax5mgfa54law9lg0c6dkdsru30qs40ug02;6462995;5;16029032;9566037
3006;bc1pwrwph0t7fcfh077dxr97g96d9kqq6m5rhpwgu5g5fl5jpmqhawtqx0frtj;500000;1;500000;0
3007;bc1ptqj7xldtejhzmj70zlsd89wf2kg7j29cg94jrysxcmarqnkcey2sdpzp05;1092;1;1092;0
3008;bc1pc0juu7x7w2h9ymth6843dfj5vjvukxxwqtjz6t3rfzegq0p73q5sn7jlde;836460;96;35420351;34583891
3009;bc1qxl0sskxgp9eje975704qw32ctccurh9ue55swk;218161351;36;2523903709;2305742358
3010;3P4WqXDbSLRhzo2H6MT6YFbvBKBDPLbVtQ;16607585205;955049;49992696244;33385111039
3011;bc1ps5gxn5nc5jygqhax44d5rnlnv3m6zgqaatjc0us92x8fykklhuls5sejwj;0;2;149335;149335
3012;3N2DaWykFMap6g5RPV2XeMZKQTdjjsJy2o;2992816;5;6834898;3842082
3013;3DBADyQs2RkBXyvJMYZk2kbbfNksxEsNWx;5000;1;5000;0
3014;3A1HzCSEV931gaA7xZ8ZwLPWYmwssR2qFJ;2773100;3;22733342;19960242
3015;3FBTpERyW6ZX2vBt3QV4PcYctpg7NLdGWW;191735;229;188539797;188348062
3016;bc1q4tk7spchnzka7eseyyg2yy33rehqfcvtmwmtc9;130219;31;130219;0
3017;3DEDcHumcsmuw8i3nVb7xm7iZ4dFnvzrZW;78000;1;78000;0
3018;bc1p2aafk56zlqwq784u24pr928q90csuu6rlhj0sc2l3s4lywsxsjwqfk6u44;0;2;13150;13150
3019;bc1pt86v0wfd38j6cc4yqse9yh8tf5geajkrcrhw3c4ywh3n0ffqz6ls58q7aj;89546;6;747421;657875
3020;bc1qfwjf4ey4tkfsj04qf9eaq76d5nvu32jycwp3a6;2086359;1;2086359;0
3021;34iARr7oDrNAByNsTaPYQbHwYqPGv4Fukt;7844352;226;596526036;588681684
3022;bc1pk4psnu7j5wl4slrqvvzy724ge28xt2swq0ndg48l9eu6k244yxksw54nae;94000;7;3631000;3537000
3023;bc1puztlwz7zwfj8etc38ht6sjz8c7zzqg8pxcv9fs79wyvaupxsfmwqvr8x74;445888;100;13666535;13220647
3024;36V2wPVMfikNLrwvyhsi4F1E8pKMR3L3RJ;1330546;5;1330546;0
3025;bc1pnzdqvw3s6cz03ex3d5f8k3d8p7kxztscgcvn7ypkcwvjy3dkscms3e3yzg;406568;9;1356056;949488
3026;bc1q4ulfl2kjswdxa73vlfcfhuj6pdeq0682r0gs56;555637;404;502763547;502207910
3027;bc1p4hv90k79qfk62lhf7s4gymrrsrnsxx0mgfwj88rgpqdlc3ah295qlguymp;94000;3;354000;260000
3028;bc1pjmvnws5u8yc4mzpytq5e7enkmgt6jt8vrslqtyzzt4mcjf6rcrjsn4ptag;89000;10;2487421;2398421
3029;bc1p02t7ac8q8ua8juxp36d202un24h93e87n2qc9z9z36fgjdtvlx8qsehwgn;94000;3;354000;260000
3030;bc1pcm4k44m06e5lqpa5dz7vm0a8gqe28d4xwdhchm4le7xlpcaj02cq2tkepr;89546;6;747421;657875
3031;bc1phtya58j96mx7s9qxk8qnwkghlx039hkmaq9g0gdlfs3j73ahux0s4en0dj;204799;211;529391;324592
3032;bc1pstckpy80s9gufhtzgc9rug82e2gvhrdw8mccd0fz3pryeglmc30qgznc93;94000;3;354000;260000
3033;bc1pgwxfnyup9khtkcrjqv5ktagnhxz7jfp0xvkynmcttx7kva8ttsxsv2mxsm;0;2;13150;13150
3034;bc1pwhvvjhhhnt5lehlre23tm802qwh3c045zymnjh0lpqg7zhduwtjs3k8tfq;19615;32;25129;5514
3035;bc1ql04vd36g87r90pgxuk4aanhmzgyk4w3lh52us0;10000000;1;10000000;0
3036;bc1qtg0rvznvm2y9rx7g47wfkhdpd65razzwxqcq4w;3647;4;6984451;6980804
3037;bc1p4xdvenm39kjsnme9gjm7vf06kw54xq7hu88a49f6jhaek7zjtwjsu3gx56;94000;7;4581000;4487000
3038;bc1pl3ye4fnkhx766vh3cfh5glhww7czdkd3v276pq9n0qc3zscgwkvsdy8nd2;0;2;13150;13150
3039;bc1pewttmkstt6f7wsn6s7p5m3kqxwuk2q5t3wdxg6ld8c7z0vc7a65sqpqnu0;957464;1;957464;0
3040;3LkTz7bJBbCQ5H5eaDksubKs4dBkeUcTYm;239075;56;55901760;55662685
3041;bc1puj84vl03g7fpapjnqx5hnh2hmmr0ts6eajvtafzsy0n588e8qevsscun8z;94000;3;354000;260000
3042;bc1quh9jm6p06nqnvgvvv733pl0g0y6ycxl0aas2t4;8607867;7552;695642915;687035048
3043;bc1p553k4q699r5dfps0muk4503mkcgaephj4aupy7zqng0yz3pzkawszpc52h;13546;5;14146;600
3044;38ruZvQnqBih3F36chwarR5FwzPvpYgvgD;328162;1;328162;0
3045;bc1qy0va7hj3ztlmyp9ysn7kxp8x6srk3fd7erf004;119561;21;22613927;22494366
3046;3NdiyQNZKwp6jHBaYUR7AYqjjYANuZx3sz;22289806;187;542123253;519833447
3047;bc1pncjz74zntm8xsazlq8w2x2rlxv0ely7xa99q2vslcmzsr8dmfzcsm0r7y7;89000;8;2239421;2150421
3048;bc1px4gcyxzu8xmam857srxlnf5r3tq5q3378jz0pqrus2qn6y5s97dqf4zuxa;0;2;13242;13242
3049;32zAsBo3mkv6xJm9GFdbgBA7REochUXFfE;618034;24;20706763;20088729
3050;bc1pt3ruerjner3xrcgz46q7lfp724umggtmvrwlfhsfphrq03d5wzrs9zlmnq;30000;3;30000;0
3051;bc1ppjuc242u9m08ggwwkhuhm4nrz03gn8u4nw5je2u2tr0jf2x8lspsxhernc;1656;3;1656;0
3052;bc1pht2aqxjff8sud0lmngchkmked93kq962fflpj3llcsf6we9zuc9q47nln8;50287201;35;262833043;212545842
3053;bc1ptd7mqk8h73f3vgnrwc80fpp9kphht3szyw8q3y7gwv5vlv8ztl3q3jdews;94000;3;354000;260000
3054;bc1pamqs8yzygcwmvjvcfyz0acfxrfw5xx5ap453g2z3q0ynxx3mk8xq64tcew;304134224;14283;311322821;7188597
3055;bc1prjtq33umsnx3g073s6alp3872ds7gltw6pz950pzhmku0rshue4q5m0x9v;0;2;13150;13150
3056;bc1p23sx35arc6lecy02qmmra9phygshv65lx3waj2rezepkjllr2zpqugjr9y;94000;3;354000;260000
3057;bc1plcq0katvd06qfype7chrfftuuutzwyn5d23r98u473rr8vu42w2sntdyn6;13150;2;26300;13150
3058;bc1p06yezks86vrde9zp247szrk2hflz0rh4a0h5va3kvtalpe757qhq0srfm7;0;2;13242;13242
3059;3Egxmj8veYoNSfdDKiMbrKe4NUEqH4Zuf3;539395;12;5335322;4795927
3060;bc1ph97ak0tkn7lnalxddzvhxs6nwguzhm8nz0m37sqs0hmscnq464nqg37jed;94000;3;354000;260000
3061;3MyQ4BDT5mXTaPzvxHqLRb2rUKWpdiXnBz;3738769;3;25547669;21808900
3062;bc1q5tcqqhyk2x952wt2ns67hd48adkrzapeljv6s8;29139;6;15628103;15598964
3063;bc1pu23ffny0qc7try2y8nqlw278gdf20ctkrkr8888q2dtdrc54jrqq7ulthw;94000;5;1159000;1065000
3064;bc1p7hagsy9zvxwquqawqsjpkkttmext3h82xkqwmfxavcuapym6zc9qtyd4hs;18523;14;18523;0
3065;bc1pdkptcg38ldcnpk9a2ley6xwc50535j3va33tkua7rgwrhn9ulhvsgcxw3e;3192593;167;59983989;56791396
3066;3DzS7DUtsCsaRvvKNXvPhS6BZvE4C3SyL5;1715616;181;81691537;79975921
3067;bc1pkfyu3ysmsr0wh4jjk5qf7f20dwqm0m0grtks5a7teputhp0vrpasvtry2t;0;2;13150;13150
3068;bc1pazxc2ac85qacxe3620xz4lm53uvfkea64069vv7njuuuj4t3amcsvmlqsc;11546;2;11546;0
3069;bc1p9y22atq9ne7qv8ywqlx6xhrrtc7e2pu4vz7fr7r6g4n7ms2t0lks89c85m;141337;1;141337;0
3070;bc1pha5fctsrnqftmknxd4yerfy79ugwksefspkdpyx3mptz8hz4wtpsvvt4cj;94000;5;1159000;1065000
3071;bc1pqt0zcv0latug3kerkgrs4zf6s8mpe2smzlhtvagvj0sg0xz5hyvsapqnd4;94000;3;354000;260000
3072;bc1puu2paahejptltakkwuauw8zgep5gqajarwdydjrxrwp7l8y3e7wq6gc53k;89546;6;747421;657875
3073;bc1p0aunpm6zv36dz835pueu9nl30flkkzlpzwk3vls9zu5clm58klesk4v0qq;89000;9;2397421;2308421
3074;bc1plvjp5u42w6gd9us0nyjhr0hkmc0qzezdwfd629fclquyr4x2yups6uycql;94000;3;354000;260000
3075;bc1pkhgatumcyqh4t7jz6w97wavd9saw6wtswwr78mknd0v8vyxvv4uqvkedpw;94000;5;1159000;1065000
3076;39C6rERj6cFEY2D6MAHKzYmTLs7dHPKBHa;29796;45;8955777;8925981
3077;bc1prnxd4uekgfs7g4a40hq9uqqdwv4xc8wlhvrqggmek0a2ccza8xsqv6ezyj;94000;3;354000;260000
3078;bc1p48f6xzs0r76h7va7g7lrwex2q0qgvhpqucd629cvppfkl5cpvtes96yfk6;546;1;546;0
3079;bc1pr0uv2ralxn0p9np0s2akcu3ewk7uqcgmdfkg80f5lawcyqmvhrqsxzq75s;0;2;13150;13150
3080;3H5P6Eft5GJExwTQ6BH9gHEUfu5HT8kzQq;78307;1;78307;0
3081;bc1p4zwvaqcf597tv0q7ghe43lln9wenqsuctu3j45g9d2e8ntrpsaasz8wvfa;85000;9;5187857;5102857
3082;bc1ptjq5auls6myzjhgpe7svt3xaza36emwxgxml0p0vat86yxlvy3cqezmkul;89000;8;2287421;2198421
3083;36AeEP6GJQqJNmvnvHoe2KBepAoqsaimuG;1640052;454;1489656988;1488016936
3084;bc1plu6s0kuxxhc7tez2n0c9lphu5zrhx3gescucealvuked802vmthqmhrq0j;94000;7;4581000;4487000
3085;bc1p00qmydscs392epqxjlp3lg6kkg8c8fwcdc4s7d2fas5khvwkewhsrfjfq7;94000;3;354000;260000
3086;bc1put2lcvs34d27avtmyzx37mkw7gwqnvgr0z0y9fl2wq0v3vgf279svaa0kw;94000;3;354000;260000
3087;bc1p66gh560x8fheqf9wc4qlmjh22hsndmskhmsf4c5t2wyz8s84d8psycrf0p;94000;5;1159000;1065000
3088;bc1pwsp5wzfhs0sj4tgpdurls6ushurp9at9x4tw863p7c2kq77jhn5q45g5jg;2000;1;2000;0
3089;bc1pgp6scmqeal67zsdz0hkd3pfshrh66hvcfcxk24xhc97fx0fwussq6h2q2x;487378;40;15776189;15288811
3090;bc1pumpm3hc0g8fsp9yrnqkwrzu68q86eqcct3hhgzlcxqcq32vk3tgqdctnqu;89546;6;747421;657875
3091;bc1pnr0z509d56x9war5vt6c2v6yw33crafedfrz53yhy2fk747jyrnqngvx3m;2504667;9;13204639;10699972
3092;bc1phe4cay4k03csufnf2m4ddlfetr2vcpn7888gve75rjhym9l5mvtswkq4uz;149512;98;156671;7159
3093;bc1p24qyd26vy78czg63jfu0xr0xkqva7wyyaul6mf8dugjnzwnkgpws5a80m9;94282;189;260348;166066
3094;bc1p6x70cjjpmraktfqdx808td78d7rc0yz24cgtys2ew5lfu67er9dqedhpqm;151946;56;65298733;65146787
3095;bc1p3nhlupzgufpg2a3ukcwav3refk83jx5asxwhu9smnpd5exewe2rsephhwt;94000;3;354000;260000
3096;39hnaangk1ZvSJq1tBZCLVfKLHRhdQ8XsJ;26741750;531;9887865315;9861123565
3097;bc1pe82dwl4ump969slap5xmk4dmvsq0xfjyxjc8u4lnmgx6py4kz4qqqhvjn8;79869;9;1543570;1463701
3098;bc1pqn4g8d2v3rq63sswu4055h2h5nuuf80hjmhc5e8eee7zr9tdvx2s3tfrx9;739423;264;2566945;1827522
3099;bc1pue3emf5gguwajjaehhlpvhr8429jqmaegqptpzgl5nffvcf0rjysvjtm4v;89000;8;3247421;3158421
3100;bc1plgaakfnwqfggz8expnfykskwrm2kqn4ejy5kr50he6nrgxwnx66s4hz57a;0;2;13150;13150
3101;bc1py3v3ln6y3yn0n76n2nlf33298g0786xvvgnz7zn3namnxyj9mwtsyx2k2p;305500779;14348;312191444;6690665
3102;bc1pqgnh5ywqhg5wepym2p7slpwl5kcuer5q5xz9zt7rat6nrc2rvw2qza65mn;0;2;122866;122866
3103;3CaRvuXMWvQEbpXBtFGM9TedrszrvEqUQ3;999054;33;15060914;14061860
3104;bc1pyg2ut8uda6pc2c3fuzhr8cpw2l8d4s2hsu682cz4xlez2frwn8aqgkelhm;89000;12;4964471;4875471
3105;bc1pydjpay3yxf7pmj4039hm3fds3ftfwwr5aykmzdu028zzqdy6cydscgkmh7;1140323;583;151329737;150189414
3106;3JiaAMTyF3pDbtQhB8PVjzjK6pH3Gku7mV;658948;198;143555121;142896173
3107;bc1p295tlkskhy2t80gqdv2d9vhvpx7nnrpg2e0dg3v5hgeec8eckwxsdh0ftl;94000;3;354000;260000
3108;bc1pzjrmu729ew793l75usduyugr4ekgcjdz07aswa5kwwrrl6f95eyqt3fzxm;137324;2;339465;202141
3109;bc1pt2sndf53y6keu35fqh7zteun3l8wcaggxdcsjpxlgrus4fu4v0vqjkuc9l;105569;1;105569;0
3110;bc1p2ktl9yutss73ze9m32tplc5q8tc3m8k25ersc73ynqzfp4d2me5qthdxsx;89000;8;4227482;4138482
3111;bc1pxc8wr3hllkpu50pr633jza2k5hw860kglq5ywvuwnn7kmcvzxhaqlprrrq;94000;3;354000;260000
3112;bc1p5v0pje3fa2rvdhn4sk2yvj64lgl8s88yq3wf86pgeel0qnrfrezqgak3ww;4620;7;4620;0
3113;36uA5NRiAHyGVF6dT39yY2KgcTNwZJ1U6J;37662389;3334;427420767;389758378
3114;3QMkURuvqbCRxZLQq2qvcizbp67s4fHMhi;4932116;711;1898049623;1893117507
3115;36b9r9u5Ymza6jywbcrwVeRpzW6qgFLnQa;395626;3;16008052;15612426
3116;bc1pejkpj9hhun3zqvx49yng28v27yxha4eav0xersc5kk4s28gjswdsm8ewaa;1776396;207;22633003;20856607
3117;bc1pe0fgxxwukhxg7gh8p5ec92t5tr0ekmv9g5nx025zdn9prvpyan6qglf09p;94000;5;1159000;1065000
3118;3AeR4XXzJFhkr3JgDHqh78aD6diMGmtw9T;0;2;99975191;99975191
3119;bc1pl2mavm67y8cnfgzu5s7hnxzu6v95q44j8e6vcpsnek5zzdfhluqq56kvxv;94000;9;5333500;5239500
3120;bc1pq25lujsehg7r9vpyglxdy95gjt4xg7ky9p77ujm9nmgd9j23xmysfpngvw;94000;3;354000;260000
3121;bc1pg88h7qd6rl4f8g0y76drlrehvaec8r9jec5jr9txqhv7vwvxcnvq2qpav7;94546;17;7237564;7143018
3122;bc1pnwnmw4m5wtvv5vtl34xse2eqeyxk95jwtqzumqweusr6vyax3k0sc2lrf7;94000;3;354000;260000
3123;bc1pfun324m9trsltfppzpqzv9sy3uynngl5g6ymh9uy3gctuepkcepq2fq58j;94000;5;1159000;1065000
3124;bc1pmjx7zepqvy7dxhvtvdetvagz9lngtuy6v3urmv09df7kqkh8qcys3juwmt;0;2;13242;13242
3125;bc1pdlzgx5ghxv37p4cq2yzvslwp48fcqy2f34sgzrplv07uwdu8fxvsjqecav;546;1;546;0
3126;bc1paaupu6fe3rfmeck3rd32vxaqk955grlvcdkm7avtcv7m4xkyjpgs4uxne6;2048260;2;4117260;2069000
3127;bc1p5zd6s0g9ph7qfkwyck5400kzfrm4fq67qvu6mukptsqd23wznrnq8lkugv;12309;17;3712797;3700488
3128;3AoJGRUHBXrG6S1qMDz6xhVwWpWVUfuLoo;198056;6;50288939;50090883
3129;3Ke1Qwd67jpcGDSa2jdVzxrevSTmfCthP8;2712513;5;14050354;11337841
3130;bc1pv0qxjkpswz0m4dvek4c5fh9ndlenm7ns8a374w0rlr3vxmeadcqsu80yly;0;3;26300;26300
3131;3F9SbHZinW9x6VKrGeDRgo5CZ4kiGYntB3;483017;13;4899410;4416393
3132;bc1qsd38m4lhv8hf9m07ezs5kwg4kgsc0m4gch88qf;68845;1;68845;0
3133;bc1plwgvfemdcqfws2q3x9e9ms8pkdpkchh34p6svs5d6y0jtks6mdhsl45g4w;94000;3;354000;260000
3134;bc1p7lpgup45454pzyy4x4m2fnvkyvn5dm65mx2zjkzdgsp2w57fl0ts0cery8;20330;2;20330;0
3135;bc1prkwsdayt29gdavw8krzjjrrdc87t9e3drvfpn7wn4dgryw9t8jpqqxec0f;0;2;13150;13150
3136;bc1p244hqze2a4uvmx92xdzhzgad5sk6ees8lhz5ww48zcmnpvct3gusy5mqnh;0;2;13150;13150
3137;3B6th5Tc6yW6kPVNzxsPMjT7N2cw4ehSfT;4716000;54;100873668;96157668
3138;bc1pj0dllkrsc309qjkpm7dz4sye87gghqqhl9wq0s9pswd58t39p5hqg08kne;89546;6;747421;657875
3139;37izAUsEPXhTY2MqwMAvewrPpE4AKYmnaT;3196;1;3196;0
3140;bc1p458t5wtkxhcxceswj4hehhrx4l5glj4es08y4e9r4h9wzwc54jfsr086aa;0;2;13150;13150
3141;bc1pq5z0hvxnewyz2kr40j4d32nx9tn0jx0vvdsvjnlckjekyhdm0j6qh7w6hf;15124912;2128;16274788;1149876
3142;bc1pehw06m2tjnz7ywx9k5umtcaaqd4uvecelxnvapttxyy3kjajcxwstam8lj;94000;3;354000;260000
3143;bc1p97lnmr4grt6l6aprvppss5eqq3wcz2wssa2k2xe3hz0w5e6av94q8awcx2;94000;3;354000;260000
3144;bc1pquz62anahzfwnqf9wagynvdp8hv7ehy2agxlgy72h0hxs058zqfqk8ksyq;25219745;105698;328933123;303713378
3145;bc1prls8lqgqkl2ltelm4f45km6j9slk2wp5uhp75qcthq60mulscx8s8uvd9y;0;2;13150;13150
3146;34BMgesoDUx5WcT1PEtgnfN7Pjs2Q26m1h;1288699;43;11143483;9854784
3147;bc1p5jwedngmj3n9fkjpl82m444gwpw5nu27alt2y325lmyyt6hea63q3f67ex;222456;24;3175136;2952680
3148;bc1pevh0zd0ssptu523lm639zdjfn36fdf378qv5nwzghxnstqn459nsxn3ymk;149260;2;319260;170000
3149;3CHLAX1zURsYyDmC6NCCKMJV7gkne9LPNn;84007;5;469691;385684
3150;3P4WqXDbSLRhzo2H6MT6YFbvBKBDPLbVtQ;16616601311;955132;50001712350;33385111039
3151;bc1pk9x2j98nt8fg8czxhqhp8lwt6d9r0cxsqcp2k5zp606xx8gsmmfqlr0sfa;1065683;2;2165683;1100000
3152;35hWo95KvZBoCffF5WaU92UVtzDU4i4n7U;232006;9;232006;0
3153;bc1prtm266g3q27alxhyy8ys85e8ktacqmgtjm6fe3cmrnskn8yjcgjsrhs5qx;546;1;546;0
3154;bc1pa53xtu2swpmq35p7z90a4mvzclcxmyvey2m909cxp3vgkhg5jl0s0hx75m;0;2;14196;14196
3155;18FWSyYYKaxApRzJdSntmBrro8bUSTtphK;1999538;7;11456314;9456776
3156;bc1pamgmus3qrlg2zsc7prwxufxcp9wv3ec8edm837z36sr97hj6zd9st3jqn6;0;2;13150;13150
3157;bc1pef0wx9364vz6ur22l59mq4nulfapm9e0axdn3m9sxj5fgl8k8mhqhkrayk;0;2;13242;13242
3158;bc1p3au4kuwxg49j32tvq2p585hza4cecwm6ty73es3q0n7kqv293vjsu5t3yd;0;2;13150;13150
3159;bc1qhunhhgan3asak5lae7gywtunz4gdt7dd0vwjz0;139361;2;361114;221753
3160;1HcHP4DfJRyV5Lk8MFKsxcHW3BYjdAXZL4;136981;1;136981;0
3161;bc1qm7kgk0eklhtj68lswjnczw7rk5aplfxa2l83sq;1457038;3;2957048;1500010
3162;bc1p8za6uj2ayguv074ehtrx5qkprk4uh03sh8a2xltx762ce0hz4zcq0jldnh;13058;1;13058;0
3163;3DwDwgE11tZozJKdn9YURzcrYjzBdapiA4;212900;1;212900;0
3164;bc1pcf23yzv3nh204ql0f00ct6hgw87x4krsh49x0t7qv0wjfes58zmqkc9w8d;13150;1;13150;0
3165;bc1p64vvr8gq54chfm8hqhctj7vwl3fmeadz9xt0kj785lcgex8n8ruq9976ms;0;2;14196;14196
3166;bc1p8ntys4wkeegnqurk57g6sa32544s3eunq74wp8uncjunynz6qgqsrc799t;0;2;13150;13150
3167;bc1p4uc4nz4cs02e9mk8pt7rtyfejcwazvzycfd5ecafd56jdpwhdctsata34p;0;2;15379;15379
3168;bc1pvazk2jey24jvjwt78mwc2h4eacjz7ck5w5ser62e8uedww262qmqth9zwj;612800;96;8090236;7477436
3169;bc1qwqdg6squsna38e46795at95yu9atm8azzmyvckulcc7kytlcckxswvvzej;2324406749;1120740;326842212370782;326839887964033
3170;bc1pt38ethum3rqasleh404elr7jd47fd9ue4rtp3lu4w7wc0hg7t32qqv4ke2;13150;1;13150;0
3171;bc1qykmk22x7dglmjmx5zx0twlxy0slksagg9nfmr9;78318;1;78318;0
3172;bc1pdyp5qkaw82x23jnyqwws3mmszkdqgnvlpfs2xnsgkqz7c2mnyqhs5fjpeg;0;2;13150;13150
3173;38BEwpv8QooxuckYM5Ym3iWeeiHALZQtGq;5680000;1;5680000;0
3174;3DSKkv8CvFaewzkFaxRBcmnYS7C5YTTXQc;1276128;212;1257244845;1255968717
3175;bc1psvtey5zv3a78wl9xcmajwzxsakdsn50xzavrnnv4fp0fr6q27x9sheehsy;0;2;13242;13242
3176;bc1p7nu03qx0wr5nfkvu7pqyr0e68u4jcpqn8u0x7l7l7sqgperg54fq8jdjmm;13150;1;13150;0
3177;bc1qzk4xz9sch9tvmta9zvxcfd6easjkyc4fhxd5zf;2813631;1;2813631;0
3178;bc1p6y8qh6j4r2qzlfww5ev7utcqd7v5mlclmhu68vsyr0ue6e3ch2hs7jdmyf;2596218;535;122375895;119779677
3179;3HXuwEtGcf2M9h4qPBaWxzLhqJf6ivSDD2;1063221003;250;1075573949;12352946
3180;bc1pwaecrpm3h2dnq76rr9xqhtq2cj3karafs9fjlrezacxnuhu0y3usjztfpe;0;2;14196;14196
3181;1JiAkRMdNUVxVmLpKXMtGngpckavJhad9;690002;8;4192004;3502002
3182;bc1qq0a2czu4f0593v6yaltn0r0zja2pehxxrjd2ts;40000;1;40000;0
3183;bc1qvrvjlx2y26sdkct9xhmfw4rdjkh2qnlhw6s0ep;78357;3;85755;7398
3184;bc1qq0v7fykcshf09nmlcaa4mq8jufgcqstvygj036;50177900;1;50177900;0
3185;bc1qjjdr9wqw0sc0m2eafwpfyvlj5wr58609qu0v4j;70000;1;70000;0
3186;1M6SzMctnWfUHYMKzn8WNaaFHSSBvAMbru;2302110;12;2302110;0
3187;bc1py69e6y7w4f3223fj6pfw3289nrrq2plnvhqe554ad4jkkt2ymefq784072;13150;1;13150;0
3188;bc1qv5495xh6xa8p4dfd50h2na779hg2sps8wsjjpu;377082;1;377082;0
3189;bc1pwjna8h2epv73aa4atmqfztm9mj25f957vdemprn7ezukygwcrz3sm5xk49;3949592;124;3949592;0
3190;bc1pwcd2xq6a2me5hh8w0su8gwzvtxdk6dturw3ddeaxqmzv65dscvwq7dt49x;0;2;14196;14196
3191;bc1pvzafd0a6fve3ulm9lw82ckqqcgfrezsah7dwdck8jhympswzefrqxz9f3y;13150;1;13150;0
3192;bc1psvz8lehpnzs95k5uuzr5eeswtep6lwfmcjqfzrr2dq27ykhgfscqlj2kuc;0;2;14196;14196
3193;3NbFEY34PuN6ndnfdibkKTpEUzg3MzyszQ;230703;16;130867637;130636934
3194;bc1p6zknv9jeh9pwzemggmzm53xa7n2h2645xln2sg8wergrzn4vty0qw5w6lh;0;2;14196;14196
3195;bc1p8qk528zl828tgtc7qyxccakv0pgs4zwtz5rn2kef3y20yz40z3sshvsvw8;13058;1;13058;0
3196;bc1plw40gje5vd545rz3mtm2rcd5d8tr3pl36l0r5u2p7mscsp9dvqkqc6x2nn;13150;1;13150;0
3197;bc1puuy4gejn23ah62rg83jwfutw8rhjmk9c3ds9mc4z783pzrucx4lscvgr6m;0;2;14196;14196
3198;bc1p7en40zu9hmf9d3luh8evmfyg655pu5k2gtna6j7zr623f9tz7z0stfnwav;73196389;202848;2865737188;2792540799
3199;bc1pzs8vmvej3u7gawmwmjqs2ese06xk8wtsaafcmqzp2ltreefdf4kqz69akk;0;2;13334;13334
3200;bc1q5j7gcg7trxhgce406lfqu3q6a82ztp5clq23nv;482254;1;482254;0
3201;bc1q6tykc2ga8dxuhdky4zu829tdxz34k0359jf9zy;39070;1;39070;0
3202;bc1qs22j537u5z4l28x8hry8vzl5g7vk6lwle4zhuy;85050;5;386745;301695
3203;bc1pumeks47j6y7danngm6ynru2u3d5psky9ykd6uwf6zj7h7jn6vqzsrmdp6r;0;2;13150;13150
3204;bc1qdtvwx54ze7vv3cn4axhpq297r5apzxrrurqz9j;83327;1;83327;0
3205;bc1pax3lxead7r49gejh73fjfq9dumly9su55vak4fmhhawtn49fwp8qveetmr;0;2;14196;14196
3206;bc1qjzz2g6kcn0y6t5qhm3l05m7artxnhmvs58ur9r;73032;1;73032;0
3207;3DvE5fDHwZaJnQ2qjct83Lgws4PRJjnH3i;167403;1;167403;0
3208;1KpJKP5JdKjGA9hA3vwNPoJ6aA4Re914Ha;1077;1;1077;0
3209;bc1pw9y3yytl32vke6uyqg4j6evu0hdt8z2ewcy5zgpvcg8j96ka29ps2zuexe;0;2;13150;13150
3210;bc1pc2u3xpa068k08pxf0a3s48e264eqxke23gy5t2r4tpmtk4luyeps5pgnl5;13150;1;13150;0
3211;bc1qprssay4q42s5v39ml8udh2s9qd2r8fjs0hqmma;3130272;18;85599208;82468936
3212;bc1paj435sw5m5yw2k8e0rr72myyz9savtx95gv2z0yswaqxqjd6qhrszjkywg;0;2;13242;13242
3213;19X5ZX3qM2teMBYToV8pgVqh4amrPc98V1;847000;4;847000;0
3214;33yCMTKJZKxqxqdimw1wTWmLUvehxb3xnT;191574362;16844;191574362;0
3215;bc1qc7jw2csxcx5vufr97m59wkrzt9h4cte8njr2dp;187865;1;187865;0
3216;bc1qw4alvwgxtxwk7la4k9d9zfud5kmeefauyd7g65;62640;5;223970;161330
3217;bc1qv34kktgr85u667ey5l0dskn3l37vuf8thw5u0m;0;2;13341362;13341362
3218;bc1pk5ccuv82t5tp0cwukwkz29vnqjxmyyp9u64qnl2was40nf4vr9vstz8k3u;0;2;14196;14196
3219;bc1qscs4ec2ncnatjrj753fr04h77tc7nclp4j73f6;375392;1;375392;0
3220;bc1q8qpga0a3x8h7p6qzd0lqqdwh2h7mw6k3w6yn7h3myped7pncqkfsk6mmw3;118816;1;118816;0
3221;bc1pf8ff7ujwcfpqye05p7cm3z4fx6ugqxuc0ywl0gg3juhmscrclr2sh3je5c;0;2;14196;14196
3222;bc1pv4nahljd9xeg7th7eyfvc0rg3akm88cuhx3su6xfv4n4tpylhajqrhuu5f;13334;1;13334;0
3223;34Kz7fLnx4UgeN31xKXzSQMMz8gBUNqJMC;34331860;608;414311839;379979979
3224;3NUoGgka9c7HLQrTkNwPapRkpsQCheMsjZ;60452000;400;60452000;0
3225;bc1p9n84ufq6zvzwn97u9rchdk0snmx8g7fddxjw8dfztayg823xevsqx739nc;13150;1;13150;0
3226;3K7cgTZ1Kftsf5xqGr3niG9qoxeA9WTAzW;6027700;50;57520118;51492418
3227;bc1qvcgdsdrmgf5sr2dl8j2zzwldlsy5ds9y453s48;26015804;4;26015804;0
3228;bc1plcq0katvd06qfype7chrfftuuutzwyn5d23r98u473rr8vu42w2sntdyn6;13150;2;26300;13150
3229;1C7PRUABQ9GPpETFnxFia4X84H6716ioFr;3135890;1;3135890;0
3230;bc1q5gax3j7rs00ed3ne8750v5vlg4l7mdpfjvht6djuqyrvuejcl5ns3rms5g;1534589;1;1534589;0
3231;bc1qnfltz5p4xmn476hrjqh8dna3kfhxk8p3pvrfw5;1048049;1;1048049;0
3232;bc1pwfekcgumsxlncrty3pywprg8npdk50gps5el58mftpdnmwy7lajqhfl3kk;0;2;13150;13150
3233;bc1q7u2sqh5nrj2ddwkvmgxj340lrc9aw367kfqkzn;2806256;159;398012732;395206476
3234;bc1q4gffrxjewyp5kcaweluzjym5n57k078fj8rm88;8620000;1;8620000;0
3235;1Hd21XTubVAEeQ3P4wb66xCpEDJjyWgRr2;4354820;50;7563540;3208720
3236;bc1q6mmkch5jhg94gk7jm8a3zpgyqvdtskd6t3lxfq;2401581;69;138833030;136431449
3237;bc1q2jlyc7v3z0l7euemxxw33ywvf3ptrr9lumhdz7;30627;41;11618119;11587492
3238;bc1ppdzjvvekp57zud0f6nw0sav77z0yp5wnmh2egatha2sqfn9psv3scrldcr;13334;1;13334;0
3239;bc1qwj68e0ye057hpt4rh74vdmjwzvmjse7v7s4h3s;57762;72;89120932;89063170
3240;bc1pk2w6r8gagke92tnwwtpcldu5eewpk8ugz3eua63lakqp8g2kthzqgyzxyu;13242;1;13242;0
3241;bc1qv3fczjtqawe2l0mfz4rfh4ecu6m5thz5g9w8jw;122829017;1;122829017;0
3242;bc1q8mn00fqjxr0xshxyd2tnf9htgzmc6yd76ray4k;78163;3;1712893;1634730
3243;bc1p68wcaa2lnsu3z52supp4v2g2p2ndreydhukk54pcq2av03qwfl6qry9wcm;0;2;13150;13150
3244;bc1p6ydcu7z3z4ew2as6p50ac87j3a9erkzz9zqafnp9uka5ytxpjk5q6edrva;0;2;14196;14196
3245;bc1qk62q6yjg8psardaygsswsn8kkwyyusk8hz0x9q;7417450;40;35886536;28469086
3246;bc1qutcrdmwdzgmm2zs8k5rmv7rhk74x06sscjzlfp;288778;3;923790;635012
3247;bc1pec5rcvk43yv77zx6t9t5vc2fe6jcjesctw9nsxz43azkegswgz0qp0xeqq;13242;1;13242;0
3248;bc1qd5qmt8rf0creh26vqfmm2famdu0dfhplvkwcqn;954200;3;1954200;1000000
3249;bc1qyyv7zde4xmkcswv9zdka7ww2g6mfxnt4ama8ax;761125;9;3247095;2485970
3250;3GkiF3GwupCeVR8m37AgvpMNBGpxeA6apg;1193158;1;1193158;0
3251;38on7ZBwNCrURASjHQq1DzRxRaj9oF7jN7;800683;2;800683;0
3252;32wthbRDtUv7uYCMwNb6ewCHXGNucdg9VF;250003;19;5433912;5183909
3253;bc1qumhf2cdqx9ggnkxv9743v3a09hk49yvg5g8ynn;1852191340;904;22748765477;20896574137
3254;bc1q25dqul02z78uh0atf8g2zlrncswlxghnm2m2hr;1323780;449;3039288670;3037964890
3255;bc1pt8rhn6dm6amwjr3tlyzllvy4gtr7uzdenwxa2q3mz54m2pzpevzqkcm58c;113524103;8064;413470475;299946372
3256;bc1palwvr9eu980qlmsldh7s879kh56tvstyuzck4kmuj3x77ma42xaqm8hhmc;13242;1;13242;0
3257;bc1qp604zcm55kh0dtuwe76kdgy32mwg2e2pd0zgax;885779;1;885779;0
3258;bc1pgw23kkyjc098agy6qr8syf5eh979e3hycfal7dal4tmgkxp33rzq0ek79a;0;2;13150;13150
3259;bc1p39rk3xn4pjgjsjnalkmphcsyfm9h70sx3vc3nyt6k9vffphgu5pqxzsgc4;0;2;13242;13242
3260;15LJGf8tSRNgc2BeiJzhnm1q22Vvo4dSrJ;155450;1;155450;0
3261;bc1phurrsmuwh8wtdctqzkehdy7h7n7xhzemdcze3ke9tnrkxqescnmq6k32kq;0;2;14196;14196
3262;1CnWKqxF2dwoZ7F5uPJj6Q68stBTqn4yQ3;0;2;239422;239422
3263;bc1p2ung9dapeme8mn80yn0xy7easwnga82qk6kltmzx9n3c2py7m9usfhzjtl;0;2;14196;14196
3264;bc1pkvdm3yh8qy99ksvhecvzz4ccn6c332gplmlxfu5fxakd20xctxdqy2g4cc;0;2;13150;13150
3265;bc1q5wg76ukvsy9kq6yl8txqt9ceh7fv0pyvdgxeyk;532904;321;114338190;113805286
3266;bc1pm8vtz3lel0drtdmuzzlrkq3qr43wjv89cqkwxhcw72wyx0e8w27sj8c8z2;13150;1;13150;0
3267;bc1pv8lvlaha79h2kwxvs2z5dpyxzfr6c9lu5ptc4sknp9fqs275yqmsanajsa;13150;1;13150;0
3268;bc1q46yhht4mem5g6ak9angkufw8kqj99xmdjr6ufd;781839;1;781839;0
3269;bc1qn7ap8ky3v5ccndnxclfgtvd2ws2arwseaw4075;78273;1;78273;0
3270;bc1pg3tke8vh4z6g8pjrxmauy2tpne7cy9erfv3dqcqclv3jakpyy4ws6fen8h;0;2;14196;14196
3271;3BMzbgq1Mi6tBgmH2QTHzAnCvBfQf7oJ7t;608492;126;103347778;102739286
3272;bc1qn4gar9kf6ly4d6r7k6ksr0qcl7jcpklw50exs5;114531215;5;378177851;263646636
3273;bc1phqgp9w20k4l9f28scmg4a9g0tmyc36nhn7lnwapgf4axsh50wvwq56v3p0;13150;1;13150;0
3274;bc1pl9v3x5vd76yqg7jwce2h29v5gmynpljf2z3uuk6t38mdct5zazzqsjkkuh;13150;1;13150;0
3275;bc1qlkrs0eyzverdd48sv656r7llx3v3nav5xyzahk;26916697;102;592672252;565755555
3276;bc1pyg9dzzr567ntedap8uvgk3y88tk2gt5el64acjpt9pv2fxtmuwmqhzeh3n;13242;1;13242;0
3277;bc1pfw7u0efcnn4r9pdymgm7tz2prlkp5kkhjqm7qh8g94lq5ec20jjq9vyk9s;3541415;58;23278537;19737122
3278;bc1q7sls7peczyq60qajqmwl37y36x6fanecl05d2l;132894;1;132894;0
3279;bc1quw8plf04jrrapfqft05h4e3psqvqnze74uu6as;185049;131;74486693;74301644
3280;bc1pdrk65mqutw6usnecht8lud0sdagd8puzzkmtsczxhlrrgrwr5utqrnqk3w;0;2;13242;13242
3281;bc1qpg749jzun8u0n9axarv97xvl6ywljl064cpl9h;63420;1;63420;0
3282;bc1p095lwglyqp0892j8rjhw9d0chlj28nh8u7085s5rux8a8r99ehcqr46z8j;4518415;1;4518415;0
3283;3BKyoJPKd1eP7rBo6gzhV2bs9aCTaGApNC;260743845;4388;594666905;333923060
3284;bc1qt0w0l5z8p98lyzjdj59k3hppfxj463jx60exz9;2866907;10;18196650;15329743
3285;1NbAPwcZBqMxTb11LR6cduVbvwVUyVK6a2;0;2;496258468;496258468
3286;bc1p8z9p46py0fh7lknzjmg83xzn6kdajajce96qvpeu7e7jwydktx6s4h5t6m;0;2;13058;13058
3287;bc1p9m9zsy73kg2wwsgu3j88a7frlmypm903ewlhqf7gqz5tuznjus9szvhunn;13242;1;13242;0
3288;bc1p999zpv6fz3mj4jjth2ahwfwdtwkxap4e58kprf5f300ypktr3ugsfz0u5h;13150;1;13150;0
3289;bc1qfg2q63wnfvezkkuwy4vwkjfmt4yxt75qt8ch4q;78226;1;78226;0
3290;bc1pxed0cm70teejea8wr2vvr7ayux985kzfm5h8nu7n3x7qc29e4sdqncvqsv;0;2;14196;14196
3291;bc1qruqpg5u9q6rhyghwrreu5te4u429qedrrja36d;126734;7;2288524;2161790
3292;bc1pxckg9py05upjjgknm9yjjamhk9z96lfzjegp8qtjlsrcqjgzlyzsk32la0;0;2;13242;13242
3293;bc1p4g4xty8dfy50k5uqfqacdn5s4uz3e9axsvfqfjsjampazdpzzzrsda55s0;13242;1;13242;0
3294;bc1p0nkm27q6gkp2ln460mp8vh49tcp8z9eqrjchm6vv293waf067jqq773xmp;13242;1;13242;0
3295;3BndgR8AwFph8e1z6kNMsDxbx9K7tCu5c5;137957;22;12083048;11945091
3296;bc1qj9ecdz4x79j6asztsnll8tryudnel7klhywutz;61150896;12845;61150896;0
3297;bc1q5myetsugsyn7gm47gkjnd556lcd9sdkz9tt906;96889;2;96889;0
3298;bc1p758phye8htkyx0653kh2ap7kw2edlcegnufzkarm9fufjyy9xh7q233rsh;13242;1;13242;0
3299;bc1qj8sgqekk3rj6fwfhduewzn7phalwxzq3hfaj26;622758;1;622758;0
3300;3FsESZ65zYWt7zEHzPQtti5QHH9QBYGBnQ;881579;10;1262608;381029
3301;bc1pd9rwfh7yxuzat7jztdr8a9e2pn3fgvqexgvnkgeexyfmfxhrywdqz8ry79;13150;1;13150;0
3302;bc1p9f2urywmdhz2w8qnhmnfhrc2mrdz6ycysj2unkxxk6l2qhgj2mzqfm5tqp;13242;1;13242;0
3303;bc1p77y0773gwqt7mhlsl2nwnds9us8kl240p22j4vf337mkwndme0xsfnw9uf;133754;65;173146;39392
3304;bc1pkcy88m9xsxjqjml0wwypcnqsfqtfkf6u59z629m6lj4l03g0guxqmc05j5;5460;5;5460;0
3305;15J8gArjQkV857z8i59jZnKGpoRZJqeNCR;224050;35;5251339;5027289
3306;bc1qwcnlwt5zfjevm9ek2xf3s968ma94ke8fncdc9j;108194;1;108194;0
3307;bc1qphz9dat8xl0hlc0jfucex25z2ttna7mzjrkjvl;6057366;33;27212329;21154963
3308;bc1qptr2rtsgrkklm9m6cs37cpvfhnh46rlldk7wqu;156401;1;156401;0
3309;bc1qsn72pd00crr9djk83e4g4xfzrzhnev0uapptek;54781;1;54781;0
3310;bc1qt7rvg86mdewrhw5swhc8ynr26fvken6rekrx5u;11767825;3534;2766653683;2754885858
3311;bc1psdak2pu8zve4aszqhygpmgp68lrup8cr4ders2xzjk2fm7a6y67qd45cx2;0;2;13150;13150
3312;bc1p4x6fh0k6x97hlyehas9y7r25gypqu6d4jeqxy3uaxtn3zlezu7nqht53ll;0;2;14196;14196
3313;bc1qna9cmhpw7j0xzuslptkkkycms8vprh6fdsj3hk;290154;1;290154;0
3314;bc1pr060ztagx0tymssdxluaucvzwq9l2sh3lxs0msqkdrln2y2z8taswepmh5;13150;1;13150;0
3315;bc1pjrae9tldxucvflyulr8lw7cj0vq3vapdfsyrsjyf3gw3qq2l8yzqjy72ks;13150;1;13150;0
3316;bc1qetnphh3h25lzqsd5p8f8m3xczajtz76m6d3h4q;100000;1;100000;0
3317;bc1pzjqcsgns7m7ztapj29dyl32ca7kg38zsumnslgugs0zp84rqtswqnqwgtc;0;2;13150;13150
3318;bc1p3s4q7cxxcv3kjcfnwve5sjpxa8mfn2c2qehfjcyqynzuu3agycqs2zutkh;0;2;14196;14196
3319;bc1pv0qxjkpswz0m4dvek4c5fh9ndlenm7ns8a374w0rlr3vxmeadcqsu80yly;0;3;26300;26300
3320;bc1pfcc4axvutrv0p2txcl6nxwzwvfk40pz8hkh8lu0xq04rlw3yn3tsefw249;13150;1;13150;0
3321;bc1pmj3qd2pt5lg42zutwkyz7yss2peau22h5tew4xn9e5mjlfutrteqvdg2n4;0;2;13150;13150
3322;bc1q2q0urnpmjhf4w53m8gp477gffs4l8t39s3aquc;344483;1;344483;0
3323;3BRa8u2eBc8bDzDEHpkpcyLAxWDY6GsYHU;576239;29;6614960;6038721
3324;bc1qjkatyg4kvdzk7kp4dh0wwx8nu53jvfwfm8aglu;157572;1;157572;0
3325;15kixJt2F6uK7LR5dzJvZDiNPgyBbYgiNV;4429138;27;7300138;2871000
3326;33nTfC8n4eEFnXffodVyHGwsVnaiXKZQxA;29985;1;29985;0
3327;bc1py6l837ujnae4w4awv4j0gzeejae462m2y5py4z35r3czcht54deswg9q5t;0;2;14196;14196
3328;bc1qnhdu9zpf60cluuppr8yaul0cey3hgqmdczlyn2;328306;1;328306;0
3329;bc1p9wgzmkm4emrxxln8wz3na2fj0pzd28s57jsr0m3gqkdt0ndqpd6qcsdf7u;13242;1;13242;0
3330;bc1qhxk4ymqsfvacnrsdpamarzaskkcjq8ulezxs45;1000004;1;1000004;0
3331;bc1pzl8rckqdldp0amy7u7kszmv57c88kgm0z4vc85z0p3mmlt9xc0gqj4a0rs;13242;1;13242;0
3332;13pueAaWGqZ1VKiUvCmKL9bej1zffWaffA;79198;3;205094;125896
3333;32zYNjtG7s4duzh9GbP8mQH5rmww3EM2rb;366294;11;2115429;1749135
3334;bc1pm68fm7nqcqz86utzuat6huej254365z5va835saw7r793p38keysnyjxan;0;2;13242;13242
3335;bc1qx309k32cyfw97puylc7kqc6lun933ehkcs50y7;1764;5;568131;566367
3336;bc1qjsv2ykaafndmm29f77em5n22fgftcy828uesev;8777765;1;8777765;0
3337;bc1q7pf9f6ghcck6k0r4p4fm0y2jntpzvss47vrpap;6668842;1;6668842;0
3338;bc1qmt5z8nguc33789vetx0gs8p7xntj9c2rqtxgwe;3132000;1;3132000;0
3339;bc1pk8wkwl4vjlmz0d42x8334l3l8qwya65lfat5apg37se9ye0cftms2k6d2v;122597;1;122597;0
3340;bc1pfqam2q7aml2fn29qfrhf7k5sgntcge6ttg70pmmlu0vfpq66acpsg7zv8l;0;2;14196;14196
3341;bc1pq3yjamnqd4mm44n5l4cgvpwp9ea2tyyqruqu20w2pewry0rtpmgqfkpq4p;13150;1;13150;0
3342;bc1qpa6ztu3ffylymlyssf9aaza49kdnf02yjm2k56;9804;148;36039665;36029861
3343;13Zjnxzy9QHRh3LtX4gFVuvpywxveHDXMm;4143262;13;4143262;0
3344;bc1pea7ncdwxx8smlmgzcawmdeu7erwrka6s5zdys9m3c5ayrc5m88lqcpdmwp;0;2;14196;14196
3345;bc1pspz074l96962ga0gk27yawywk0f3rmqwa6u0aqnel30xl38m2uvqh79nt4;13242;1;13242;0
3346;3CdLmf47LVZCW8rK14Ed6yW6iouQXbLLwE;6474400;1;6474400;0
3347;bc1plz53zc0dd9u2p2l9sskvnlxxyjzzzx25gqp9el3asj5jple3rm9qth2v42;578403;3;2095883;1517480
3348;34GpdwH9HetbqTjvGEPjEN5LGuB1W2gVfg;103368;2;327582;224214
3349;bc1qnvqrdtt25sfauphxnuy835terqznvnsnmrcaqm;1100107;1;1100107;0
3350;1FWQiwK27EnGXb6BiBMRLJvunJQZZPMcGd;73819198952;158504;30168157815465;30094338616513
3351;bc1qcxw0m0ehemcek2pslcr578ruzhf4f9fr0jerd2;78259;1;78259;0
3352;bc1puvejf6snz5rxffwlglwua7ymnmrmryqmfv2tdkjuwnmwp9f40wesp0xdw3;0;2;13150;13150
3353;bc1qmle3652exkllm7eqfjg6yur9fgp2a5j873a6mz;10250860;1;10250860;0
3354;bc1pjlqppt2xffytway3zyada5zhpn5txgysh2f9kc5sukafwf5w837qrdxky5;1382117;1530;1270133958;1268751841
3355;bc1quu8fryfp6yyuk3dlntmx7wt2f4upxkuamrgllz;109620;61;26883584;26773964
3356;bc1q075ecw5z5wjpk6rdx8s05ljw0xddvkgd7rggwf;5858778;16;108450451;102591673
3357;39eRaDTDCSjUgiAomapVexagxcSaRFwXp4;9652903;1086;2187044654;2177391751
3358;bc1q83v03cezzux26yk2qnc5ljlp638mz73h52djr6;15153672;1;15153672;0
3359;bc1pvazk2jey24jvjwt78mwc2h4eacjz7ck5w5ser62e8uedww262qmqth9zwj;612800;96;8090236;7477436
3360;bc1p78n2y8jefwt9kqks56xjmzv4yu2x8pjfvpg3suw3dawwhsl28pxsuwfpjr;521323;4;3900650;3379327
3361;1KYrd757bChnbs9BZmSTHRSTh73y7w7VQk;15976594;2;31976594;16000000
3362;bc1q95t4p3ncvaz8s97k8dtdwrfnqsmfqlneessq02;0;3;3950258;3950258
3363;bc1qtqr508gcxltz9g8d5egewhut22cm79y76v9dv8;246780;1;246780;0
3364;3At7H7gSJGbCbU8NSs1xcbPWfuNpco6Eg8;2013735;3;10347352;8333617
3365;bc1q6qt6rhyv0kexqrs7emw0tveat6pfyt8u7060cz;6249648;13;90770907;84521259
3366;bc1pwr9n6h35qchyh9f87watugp0wgfje4xn5fqwwxd069yaapuwzmrs0gw076;2184;3;2184;0
3367;bc1q0s46mfsmz0wtdawxkur0ufgjlmkvnclgurkms8;260000;92;83575866;83315866
3368;3QnCwGdW6BYMvt7UeeitHPAnCv3k21eie9;1753086;9;7945477;6192391
3369;bc1p9vj8h0v2p3wzke92678ht0gjvvl4xeyv6sggd6xp8rgmecaecc8su05kxf;20000;3;220000;200000
3370;bc1qs22j537u5z4l28x8hry8vzl5g7vk6lwle4zhuy;85050;5;386745;301695
3371;bc1p0jl653sha80ye2p9cl0law7rlcjskvtwh5mxug6e5349n4srxurq8erex7;1000;1;1000;0
3372;bc1q95enntnhrf60flj9yekuvwg6qumer4zggjjmhn;103902920;1820;1291007019;1187104099
3373;33yCMTKJZKxqxqdimw1wTWmLUvehxb3xnT;191571362;16841;191571362;0
3374;bc1p696x8fghacjvkrprkzq60p82zmprfkxzv5h3d9fj5l6znx9rmehq6ueljt;624430;1;624430;0
3375;bc1qf87cw9pq6gqne650q75tmagqt70de49wtgcp2s;62538;1;62538;0
3376;1KUfeW4A9cYVdaxoXFGoy68EyU69g5cXPS;4956000;1;4956000;0
3377;15yv6Qj6Bs6aC2bZjhVkgJ8vWXF3NrtFEt;157010;1;157010;0
3378;3HZFCPDPdDxkX3wZ7YBvDNPUrG7mAjrM2r;621981;16;7700724;7078743
3379;bc1qjwfvp7e9msy9v8ljelcrewwm5uk4cqr5rt2yz8;1675;1;1675;0
3380;bc1qzlpytfruyfj7ep0wkpm9fgmjkrwh9w587hg3e8;6093911;14;96443616;90349705
3381;bc1qx7nvhmx7250v6k4r6ycedr2wt3cd7vzahnz4sq;173881;32;173881;0
3382;bc1q0l8655q8gnc9sprq35k2m7dfuyw5qg8mz8r6gg;10012674;1;10012674;0
3383;bc1p6m3020snmwp8ut587t9l50la76mekj5p5wuu7q5y3pnkdl237xfqneac75;141662;40;3776881;3635219
3384;3NUoGgka9c7HLQrTkNwPapRkpsQCheMsjZ;60158000;397;60158000;0
3385;bc1qlnxw3e2mwwaftgpmzc2rkrw6uyfam8guz7sjd6;1200;36;40800;39600
3386;bc1ph8zd9t46y7d5sh6n8hwr26uef4l05jf9gmfy9fq8lzkwfuc0e2dsr8fa3y;149400;1;149400;0
3387;bc1qa20z2dks8kyfy5q5tzv9zj7tvv44vgz6vhmhwe;210471;22;210471;0
3388;bc1qag3cny6tcgjs0ruv27uhyd38lrtkqvt3u9j60m;230780;1;230780;0
3389;bc1qmlmmxqh7t6ywxgg2nsnxrl3fgsw2eljseu42tp;837070;1;837070;0
3390;345GnsQ24sB873HHKpRvNUQqXb7E6W4GaP;35940;1;35940;0
3391;bc1qrh8nq6thdp740gqs3amukaankmt4thx8fkmfjp;790959;2;1596160;805201
3392;1L6HpViUzRhDTY3xBMGwyKhhjWtn4EQoPY;78427983;1;78427983;0
3393;bc1qjr242hcxnss4jygjlkmlqt7d3aytaj58we6rcm;6533210;3692;55029967;48496757
3394;bc1qmeq8djcljqgz8ysrfagnz3sjzvnd4j9ntlqv0u;945780;1;945780;0
3395;bc1pkrtv7h9m5ywmng50ustcvd8qvznzfs6w48rj0cyq9c0ttssz0yfs6k4zyc;1143275;1633;99320727;98177452
3396;bc1qngs9gzgp99w5yu9fg03z4kljy2jkgdazwra2x5;6246918;13;90735417;84488499
3397;3MDA4p2pCaGYH7vZpj4qMJydoRcF3jvjBF;1604947;188;1824278372;1822673425
3398;bc1q2rzln35xgpgs8ag4rjheyadmdequkh0npkqwz4;343211;1;343211;0
3399;3Jn5ymPsD2WcwCna2YqqEFusQWxbgXRXEu;20048917;14;109522349;89473432
3400;bc1p683y2y08yylfl5gqqnr4xdj59scfqwx85y7e7htk9uu6t5p3cu4qw97ned;25324622;37;190771510;165446888
3401;bc1qkuyj5xh6jjhhuhtvh889lunt5jetxnq3h0fawv;445780;1;445780;0
3402;33axxir1P7HVJuMef15qWvBqcR9EJqPQCs;449610;12;2594220;2144610
3403;bc1phgect3c5s3wegakpr40a6uq0ag5c7v08lqxdvnpzd4ex98c325vsdnk75f;0;2;12426;12426
3404;bc1pgccnqgg09p8u2m7k6gn6n8zwzg88wzyqwyvh72ypht38wgjlnr4qzr28jn;0;2;12426;12426
3405;bc1p2zvdtp8g3pams2m2ghd609e0qmkxq4pyf3g5v28te3q5ta2dh40qd082zz;0;2;12426;12426
3406;bc1q0zt66qd83cdrj8qudjaau2s5y2dj2w5xn2k8dd;8536199;22;216244919;207708720
3407;bc1prutwzwtnh920q8g46ndeu3utx6lctrzzvfep7em8ns25am2yg9vsfxhndh;21055522;990;21120368;64846
3408;3AaUHM3K45PX9Hgd3zGRLEGNew4BqSzAFm;14309131;2;28710962;14401831
3409;bc1p5sqswjf4ru6s7nz8y2d4s3sw54h5tg7g6549mj03vsthw4rq7vyq6z8qpu;0;2;19536;19536
3410;bc1qnwk2hq269pm6sfuqmfxgnvcs6zvxkjwzev7muy;6378834;12;84592917;78214083
3411;bc1plg2srx3vjqdwjn4t69f20mwmlfchymj6v440mgt5ds0r569vatpqh3e09h;11782400;13;66024954;54242554
3412;bc1qrsexkfcjxy65qd8mwn5lznztxfx782fwf2f5fh;2002471;5;9231079;7228608
3413;bc1pt8rhn6dm6amwjr3tlyzllvy4gtr7uzdenwxa2q3mz54m2pzpevzqkcm58c;113916671;8069;413863043;299946372
3414;bc1qpavz72mkjgu4jm0mz4lekt6tkf4euwnz2365v9;450330;1;450330;0
3415;3PQ6L6BMrc3NveGKSnHWLRjJTXpXKXHpL4;1633590;13;26670492;25036902
3416;3GHGfv3MVvd7JjMuwfAh9N6Uy1L1z35XvX;209732;85;12731812;12522080
3417;3ErU9ASKjhhrREiuNS53QCFjdZaw7iXzRD;911304;19;8763344;7852040
3418;bc1qeuwma5tdzplwkw5fp6fgsv59tcnran8r8wv6ua;376701;1;376701;0
3419;bc1p4k2psdntzguhjhwqp579cwhqsz8u7yle0dq670puhcz64rv5nqtsndrq3h;63697;61;13821229;13757532
3420;bc1pwpd6xrwefjxmr9c8g2ylu2hn088hsw4xq5ug20r6lsv5jy2v765sftmjfr;108270;1;108270;0
3421;bc1qzv8p7dazkuvyclgagm2qn8edjmupqnr5kp3ey2;1908611;1;1908611;0
3422;bc1qhujps2x8suwx5m3a27lfu478yh4kh6p0z0fqas;741583;1;741583;0
3423;1DbLgx71CQnUHJTF1drmsG9yLr4kooWohg;112748;50;20676843;20564095
3424;3Lszo4YnamdXjRHBUuLAErjDHF61izis7Y;133966076;642;2202618203;2068652127
3425;18jx2HKhpHZdXbMt7wYtVAWW2YRqnpCRHr;38909;1;38909;0
3426;39RK8hRd9v14qccqTdgqaUgAdqWXtc5DpY;2436747;56;12883402;10446655
3427;3PJLEHZTqHv4Bb3zjUqH91DnCc5wQNBsiV;336796;69;12003135;11666339
3428;bc1pdvzrcsxz84zmz6wmsndz5z2wyclwd29vx4zke7989t0fgllv95uszk78ap;712653;7;1645306;932653
3429;39VspSej9ZAxR6bZxVHrrpsFteBFp68GJG;1701287;4;4158958;2457671
3430;bc1p2aa2x76ez2zscwttssuk739erqcjmckmlyflxkq94xda0egc9zfs2gtg90;546;1;546;0
3431;bc1q0vd0sdmuth4dn6ey3h734wcmathy7qwvgufvf0;10639113;84;177289311;166650198
3432;bc1qpp25mfp0ynlfrhexpxaywj9ltk7433v099e5qv;2500000;1;2500000;0
3433;3Gbdsrh4viYHEEzXcNEfA3Q1BBhmr3gruQ;6177512;57;205631917;199454405
3434;bc1pccnzmcr0q56acqw9kde456z3hmzx83trq67cfanpa92awykrfgfs08g4u2;128484949;155;4164650621;4036165672
3435;bc1qj9ecdz4x79j6asztsnll8tryudnel7klhywutz;61147896;12842;61147896;0
3436;bc1phu3tgvnzhqzam2v6qu8gf39g9auzf5t0334ma0l7lwnwgerqwdsqpmm75w;0;2;18000;18000
3437;bc1qnxatcydrsyhmdm6gusna9d7v9fyf0gqz8xn02f;14864;1;14864;0
3438;3NYKgEvfLjNDt5eMaXqcX9CidNaoSCQpzW;12968642;191;56802572;43833930
3439;bc1qn05mrgqtrfztekqph38jw3r3k7sd7lpz9l5ut8;357557;11;357557;0
3440;3FXbD4Ze7rJVqgq86trEiUc35XPuPBS74o;22742472;13;104638714;81896242
3441;bc1q2nxf75j6at9n9ezyhggxse5gaucfxfkcdpzzmv;169971;24;169971;0
3442;bc1pds8hfpuatrd3jczu4vr8uzylsekxkh8s3mvgnle7j4snsu386ukss3sjp2;4180272;10;4180272;0
3443;bc1q0rzjnthx9s2xauwk4tf35aesa5tft4um8h55vw;543080;1;543080;0
3444;bc1pcnr3rrqtwjls9g3fflxtstmtcvw5789tx7ajdu6afnn33m5qhnlqqhcygn;10000;1;10000;0
3445;bc1qpx9s9x59w4zz6g7v82uzl68dgm8kdq5pk5u7fv;291430;1;291430;0
3446;bc1pdkdavnlad38a8lqjhu4cay3x5uha4a8lkga7k974kjyulf9czn7svds50j;0;2;20000;20000
3447;3M4NP8hNB1aTrkEdCq4vvAkP5KRjCX4DE6;1435840;53;67101950;65666110
3448;bc1qnrcefv0dkjp6zu2thr57f5x3ydfefd22uu35ax;58755;1;58755;0
3449;3Ke21osfhEbEryUeqdwAuAY8VKxm5B9uB2;82171421;6315;166307381;84135960
3450;bc1ppakskg0hml8kaxv3er6mjgrs2nu2j47lednwu057w5fxpjtvdpysmcd47k;65000;3;140000;75000
3451;bc1pquz62anahzfwnqf9wagynvdp8hv7ehy2agxlgy72h0hxs058zqfqk8ksyq;25163265;105680;328876643;303713378
3452;bc1qh0n5fpq2a5p9ztzujfdk5s7h3ra9rzadvrqlt4;160805;25;160805;0
3453;1FWQiwK27EnGXb6BiBMRLJvunJQZZPMcGd;73814751578;158502;30168142652965;30094327901387
3454;bc1qej4wgeufx5gzug4ccfh5xktg592jj3regh74tv;268823;15;63486716;63217893
3455;bc1qguzk63exy7h5uygg8m2tcenca094a8t464jfyvrmr0s6wkt74wls3zr5m3;285145689;898;454459689;169314000
3456;bc1pg4m54rpn86auzyarhr44u2ltkxp6c82qvv4rsrqq7rse0l3677gscn95n7;8770;4;8770;0
3457;bc1pfwteauerre63tlve3lgpa6gsgj6pjk3vp6e4mflunggtyujs9xgsraecxp;97568;70;126300;28732
3458;bc1phkk2t5z9m7zmfx60386dmahvg9wd8zrzuvmnp4xphuhpcdppkv0su8edmf;2427212;543;111790993;109363781
3459;bc1phquhskvkfpquc2h7zglgvwrelwn5aypsmq7uyeqc9njlx2398wjsdymfqu;16987164;371;286931723;269944559
3460;bc1q460jlmp03er95j6lj0xpwv4mhhaxru9l0gdqge;695780;1;695780;0
3461;bc1phr703gtgf8qm85mlv67kt73u598lp0mqy7sqyl5qcy0ycyxxduxqdwcn8a;328677;115;14966444;14637767
3462;bc1phckcnlwafjsr9y0a86prfxyl00jzlc346xnuzkgkrrfgw0xdyv6qguhsvr;996699;1160;252762306;251765607
3463;bc1pgfxnklvyddnsscdltl9a0c9qa35pv25rtjzmn094r58ehsu8s6hq30pugf;2443409;9;30255741;27812332
3464;bc1pjaxc2hl46uffg4ss6fh8z56qyyn92prj7smj42ef8um9twytdr9snct597;66234;4;816234;750000
3465;3PAtH4r4TLGF3KnjdSPg99EKEnFN3NZcxs;5956260;2;11956260;6000000
3466;bc1pg7zwzdadj8yv9q0lztn3jpcgf74v0zuhnhgk630xmsd2kmqxvnwq52kypd;75360649;2517;2203273838;2127913189
3467;bc1pjf8sje3n607lq97g88h32x7hca75h4znguafcz6lycws75gt6meqwv6fmk;14538432;23;229405409;214866977
3468;bc1pg48qketyhsds3sasp6ulzn2e5ul5utulxjg7yjhyuz36nrgrx9usmq0e32;8104;3;8104;0
3469;bc1pep66szh5cd5quq0enlj5uz26lkdn6u35zg4gpjnksyrcfpy3tp6sxlgkcr;201526;48;4241785;4040259
3470;3B1EysJcYTNuR71YFvpUFyd6qW2twfJBqp;1147064;13;15106159;13959095
3471;bc1pghtrmnayde3jamr8zgtuj9u4n332zeanfaj665uv0rvz5h5ydcss5e4g7y;852722;45;12951453;12098731
3472;bc1q0e3krqe3shpfstjrm37ln8knrhp79z7jh79xa7;285780;1;285780;0
3473;bc1q30f5uw5x4cjt5sntdnf4x309j5fqjflktgec4e;329780;1;329780;0
3474;bc1q2vh402hfp5222dzah8ndmhlxtn2m4mx4twg685;945780;1;945780;0
3475;bc1pfy9ycsue6j6x709hjphrq40zegw9fkwql25ahzzn29aegf525rksqs9dsm;258235;273;153256031;152997796
3476;bc1pfmfejxhydkv55mgxv45tlaqd4lna679hrjc9nn6u7y6mm0gsk4zqu8cneu;52158;134;36190558;36138400
3477;bc1pfltx3cl03d2gve9v425jh96as6zjdyh652xtfzxntqegg499t5vsdznajr;575776;661;71184844;70609068
3478;bc1pgdx4mruhjrjah9sp8mga2ya75ewafe4hhrrszw5dd343nks7khxsejq0xx;101488;114;20881865;20780377
3479;bc1p0xwnsd8myjksp6uq99cpx2rgddat3c08zn4xtxjvkqxfrgvzexpqsrz2c3;30000;3;30000;0
3480;bc1pev88ycspllvujtyf2uwl94t0c9n2rzpm8z6nuwy2z457pa8n84vqcuxptl;8770;4;8770;0
3481;bc1pfsnzxa64gt88q33ffqdjwv872zecwkg3uehe377n68ty9apvamcqgwdl08;57546;15;551826;494280
3482;bc1ph3kurhlk5mguxzkxpj2wzsc2ejkkztj9f6xrl099lyn38q8uuheq58zur3;1422;114;133575101;133573679
3483;bc1phuamc4xgkkk0lyz7s2xvgq9fhlpszr7770tndz59jskxnnmkelxsmj86k7;348277;48;20136347;19788070
3484;bc1pghjq8ftjk849pnrwmk4s6k45s0ez6m0tusxhlcc6evq2kjzlmrdqnrju63;90321;15;1277900;1187579
3485;bc1pj4jqhadhz88wh4mvjukmy0lexuq8hdzjart6nlyjknpljt559tzqsfmurj;1123321;1543;112879948;111756627
3486;bc1pfe36ded25fd0gcg6297tq2vdfpf0u9myn2zgqkyhxw0cl6ca9z3qhm332m;140071;166;234614380;234474309
3487;bc1pf52x8gts3cfv3mnw8xy9mcdatgexmw6vs3jf63ne2xap7dhccxxqnhdlfj;192304;8;1396972;1204668
3488;bc1q5gp3fgzrpzdann4dkgn7y6f5ngcxlepagvkhac;66889;23;66889;0
3489;bc1pj2mvnmy6m2yfq3d6f0gp36mnwva6jxnn6xufypuhgzhhlghn6pysrxyax7;74476;6;845084;770608
3490;31rAt7ktUADgvwRbzanz3fZNu31bqCsRGK;3105762;2;6229344;3123582
3491;bc1phya7lne2zkwr2n4h9ptr3xt2y87ff9mj8f4cmkws7pg3jc6gvs5q20fney;519265;127;11816974;11297709
3492;bc1pha6cep4jfpqrr8fnlkzh2yvt2ptz4pc36q8nntasl7j99uvkq8rq78qchk;90428;6;344756;254328
3493;bc1pgzlfveusa3zv2x8jnm92vguaxjz7jeezxm4ntv9acf76cunt768qckyuyt;138612;10;3772343;3633731
3494;bc1phc9xwe200kffrtnwxxar43w80hcftt7rnxqcyqmjx54rm2zeuqnq858lma;101687;37;4823096;4721409
3495;bc1phfvrhw3c0z3vq6c528u8mssw0hf0pus6lwul49j4mv3xwz7lwgtqqspn0n;2115550;156;5744515;3628965
3496;bc1pmz28tyvrmm2c7rs6k5g0nwmtrdw7z7gz0gluscdec04z3jz2hzqsex0znp;185601;7;4133264;3947663
3497;bc1pjawf34fwev7mfa6pr9cecq43vk2guev93akeyr0tsl5js9j0rlgsvwew9e;2201877;161;204021815;201819938
3498;bc1pfz75shlx54t93s80fy2eyyghulwn9mc9f4hd5jmgjzstftmr74jqspycx6;315772;3;1515772;1200000
3499;bc1pez3rnqhjk3j56kqg7wmx8hk2e4l2qjakar9uvrekdlc0wza4f4jsj2hsgf;112562;3;1117822;1005260
3500;bc1ph96fwvlm0yg7lqx8v7g9t5uqd2qa4lvwut7ntf7q2t96cw36tq4qr0as8h;175375;41;9015326;8839951
3501;bc1pexpewuatfz309uwfss0jm0m247q3tl9qa6dzuqs7vrtmlm8cqsfqxy8lry;195062;223;83426962;83231900
3502;bc1pfp6r7r9ev4gpa5qk3gxkf0ef0j9yhpjvy0p6q3c0env203pmlqgqujmj8t;6692692;263;168807514;162114822
3503;bc1p0u683cc05ch5j4ad6m2kw7z39299z5u4gn0zr7vpv44ju5dq254smmen9e;32858070;1;32858070;0
3504;bc1phaz23nq5a9y0q5czatgaage67wxu2ls2vxsv3qem3lf99plfmnrsj3mphs;41878;38;97338;55460
3505;bc1pevq727ch36eya49mct8a7gcvef8renflecwlh6pkzcztaz0jeggqnaqcnk;1037308;331;51362652;50325344
3506;bc1pgghq3u0h8r36hgswxqwgzlj6wxg7440y9fvrdtzr9tj7lpat09uqhqeucl;546;1;546;0
3507;bc1pjq8fyw0xcrmayq44t667gfpq7rf2xtq9f7j74gukwmh6dxdcwjzskjxxmm;1000;1;1000;0
3508;bc1pgwlwhvh3tlcaqvfdla6cdx8zuw3sxf0sydeypnssum27p7sktyuqary0a4;260590;295;721936536;721675946
3509;bc1pfz4rnclwyvzj8aff3fg69ht3te9km2x4nahlulxs47vev62h0ztszawsr9;790404;35;802402;11998
3510;bc1qelkes025am7l0c5qce5ysynjkund7dfvjzkwcy;30445;1;30445;0
3511;bc1pez46gjedpcfdhjdye3teeuz566k9gzxcx9upqtmnn6j3ckrtamhqg2srhl;12620413;779;475793699;463173286
3512;bc1pfknkwqzddmfqltnl67mwxder99wwk5ntp29gn0930p8h6dhjamcqqlyal8;5431952;636;214804539;209372587
3513;bc1qwmue23fnrgw0xscltp9lu2sf5nvjr7tcc0u0yq;281780;1;281780;0
3514;bc1plk3pr0ek9svkkznt0purwff28qfrp3h0g9h8kjp2n53tkl9zfv8sfj0edy;10000;1;10000;0
3515;bc1pj8yvgganz0v90wjekfc84fnsch9v3nwd5l8rcqlud7dgtd6cv46sfaru9t;8244;42;8511004;8502760
3516;bc1qzucyjrysqmmw6j3t3aucjhduy9kt820qrq2jxj;605780;1;605780;0
3517;bc1pg3hm2akr5qrwm9v6ycagfg9kcre0azsdjq9wqkplgdt32xn0vkjqrwm7vq;262444;186;396219;133775
3518;bc1phk5gfwyws9zn303mcl4ptj9rgyxq6ltd3ll7aju0y93rczad7kwsnuxceg;111700;20;2372372;2260672
3519;bc1qqepp9x72nqfjyyrwlhk6g9zq05p9u26fvpyxfn;2118788;1;2118788;0
3520;bc1qjr242hcxnss4jygjlkmlqt7d3aytaj58we6rcm;6533210;3692;55029967;48496757
3521;bc1ph6y0yangggfelr0s0lvn5eagm5tw0lsmv3kgw3hs07d7wh07fvkqn7uy9z;154978;55;6337535;6182557
3522;bc1phav72mngw7tu9yugt32nylu470ue8wnhnam77lhqvlk8prrfgnjsljmze8;371333;13;2549982;2178649
3523;bc1q60e99khfjn0a28lryxs542nrkn80604tdtekag;278071;1;278071;0
3524;bc1p05sz6whc0p36ht0n2j3zg08wx80f720rfdf3a5ltshtf5hpvearq78z655;3276;3;3276;0
3525;3EzFqHBdfjqdEbsqYQZz5LKzTJC2Zat82i;4277351;22;21020014;16742663
3526;bc1perjnyv525zlszp8v9g3jmmtf4zhw30ucd6ysap74escaedzzj07snatu9z;1315275;1396;365873164;364557889
3527;bc1phet87jn97un3jyu8r54cuxu7lrw9p5hc53nvjyfptq8plge87z2qg7ufnl;4955768;1729;527492545;522536777
3528;bc1pfkp4xuwnms5ylhx78hkffve3r0w3v8tf3nke3dntp6xvxd4szueqllrffw;1655540;2667;1192899941;1191244401
3529;bc1pg4y2w0yydkwh29amcw8aedu22j4lzjfcseykudhvlr3mg9nv4xqsa6uzmu;1780525;25;8960439;7179914
3530;bc1qjcjl3d0gpgce963fdr55pzsyu9v2ulup70aap2;945780;1;945780;0
3531;bc1phts6tj343crqwwvl7e3s4tmy2c00tqhej7ugm9ml56umce53vtaqc5mpyv;182464;225;301497;119033
3532;bc1pgjv2rwrs7sqlaxwetnkzepkyefwy5mwummkhfp5alkrn8j787ydstughgg;879;2;879;0
3533;bc1ph7mm423894lczkyuw9phazf93x5xwuhp45z5lwh6sr9v2jcna45qkxa227;14091;7;1067572;1053481
3534;bc1qsp2ut94qlau2skx873223uuruecm33lxfnphfz;605780;1;605780;0
3535;bc1qqlj20wj9c40y7y4xx80z8a0dntfk55u8p7xcva;954780;1;954780;0
3536;bc1qtlr79sf4yk388z9u5q9q7287pd0lnqyul70qkm;945780;1;945780;0
3537;bc1pf4k5y7996m6ejpyn7c3xm7nnr9k05zn0qsnwnalqrn6apkt6w6lsdxgs2f;20315185;200;2662171929;2641856744
3538;bc1pgq9l72p3ht7apzvtesz445u2fd903s4x6mnpq9xk3eqhjzpds79q5a79n2;86914;48;667043;580129
3539;bc1qh3hkr5yyqlr8pr2yp35xsxndd3zwesp8xdhmd8;1206392;1;1206392;0
3540;bc1pjg796gdpxmkwfdhgze52acv058r8rc668jremkg6wyudmp2hh3dqmgfc0l;93969;28;9319017;9225048
3541;bc1prutwzwtnh920q8g46ndeu3utx6lctrzzvfep7em8ns25am2yg9vsfxhndh;21055522;990;21120368;64846
3542;bc1pyld96egmmnsmmsrhjavfphzl3mr8ja7v6tkcszahnkyysdhsrknsqls6r8;1020222;3;3110990;2090768
3543;bc1pg2dntd7crpxzvwd59nxq0hd0htkwyjcet4etgteelskqfvv3g2pss6ahln;231644;16;5652366;5420722
3544;bc1pgr0qr8fu3h20rkqz869xklm70zrv0pdsvl67tt2cd49y306upntsqlzwy2;467559;27;5819436;5351877
3545;bc1q5jdvq99zk573hwuarzntcqs7ytrc4s4sj8k2ml;501953;145;9937609;9435656
3546;bc1phuutlnn9up7zhyqtyydm2alf27re04pf8eduerk5vjjl5szqmx8sn4hsyw;18548;5;18548;0
3547;bc1qwr4vd0y3086ktwv7h8tr2qnp5938n4ekctjrfe;695780;1;695780;0
3548;bc1pfx0e32k8shasv2yax8p9l2j5cjnxw9mxfy23ud68ngpn8jllg63q3mf90h;4790216;1241;403820751;399030535
3549;bc1ph7k6kulyrh9j3r89suq0j25jf5q69tuves89l09guv4t6f3myqnssnp82w;167100;32;5441548;5274448
3550;bc1p4j52u2xs0wzdzqmp9mkmg492xwxxcf2l7xg9e0scsjmgawuxz2rs20qnej;10000;1;10000;0
3551;bc1pjf8esevfnzjrakcvgjt0jrhzhcwqtgmss9jrpdar3afd9qy2fpfqul85nk;436265;49;7060540;6624275
3552;bc1pgk9rant2k8mkkrjv69hzc7sg7meeu3cjtfgwysafh3dg2lvykylqrdfzt5;2136505;146;36058816;33922311
3553;bc1qgw0df7h0segckt80eeguymlkrsm7ac46xay4tp;46074288;283;826229644;780155356
3554;bc1qrpgvq39mm9fau7smkp564aejlcewjp7fea7x82;645780;1;645780;0
3555;bc1pgtvn2x36533j3tgfatzehd0zvrnml88u0axmm0z2e5u9kwl8852qwccmtn;546;1;546;0
3556;bc1py05p7ad3rkdahvu27mxuty209cjtd4hw6c7nam635qlmse96xvdssvcw7v;0;2;9038880;9038880
3557;bc1pgct0wytprak8m07z83eupfl5nsv28tzv73crnutw8py2xq29qs9q9kglfu;48647;40;16898861;16850214
3558;bc1qzsxhpuwcjq49nlmhumwy9yhp7l5uvw53t2z5kw;84812;1;84812;0
3559;bc1p7scpuzkjcyysguru6h8s435llupvucz6wu5thaghdzhthzk8fh6sgmz9xf;75800;202;39525129;39449329
3560;bc1pequqjzwx4j56pp34z5gh4dasp3pcfnhmcpuysu4yjlcfgyzc0kes8cazus;297968;14;1418694;1120726
3561;bc1qt6rpll0mhmjjwgdyxj0gkw8dhv6mt3e4jclxkf;170550;1;170550;0
3562;bc1perhhtj22w7d2srq2wmrlwlztzkhx2aqutarj7k0gsfvukddfqf6qfdk407;55238;19;708838;653600
3563;bc1pexe3urzuy0l750l9nhxjrpcdn9wxtmqgfdgkatkfq9avtult3ywq3xnkxn;1598518;173;184242439;182643921
3564;bc1pgay2tk7gu56tgae6wkpyw09396fgsutm2yenjz3z4zcss60mww8qren7fc;314540;4;1314540;1000000
3565;bc1pfw6xsngl3g6szxcnp77lhfrgzv34drq8uc9x767d79g4fgckuzmq4nlhxy;156483;84;118781425;118624942
3566;bc1pfqf4qkxvw7fkssqzgsnn4qy7njx2g0vuttauvdmvgv5xaxuspfwshur4h8;546;1;546;0
3567;bc1php44ctcjd9jennpg0fq4xcj8kc4njr2nqentxqsgk88ay9sgvu6qjhq38y;8215;4;8215;0
3568;bc1pj0gc9kkwn5zpmt68a7g25nyprv47mgk4jgv2fhdvqpjh75aj9tlsv9kvy8;684177;18;5750662;5066485
3569;bc1phet4k5hyvvm456n5fgu2g4xxtntwyfwk0wuk9p289pt5uc3qprmsz7guag;4425469;389;288736653;284311184
3570;bc1per9xxlz6u6qqjyhanf6sxn8p32mflcnccht8ngsfxjcrveuu4x8syau8fc;9843;28;3491386;3481543
3571;bc1pfyrl8qwhta94lurmxkrfledd8548uldwjmg46q9rjtchhphzfh5q69sl96;108492;6;209038;100546
3572;bc1pgp4el49mn5ww0u4flh9yu06karq9vl4yprasznsnkrp7wxsp2essk6vlfc;1136631;24;1155494;18863
3573;bc1p8xpqsvr2dlp4rurfr7rnpud3dc85ckf9waahnvadkmzlamld74kqggurvr;1000;1;1000;0
3574;bc1q0jskstllg4se7smgch07mvnwpcf2eksy6q649s;481780;1;481780;0
3575;bc1pgv9vc2z0zkdtv4a24pmw0ql2n50km5p2k84l3s88ss0x73ta2hssrlgwcs;546;1;546;0
3576;bc1ph8zmjqfvtc4mengyclm9m0n2j6yr6jhfk7zpq3dpf5d35jazcxashq75c4;10704;28;19790;9086
3577;bc1q6amlu7p5mwpfga0ycpq9gsv9j3mjwcqlxnccky;445780;1;445780;0
3578;bc1pnv4yqc0c90ql597rav3vgj40vhn76w98ezjl98ra4jddw4jv9s2s9h8s57;600;1;600;0
3579;bc1pf3zf47xv0dhaqhdx0mg09ul2yxw6p2vjdjw6zdu3yhzt7hq663nq03eea5;4961534;141;56361057;51399523
3580;bc1pjfx5tl6vqz0a8v5dwdv6x7xfrvtp4allvtnnxhgezztn79u7azqs3gwd30;206445;73;48833440;48626995
3581;bc1p3yy43jq3d92hprp99lzy2la6cc6xvq9cad62nftul7l92z95ke3sq8h3k0;0;2;19000;19000
3582;bc1q88je7hkpte4r83j8zz80m7jg7xc6sg06asqakx;254107;1;254107;0
3583;bc1phq076q9umqqjwlm4dgunr9frzd5j0lzylza6xv0yztkxc574whmqgmrqsr;150903;50;79957301;79806398
3584;bc1pepmhcfz9ehme5c0nc29y4xlgue4vmw55dts5sryfytrj7zcvrl5qcq78d0;8215;4;8215;0
3585;bc1pf56da5vqdj0tp0q20qwlup7pf3ndujjj54psvrwrucv55687juxszzzfdd;2776467;282;202981816;200205349
3586;bc1qckcxju32keuh5k8mqu9yz8cnfpcrmxpyvwmznm;4445780;1;4445780;0
3587;bc1q4twmpwammv86g59kmhnjp80zag7ahla2jlsnne;415560;1;415560;0
3588;bc1pgjvctxj4z9nkrwjwv3k73rvree8qkje7g4cpejt48nkk32044pdstkwfhj;2165552;378;208394857;206229305
3589;bc1q35vvarwz2h7vhmksxzjtkk6mu0n4ysc8cpswjd;428814;1;428814;0
3590;bc1ph3x9ncxh5lcu9zlhswqcv30vyfq0dnrnm037z7n9yxnec5vhce5qx4njjg;6604674;8575;1585220727;1578616053
3591;bc1p77y0773gwqt7mhlsl2nwnds9us8kl240p22j4vf337mkwndme0xsfnw9uf;133208;64;172600;39392
3592;bc1pfkq4eay7ht9q0kk0vnauwzdpg3ja6jmnxg4nazlsg78numdj3ufsxve6s0;841672;57;7560406;6718734
3593;bc1phjyagq98ur8p5pefsgzynuekupap2j9w89tvd4fecwpclkusuhfqmfcg34;46160;40;49369358;49323198
3594;3MR3TLJnh8dCfGT2WFcn5Aemy1WsUmiuyw;4967780;2;9967780;5000000
3595;bc1pf6mwsw8hpye6mlntqjldnmsey3s5fd0k5lq027gd6chwwwsjrnwscs7d48;10477281;2559;1767878995;1757401714
3596;bc1pgr9u94mwupcgtn8jyznxmdptgvdq5nyzencemfh53lv4k4ewyfksgtymw7;386290;75;50548885;50162595
3597;bc1pfg80twqjmn49ewc4m049kw7s9urnxsh07c62m2rz9ktars57mdtss07ncq;67630;24;44104381;44036751
3598;bc1phtaqxdxt4skwgjn03vut7psk76swyg9u6r9ftztg296z8f3gnmcsn0rakf;546;1;546;0
3599;bc1ph306szqslcgehs2lagxewtgsg3u5ny99jl2jpmp9arrnh3elehdsa6pvl5;546;1;546;0
3600;bc1qt30u038zw2h3zy9n26c7ymnt3tj3r087cxtufy;695780;1;695780;0
3601;bc1q6nmfsm98el6dngutz6c4chgdgfgg3xmqaqdd2s;713088;1;713088;0
3602;bc1pfuqv8u77fz2h0xrhsrnudca8msq7esn8g5amryn6k4gn75uvssrqkwz5fm;24375502;100;144049914;119674412
3603;bc1qd9c4me2rdtg8ge4vd786gp3jsp2rfpr8uk9z2p;281780;1;281780;0
3604;bc1phxfp7a2x87jyqqsvwvyvqtwwlsfzqke2gzwuc4c0hxaqy99dduwqkdz0wn;141477;140;73090491;72949014
3605;bc1pgtv7x78m8v0qdcasunt9ctycx5l89cym4n2nfv8dg6xtpl9s6tsqfu5rdj;669762;71;24524097;23854335
3606;bc1phn8xm3v53pfm83wg7sc7500uy4r7gallmc2nppcdkx22vvnuwhfs4ecp7l;755495;147;55969759;55214264
3607;bc1pj3hup0fyk8q98j9wef6z8m3j5h00gvkkc6txa3p3z9mvvfcuu07snull27;130222;34;990222;860000
3608;bc1phvcd2p7l9rm6s7y5fm8q6sc4uf38c68fdqrjw4jya2tmy9s2jy9qpy4ld2;2837606;343;364321935;361484329
3609;bc1pgr78nean6zvjpmgs20cvvuy0s3yyvgd4005xeldny8k4hvkypr5sstcy6l;35750051;7916;8481340390;8445590339
3610;bc1pesku0f4a77dukfd52h96skk6epuq8p6wtakte7wg7flq6un38rjsyhd0sd;56780;4;806780;750000
3611;bc1pfk6wvc5lkkn0av2eudhjcppt287uhpq8p25urv3p8syurk45fxeqge8c2a;133593;176;71737233;71603640
3612;bc1pft0slth6gflhg88y45f43cl8jyt7zykma4raemaszjhd0z5erhmswtjlet;5755;44;20853;15098
3613;38MbMe9BFV37dNPNePhzi8cpdnu8bnbDyv;6572214;6;16875028;10302814
3614;bc1qthhsq0uztj0ff2nl5g4xepnt28tfwym8nedyyv;156540;1;156540;0
3615;bc1ph4tg7k6jgdsh7rhag3ycdlpskszuazm67ju8lv9xeqq7g43pyshsgqg5fr;1096178;2411;187368015;186271837
3616;bc1pfua3hrajng927jfdnr2yc77adrnu3erzf5nzg6ndp5d9d95kv6aqfp82nx;942921;39;6074916;5131995
3617;bc1pjjw4wwx90djjuyfj5asv2prskxk9zv7uzvfek838gcjy527w3xmqa4r5yf;497407;59;2891656;2394249
3618;bc1php206sh34clw28fgcqry7gvgx6gmp4d2kekjm25h4rtwr0r5252qvecnsj;434441;51;18915178;18480737
3619;bc1pvhnz75vppffcm9k3pvm7sh7hh5nth4s02dx0mmzn0qslm8vuwy9qtz3nax;76379;48;76379;0
3620;bc1qehzd5ly0aag6w05tc596kn2wg6eyysfh6efnmt;145890;1;145890;0
3621;bc1pgepfcta6lazvetuvy632d6gm38axes2pehwf7k4mjagwylzxz3dsdveuqj;737772;17;98697349;97959577
3622;bc1pjdrgvetuxkdgvxjs8k4g7spk56andpk4adtn7jvrm87e2tlray4stv807c;187174;105;8119044;7931870
3623;bc1pjlxt7z4v9nflxg79p86x9kvct97jpzv3g7z0aed7v9r99ux9fkmq79e0qe;546;1;546;0
3624;bc1phxl09939wy474uuqf9dnyvurhkjdpdt0uwxr5qjayesc4qa76m9qg8tmn3;546;1;546;0
3625;bc1pg2xng5sg42vyzdfgsquqv2pm6u7mwpkxgxhhde4jn85z9caf42xq0qcjjt;515617;5;1454215;938598
3626;bc1pjnnm7hfkep9tw8qrcgvd445wnzrxxna4pfv84586yhalruk9algs4ck7ph;8040761;514;557494683;549453922
3627;bc1phfvn75xvzf0vlntre5wp82f2qhy6anpny3d23u9l6jrm5d4ektwqsts7kn;5336;16;171727;166391
3628;bc1pj2ytgzgu8upgjdh6z4a6erre638s3mur2vpjnv3kpxew4zt9tgus05lk5d;1022803;32;49817250;48794447
3629;bc1phkztfqt7d94fatt5ypz59gugx2qqe7gq3uywewdpzx4a0nrnujpqehhnu8;23571;234;31255959;31232388
3630;bc1pgw9j24fv4d7lpzyljl59y60d38jedj7k26py07ghdaveqjk6vafs85a4dd;381859;87;16803051;16421192
3631;bc1pquz62anahzfwnqf9wagynvdp8hv7ehy2agxlgy72h0hxs058zqfqk8ksyq;25166383;105681;328879761;303713378
3632;bc1qej4wgeufx5gzug4ccfh5xktg592jj3regh74tv;268823;15;63486716;63217893
3633;bc1qguzk63exy7h5uygg8m2tcenca094a8t464jfyvrmr0s6wkt74wls3zr5m3;285095689;897;454409689;169314000
3634;bc1pgcym6s8m6fkzcka5cjqnwpjrqesf3suxkm0arfyhqqdfz9fnww0qvlm4k7;8838;5;8838;0
3635;bc1p92ys28ep253sverj7cwe0rkp7wty5u3yn8tcrga6a9knhwnsjlxswnf0mm;147980;3;494264;346284
3636;bc1pj42gct2kmfuju4v02anwrxq6rngxu6cwk0tvxjkfv92anx264ahsa87vdz;254270;23;43907990;43653720
3637;bc1plc6ctntmewmqhqcege9nletdkyhkmfkjq69t3knlt6wyfm5k023qp7adma;116236;6;216782;100546
3638;bc1pk0cchyw7f3wnxh0875hfgvqn730euf37cwt95u2fxrlguqu7nzksq8smvl;91993;117;1937035;1845042
3639;bc1pkxue5q9a3m8va2e8hw0lg38943q8p44gquuanu4dggyhvfys5vsqknwudc;546;1;546;0
3640;bc1qrf9q6qz6cp7uuqg5p9y2ee0ew0k5t250xzec99;945780;1;945780;0
3641;38bGFMd7Yv7ELFAGstgkLFwqA8smDTdAXz;3927982;62;178718002;174790020
3642;bc1pkpjy8m5q9uhjt9p89ykphla8m8wgjcwp0rraxwzxvr2lv7cw90fs9a6j22;11829902;567;12247536;417634
3643;bc1pkvtncuzrzcgsckruh4dwvlagzr0jv2hcale2hn9ecdsxntsyrzms9gm9lq;143932;168;962962;819030
3644;bc1q4ds2gj8mqgy4qw940l6cyv9wrdsaqhhsdqgzt3;1597386;3;4826178;3228792
3645;bc1pjscpk3ue4lc43yzar6pu6vaklnmcwk9gdfqa2ed7m86jj8zs2qsqc6y4gp;240997;27;1932595;1691598
3646;bc1pg7zwzdadj8yv9q0lztn3jpcgf74v0zuhnhgk630xmsd2kmqxvnwq52kypd;75360649;2517;2203273838;2127913189
3647;bc1qrshfplcm9vc458uyetvf6wwnt8kgdulfy2l4vv;212100;3;670320;458220
3648;bc1qtkxml67f6p6s6ve98rxu0ajmaj7pvnyaelfec9;680338;2;1372016;691678
3649;bc1pk9hexmr66luz9p4anwxdf8cly7jtzqzzj7u5tfehu4lpqcsuqz6q2f3lh2;163982;284;176992;13010
3650;bc1pl48l8jthsf5hzj8hjalpnlumcx6udexjj5zew3cgjzvva4wgtwwscuqee7;4667378;17;54983102;50315724
3651;bc1pkakukyz0kr9kzsx9m2z72m9r3dv4st79kq7qlyrzzx5t0uznnx3qs7ecwu;314377;128;41327622;41013245
3652;bc1qcgr49zqszt779t42x2435wzsces9l7lmjh4sf8;634440;2;1280220;645780
3653;365MbUwatcUKka2iE5EtqZyqi96v1hAm8G;3402544;39;24518564;21116020
3654;bc1pk75vs0efvwjslpwlcsfd52wytmpv28rh5hqf3czjg2mcxcluws0qe2h6w9;172749;14;23856679;23683930
3655;bc1qzz9fnk2swcclvd2c7zvxnv8acxplahl00un56g;281780;1;281780;0
3656;bc1plcffl9s06sxcecwa274vn5kvakul2gngpeyxsg5v52zsu9u7my9sf54fdf;723003;264;104055446;103332443
3657;bc1pjqxjek8y2u3q27ne93vv3urlz72gagtqs5rjynpq54dp8dsenngszajfvu;65618;4;815618;750000
3658;bc1pr92pv5850fn00m8h4v88tkfqnxwvl6nezcg588n8e5rxnz4j7r8s7wawvn;1000;1;1000;0
3659;bc1p72ne4359syneuq2v63zmaz76n45u2ry6upy63wvd53gvn9c4vywqzsl75s;217573;193;323805123;323587550
3660;bc1qcnn2m6mdfefc4qj2djxwfjt7l20xfjz30khjf5;157394;11;11320596;11163202
3661;bc1pksw2uetv653xdtjwj9euhydlvp8ptd6yryqkaqmlahcd20jmzy2qx2v28k;41670;14;5354494;5312824
3662;bc1qe4gqhfkjevwd3f46sw6f8r79j9xyuypgrdp7sj;623100;3;1903320;1280220
3663;bc1q3uug3nh25w5jt4wfq36pnjyec2ralcm4ncnzvm;0;2;281780;281780
3664;3NKN4WM8vifmifaLdf1g16nH2KVH6sZqMK;186006;3;586006;400000
3665;bc1qq7d3ev6cw2vtkzs8kklprdcvn32f4359jtdhws;235440;2;482220;246780
3666;bc1psaw99p96527dn5v85jtm0ksuplr0f086at06vtqnn5muwfu9rg7skp3hyf;742116;1290;181806825;181064709
3667;bc1q9zjepwyvav288hf64ymwse3xwwwc0s706c0022;162247;2;335834;173587
3668;bc1pljtdye7pyr0u35u8ejvfhp7ru836xv8k42gn2zdy2559fpuek4zswm3q6e;3127047;17;13635832;10508785
3669;bc1psspz7czs8w6g8gdvksf34pvvfn03duzjgz6jt9e9y3a3jsdz7y0q774at3;226385;183;432523690;432297305
3670;bc1pc0xyuff9awx9g5ma7wn8h98e8u3cyqhaumcltp2fqjlhkrcrmyrqjupzn7;1991270;2;4000270;2009000
3671;bc1ps2tnxhh8nw507lu3t2e4lx35nv38pxhsvf0yuas6j0teta7rtf7qq7r2h5;63887;7;707185;643298
3672;bc1pkvke9f60282a8rj0rhezxrm8eyfzmm4hwllshnrn8nfzjtd688xsc64qdy;6288891;137;317260732;310971841
3673;bc1pmyz9elwrr58p63g9fl8cxs8fkgzppu6234kgjknn8yhd0ya77m2q4ypadq;405463;5;1148747;743284
3674;bc1plmzsst5cczqclpyclz4r0neyehvw00f3pyctyklv70e09gy6vdts45je09;526178;608;23428202;22902024
3675;bc1qcwnxpkv3jy66gu39g549u9yqmytjq5drtheyrc;307100;3;955320;648220
3676;bc1qnnd5yttsapcj84sngz5z7utwtjmcc50mkm2v45;923100;3;2803320;1880220
3677;bc1p5m633fqgcz5h3e3yq6fmuwt0hv84k3vpkaf64xr7qj4q6cp6uwqspg5ygu;646856;44;16198988;15552132
3678;bc1qh5mgz2j9rs95mcx002warzj6gf9zcugd9fuuvq;37109;20;37109;0
3679;bc1qu4hc76jacnm5kn4h7p2n52y2wfhxf0w87muh7u;426689;2;864718;438029
3680;bc1qhn7wrns47q7ejugcuqjk3vckqck5g7jj3d2p2z;923100;3;2803320;1880220
3681;bc1pjzd7thxgkn9uc5aj4vczvd8h76v3ld55hxcpz2sc6ua9nfx3d9aq3pvl38;752484;41;114801583;114049099
3682;bc1plr6925qdq8qw3pyfs433jyf0zm9gm4lxyl356qgeakcq8zjpfh9qzzz43x;32814;67;41158;8344
3683;bc1q9vxg6k8h4lmlz8rgnmdmt3chmjs23htwssh4l8;645780;1;645780;0
3684;bc1pkpv3qk3rvq9j2am802l4u0zmcx7xm9snn8ffmwwdks2ngvsdah3qad2xuf;1861268;101;345168331;343307063
3685;bc1qgzpkr5pjdt9wy3540cfgr80npm9ve2vze4ayx9;0;2;281780;281780
3686;bc1q8u6wven97sdvuscwwmzcp3u5q2hgn59fld7p3m;316500;3;983520;667020
3687;bc1plmkh0lt3lutny0t5k23m3u5xd64xzra5z6swpp4pj5fplezmeynqrwzw2r;15609;22;28631;13022
3688;bc1pkumlacldpjzdtpuz00s3dyalksvh8tup4n793trvwd86y2tscc2qeq5jnc;2036224;4346;191094091;189057867
3689;bc1qjr242hcxnss4jygjlkmlqt7d3aytaj58we6rcm;6533210;3692;55029967;48496757
3690;bc1qk7qdr2zjn50zsr8wskaq5xqnzmnu77k4ywxjx6;4899954;3;14733882;9833928
3691;bc1plk3akp4krnnad9u53h843vngudpvccxtkwm0ghg95t78cvvvnquq8dwhdq;1791146;719;6217914;4426768
3692;bc1plh9xem429z4c2vv78s90e7atr43e5v6t0m89qnueavdqq442w80qhm0x8e;82143;18;819164;737021
3693;bc1p05sz6whc0p36ht0n2j3zg08wx80f720rfdf3a5ltshtf5hpvearq78z655;4368;4;4368;0
3694;bc1plt4gn7803awwyjj4qy5a96ql8p0074gv4k04y3m5chzrakwxx8es6u37m3;49965356;89;433275889;383310533
3695;bc1pxxfyjvvnwgstr64ckeys8xuzar47uwcdlp8pmdm247mp5v2kvzsqw7k5eh;1000;4;2558500;2557500
3696;bc1pkgfm5wenszzrdw9g8enpzluhuyhzkfxxhsyjp8kwggvrje4nrwas4tl4au;430188;69;43399483;42969295
3697;bc1pjv5a3cyekgxgz0ev5zwf0vxgd4lyy4qjk38w4fkpm9v5sxqfz9fs5s07vu;391508;654;1510360457;1509968949
3698;bc1pkul0t5yffah0vz0vqlkwg80jfs6r8wexj8lmytmk4n8vj7c2u4yq3sgnpl;305491;12;2054207;1748716
3699;bc1pxt7n9yns83wfmu2zq9ff6pj8hcsxjpnm82haf2an0kel7xvhpvuq0c88p7;71746;6;1448304;1376558
3700;bc1pucw38n6t9x00thduqtqk3dp0sa8h7gv0f4deteu0sgahm70v3ngqppjesm;6902;2;6902;0
3701;bc1q06yts6cjggyyev688xedp8w88rke84xl6exfay;14392;22;6534504;6520112
3702;bc1q5twqzfp57neu8yckfuyhdxvwdnxjxyavtxcljw;0;2;281780;281780
3703;32iCYhJcBxAMiafo6T9socePgmhjfQyL26;8474659;217;549033162;540558503
3704;bc1prutwzwtnh920q8g46ndeu3utx6lctrzzvfep7em8ns25am2yg9vsfxhndh;20709522;976;20774368;64846
3705;bc1p577evjfevell6cgc9y5fpwhnce22ak0uyh53tw5nr0j8ydahymnqzrm9u6;289845;26;2561581;2271736
3706;bc1pkp6hg69ttggr46hw5u8r6g9saenzzmtzg2s8yk635rqrj42yj2mspthqcc;667949;22;4904066;4236117
3707;bc1pk5gurfxvnnvnhqde3c9fgnw0eze6j93y36wlzzwvsdl3z32l4t7sf8n74w;3507781;1273;916403526;912895745
3708;bc1pd87j4vpvpt8xgnvwk90fg9e0dlkltffpsxn4hewum8k50m2kyz7smcfj6t;700000;2;700000;0
3709;bc1pkm9kgjdj8q97vvmu2p9uvgu2d4nkvh79a0c9x4u9t20sqr7ngsmsat3d6p;546;1;546;0
3710;bc1pl3rf5m3p52mqjyamw836q2mzyl20ytffm89mcrcxwf4ct6qhvq8qg0apja;798739;434;111215717;110416978
3711;bc1pk0dcky6tqc0nu9t8ve20hsr7vnac889fwvj9vnfcxd0ep77n2prqap4q3z;152494;40;68961745;68809251
3712;bc1plamket3vfekdxyv8yf9uk53wxy3qnfn68k87spg5ry5j3g5dnxasmf6s62;9816813;252;385619065;375802252
3713;bc1pvkcse9g8rqrjjhv3nccxff62m37venmk6n9k5vmrfdu9eq8gpp4sutt38a;10000;1;10000;0
3714;bc1qhyuw5ehpdjrg39mj4h2edhzenupfx96p0xnt3h;1085634;7;3102086;2016452
3715;bc1q46n09cl9c66v37m4m74pzzggs5r32ezv2gngkg;268440;2;548220;279780
3716;bc1pwm5a6q6ceqpjwxkp4akfhjxherhnu8ph3u0r9jcrx4pwf857m6nqw5fl76;600;1;600;0
3717;bc1qgvzs32ktgr44xpf7p6zaum8uxqfm8wvsgr839u;704440;2;1420220;715780
3718;3CR95T93ZHZHQNU8X6ipJPgWPPFiuUQZzw;105735735;28;299747996;194012261
3719;bc1pacapa52cn09ue22d6mchccaq3gl3374dy3skwmr8kje9ee4xwq7qw8geg8;37191;1;37191;0
3720;bc1pul0a8tjjaezezecqqwmf35pllwwqypnp4h9js5hqv42z04se943sygeqdd;196204;3;371204;175000
3721;bc1plps7sm6hzjedlxl8uznj2l5rqdtflneew2g3lh63h95g9tlpgrsssasax5;1394531;109;28517602;27123071
3722;bc1pjqh0vrr98lcgrnjwpcrxcdx3hdwlc8kqa06gcj64kk587tuln5es3k654v;1422;13;2327463;2326041
3723;bc1pku9qxjjdatzjnmyqgywkg89e2n2yn4l9s4ffyagl7rn6vas939qs63l2k6;1385827;38;28132995;26747168
3724;bc1pkw2nq4wy8zfmp6zmz36vmm3ua9wskdr0he2n9yg83256e6mp5plqvkkkrh;66549;3;66882;333
3725;bc1plwdhv8an2uh5ehxzaz0997aqswc04lew4qhmh30wcqgv4c6sucgsgnwsj2;458122;113;3986187;3528065
3726;bc1qfjytdw4fhtncq2he26yxpdrx3gz0397awu0vzc;690430;1;690430;0
3727;bc1p56eqtgpjl4utyvuc59d6q8rec3hqpvzqaw6qudycsu8kejnazezq5sxqxu;561277;3;2740284;2179007
3728;bc1qv4zj6ak82zxmxjeffrzc64cfed4jwuzyk97h3j;684440;2;1380220;695780
3729;bc1pju4aquqf4f2y8e7x3lvwg3qaalyjchxzeqty8xtv2jzf48v2fdqszsvahu;7875754;868;442642328;434766574
3730;bc1qvz92f62dv4tafjk7vuqppy5nz6sz79qk759j6w;1587131;2;3185602;1598471
3731;bc1pjudqe48y36jk2cp89tdqmyj4w3k5k4uu77ntm7x6h5x7xx03gt8s9m70kx;7522347;496;163774416;156252069
3732;bc1pgwas0dqg2hmrq92asxf5w6xz975lcd8qz9zaa73zx37czpfja2asx2mg5w;546;1;546;0
3733;bc1py4t4kjyts6606zufxv9leatnd44cndfzgklajj6durwec4ka99eq4mst7k;1000;1;1000;0
3734;bc1pkm5kcrwh5zepqsxxuprkh4yswhaffu9pta6py8nn67qszpqagd7s4gvrv8;435871;296;477703;41832
3735;bc1pjsh4nnkalq44mf27zc85zf2cc88sw57zzl0fnu0edx4agc0a8kesyfg750;31593;16;344142;312549
3736;bc1pjtkk5auma39emh704j9pwsewwj23l8tfgkd9jj0vhsxjpsfdmsgq880ftq;96085;148;52909872;52813787
3737;bc1pjz5lu5pn2zr7m0nynr8rgltndjxkyd88m7z9feamkgka3rm96r0qxud6r8;7643559;119;81567970;73924411
3738;bc1pkwkj4wfquzta2yuz87f89y4h5pj6n4gexvu3zajrm0w26zc82tsqxrs3vr;137541;104;23738323;23600782
3739;bc1q8nnwca08cs54vwydj8kcvvs6w2wze56wekcsgu;634440;2;1280220;645780
3740;bc1q72wkcqdlg9pyfwggq50nydawvfuy4we2e4jl6m;723100;3;2203320;1480220
3741;bc1q3hhd5jp0w320xmuvwanlhqadzhntxkg7ldflfg;1123100;3;3403320;2280220
3742;bc1pkmmkcvwegkhcvrs4mfwgrkysu7jq9am53uud5d5kqvszy232ethqggyye9;1513924;72;106275773;104761849
3743;bc1qsmnar6l9em7vee7ut29ma7vcg2akm8flj0x5z4;268440;2;548220;279780
3744;bc1pldr9qes3nvjl40axyhdqz3zqxr05kxmzhqx02ryqd8qazxkv43jqq68gxd;29487;11;838311;808824
3745;bc1qgyg3m79jpqs4cncjvwwtn93fywy6q7eql90dgm;700392;3;2135196;1434804
3746;bc1pjv69hz9zuq97wl8mruygy3y5wywwqcx50ng8ywj7jjtw499wex7ql8acc2;151009;209;4902763;4751754
3747;bc1p3efwelnnwnwed5xts0g4z9ww6vej55gpawp2x875768xq7ssv03s6f9dex;10000;1;10000;0
3748;bc1pjv8cemr4wj6t5zh9v5kh0ljwpxa5ucyyqm7gswa4emclkq60ax8qnf0qz7;204376;8;1409044;1204668
3749;bc1pl8ruzch2965gz8c5cpzwwtl4nzgsf0y6um0tt8vrme78rhtm3z4sh0ldvv;195593;495;222065451;221869858
3750;bc1pjtrpyk45uy0scqefuzc8r3ymvgz5hwnw7gwkxk6l7zgdyc07ee9q7d06qx;2022754;42;14842664;12819910
3751;bc1qw229n5aca0lvpkaqy73j9mcxrlwsncjs7srrv6;286479;3;893457;606978
3752;bc1q0yxtcd0ak40felp3hu3jje0jkf7jv34c6ayx5v;673100;3;2053320;1380220
3753;bc1pknjvnwjlzlnsaqy798jwxjazhwdj6zhkyy6r7jdk3vvtfhug9p4qd766lv;40245;30;468214;427969
3754;bc1p202g3k7qkyyw6ex84sz2mkcjvvl0jz88399hcfepyy400ee5tz4qe8zvrp;8229848;392;176938784;168708936
3755;bc1pldr83ehgu7j4kzvczz2kmnkez2d6layxk6wqjtdu5pvj8d0v7a7srjp6w6;299253;120;13773078;13473825
3756;bc1pkndfspjs57e3zq3czm4xng0emx3kepnpyy43j8qwec8pcyygedasvl4m3m;42363;80;49890602;49848239
3757;bc1qxnfljthsatcvqsmhyhle9qqccfm6zj0znk0hn4;519327;4;2583212;2063885
3758;bc1qa3pqsntn4s9uj8zahx072hfr4vcxn2dh29vdmv;623100;3;1903320;1280220
3759;bc1qtr5mpeq5e4jdh74ncrtw2gy5lt9pcp9326gqvh;294440;2;600220;305780
3760;bc1qfl28ls9wscm4dkgl7fhujg6ck445u3jc5tun07;354440;2;720220;365780
3761;bc1ppmantrfsyxrdtk3zd6zqjsahvzgm0y602n8llvhlhfgpde7t9p4q0u38pj;5400000;4;5786102;386102
3762;bc1pkzjcrg70xsrfankcv2qlznzxye3f3rpgu3hk7dyljajk7mr26e6smwh4dq;3005754;2537;2341670585;2338664831
3763;bc1pkgsj0s3wutftv24eghceznczjp2cgv6j4y0d0zg55ewlurkchkksxjlrg2;16574493;918;2281967601;2265393108
3764;bc1plfzgrhd6ztglpx8f8m3rnehrczk0rz762r9gx2c0vy0gdu32hlesw4xhss;546;1;546;0
3765;bc1qjysyjwc4kelp9ufttf4qe772keyrkjvy9awzpd;9996147;8;30615151;20619004
3766;bc1p6q3uc3cvqzp7uz84nmg3g8cvj7f0jmtwc5uupman87edwvh2sa3qhn8gmn;1000;1;1000;0
3767;bc1pcwc3g84tzwdqyaex23k5dcvffjfeeafp0s9yd6clf2th4zs2w6eqwrsfaq;178830;2;378830;200000
3768;bc1pjpaj2sctchg0zdn8759xet6empekzpsenu6lqssqwdkddzewvdeqkqc39e;41113;23;483919;442806
3769;bc1p630eu4tu83rjpx6ha792v35z28vec9ggf3pe36jj7hupc3v4js2s7fnez6;112186;6;1601523;1489337
3770;bc1plhrw982gd4ercu9ap3gtfera38gm96ypyvc2t4sjpewk7ahfd7rqr5p0z2;735089;10;2232151;1497062
3771;bc1pquz62anahzfwnqf9wagynvdp8hv7ehy2agxlgy72h0hxs058zqfqk8ksyq;25172627;105683;328886005;303713378
3772;bc1pgwmdtsegtsx3ytzmu92pyfns935edy47g6qj7wmvu2av9ws76e5sfzl0yg;3363664;99;326399769;323036105
3773;3BQUM12jb3dA5eqp7jCUxaWaFNX2Tys8CN;15959140;2;31959140;16000000
3774;bc1p4ctmejalnndlpqjdxvrnmx6mkr82xda6k3d9088rzyx2ldd45gasvc4th7;582536;8;3245064;2662528
3775;bc1qej4wgeufx5gzug4ccfh5xktg592jj3regh74tv;268823;15;63486716;63217893
3776;bc1qguzk63exy7h5uygg8m2tcenca094a8t464jfyvrmr0s6wkt74wls3zr5m3;285145689;898;454459689;169314000
3777;bc1pzyal8q9f84fwg5zumujakp720t3pc8s354hgkh6wgpsh4ta072csw29sq9;65587;50;95105;29518
3778;bc1pl4e33ue7p5luhshf9ale3yzqcz2dpsjpmd39zakw99zmqe2udkzsl5uu73;252952;228;109762619;109509667
3779;bc1p3q3aznw5vh2k0y6rtucss07kzurq3lzcye0wr5wtqaywr7aj3atqc04hu4;0;2;599430;599430
3780;bc1qx0yy8j84tq4xr4u889m2vs5skrrftz8tvv3049;62111;25;62111;0
3781;bc1q3eecws8jpa9lpwkc4jw6rs7t7dkkkyunt0z94s;620414;3;620414;0
3782;bc1qckk3ej0837cchj46xckzvrdkvsxfg7p4sw2c8j;1253670;1;1253670;0
3783;bc1qq6jxx3fzjwfpf2s0dgjnzuahywsmqyx7pfqk4lkrx8sq4dxt3sfquynj32;0;4;13778550;13778550
3784;bc1qpg02gppp53nsc65xlyzucgxuetfkk4rm5vt0a0;22956131;8;39035799;16079668
3785;bc1p8k42ev9crm432hw93vz8vrmwxy5vl242z56wxdgkgq0ewmzcq56st6j8sw;970355;22;6834671;5864316
3786;bc1p3f9t8zdus993rd7g3949fqy8ds53lyuh3yqr2uf7xg7vr5a4pu8s5rrmgk;6556;18;8194;1638
3787;bc1qyfaq4nnj7lfkc25u79wj4hwzap7v5hm0qjy975;52070;1;52070;0
3788;bc1pl9snd9cfxus46dgc4gn0numg8xdvkzmz8vfj5qlk3gqqe6er70tsxk8s46;0;2;42000;42000
3789;36RjKHTqgKSYL8iZbjvFkwvuWGAUawpSim;1000607;72;48626470;47625863
3790;bc1p0zq6ge7wxs3s084r45mtysty2rwvkhxqpf2qt8e59cj4e526jhesuc2xe0;18190;5;18190;0
3791;bc1q8amgh0pj8hakcrqx9raz9hp0w3gzfnl4h7evqg;530775;2;530775;0
3792;bc1premw86cx50puclpzm940qrgcac9sd0r3rx6f590x67a7ryh5a6ksdx68zr;93044;47;140473;47429
3793;bc1p9cyk69mmtgpe294h2wkf3cdr7yuqaa3cze7ksadft9u8t8wv79zqxsq68d;5466360;2812;334593700;329127340
3794;bc1p5thl80kpa9kssdsupjte2tj2cqdl57nh5mzra8rt9f232vap2tysmh6fpd;129955;26;129955;0
3795;16oj7jqoSnj2ANrqu2AWDGxtwCGpwJ6JCt;313800;92;120993432;120679632
3796;bc1qpnh8pjkn4ec5rdw3qh32zzmuz6t69g4r2ad896;18805;1;18805;0
3797;bc1qrx2a9d54uht6c9utykd4khy0acgu4kp29vlwyj;22222;3;234029;211807
3798;14HY1gTA6WuhVWwJpHepQR3jviRp1R4uNX;7418829;21;11920061;4501232
3799;bc1qwlku2jhnl0rlucrqsmwr6l33hpy6lnzdyj53wc;608107;19;35488451;34880344
3800;bc1pgm6hqdv74205w4m55uy9y25sqdfpkgv75ttnr86lu3rhr4n8wucszmytwk;0;2;49000;49000
3801;bc1qeseq2pkt0z7682xdulplud644n3s87dky3agg4;550000;5;550000;0
3802;bc1pgf3zxkpu0aqp7qq5fjsw0uvtpa3vcrxprpfek0j5vl0qqaetxvcs78s7ma;1000;1;1000;0
3803;35jqMKbjduMcMSMyQfjkV7d7hkwgwiPRUg;499866;3;8452390;7952524
3804;bc1quh9jm6p06nqnvgvvv733pl0g0y6ycxl0aas2t4;8614011;7555;695649059;687035048
3805;bc1p43t2m66fwkv50dytt445dr0r8rvexmyhnrmxkpdvtuv5xq99ycfsfhtj4w;2409099;1677;484793244;482384145
3806;bc1ptz2ycn6760cn7p279fd6rmyewv4tw5dsehu5xft6m0t2ljvlg9ss8flga0;29677;309;1124005;1094328
3807;bc1q5qzgecqdryrd8wj8m7n6vh5d7sangpj5pe3tst;82642;1;82642;0
3808;bc1q9wfq2nm2urzde78rk99zxhyf7jr2aj38ckx2h2;61616;9;859575;797959
3809;bc1p26mungnn4dsr34hjstfumayhfkzewz0y94qu9hj7c3txjar93r6s2saarh;757186;10;4093285;3336099
3810;33yCMTKJZKxqxqdimw1wTWmLUvehxb3xnT;191573362;16843;191573362;0
3811;bc1qz6mfpq8hygf5w3uaxu2pvvym7m0fjjgz77prhw;7285699;7;25469594;18183895
3812;bc1qvs2hts5u0mk06ayecd3m85ps5w5emuxtlxeg9x;46052672;9579;104485020;58432348
3813;bc1qm6j2svmdw59ft0w80vhaar6qfn29ud6z9deqsj;158584;2;354548;195964
3814;bc1pm45ur36cax3yj9dgay3f4j5krcf8m0l94v7hkjntudupsg0jwxns4xc63z;0;2;25000;25000
3815;bc1pw4gm6d3pz85mdyndy8g9zan5slmn8ufexw73gtux2a2wffe3vc4spvm8pc;424987;62;3925246;3500259
3816;bc1q6ekmn5a9j07f786024sw6jm4gufkcpjqc0m5w8;420519;163;16247161;15826642
3817;bc1pddheyxqgpt9rq3m7hs6phaafvawuyfy8s2sv8hyfngfzgymwguasnddchk;781106;64;56041330;55260224
3818;3J13xVtrYZ18hsNwbBx1xnKLpF7S3zwGuo;5397926;98;239342409;233944483
3819;bc1pjn23xlmamxz7vfku33l4zqlzk3qwtrnh5mhlpnar3m0vl29ky7hqxdc3ar;330;1;330;0
3820;bc1p05795tu4n0fcln9vnavktyt20zhrz32cu7k57s53kx2hsj00m7vql3u266;52641;176;145727815;145675174
3821;bc1qjr242hcxnss4jygjlkmlqt7d3aytaj58we6rcm;6534590;3693;55031347;48496757
3822;bc1px9fczupdd2k083rtjavn9mln02cdx62sdfkf9mjyl98e09h2efzq4nnj6a;174141;5;14422729;14248588
3823;bc1pxd02fzx8wxsm8t47eykaaz4gkcrge3pkmutjuh0vcxtn3encsfcsc8h52e;3214135;140;194396083;191181948
3824;bc1puvwhp5xvz34ymatj6vz8tj9f72uacqtl7a4hj4la4v492m4jcxdsrrfkzn;1146144;209;12614130;11467986
3825;bc1psejwf7u8kvd7qeq8xmtekh76zqf2rag4w6zfx9perg9whcclyu0qyfzss2;298632;185;36937714;36639082
3826;bc1p453fqq6a28urcp46gv7ctwwlfmkdk8fxuhy853tgzcu548ev4fgq58vvsc;617056;33;3481775;2864719
3827;3Gsq2j91sdP8Fp5bXcuGkxKQmtMKYyLsPX;18413136;23;109598114;91184978
3828;bc1p4mj6gw26gnsnp5w65u3wna247ect9e8vc5aq4alx0vzweq2thyrqghuczu;302049;38;123206727;122904678
3829;bc1p069cpg5xy0jw03kw9ut5ppq09jxkdqzmg58fukvxujeccf9ag8aqskhcy7;165802;312;169078;3276
3830;39oYGP7Jn5rsUDhoEdDzy1eCt9rv954hWY;4751537;8;14457932;9706395
3831;bc1qmgrwclp7cj7v2s2gj4xkj70m08dzvwr9hxx59g;29013889;2287;203543177;174529288
3832;36yhRqxgZAURUhgvUqdQQcN88EVWkzp9PV;301499;1;301499;0
3833;3LCqRi9EgUtDWimbZgqig6cCJJ3ZAAVmxb;375362;25;9322663;8947301
3834;bc1pc3q98vf8htl302qckluah3c5dqv9vxytg8k3npsuep2xv72cqv9q66mefh;4660800;2;4660800;0
3835;bc1p02spafhj6yv85t3zynmjjsyxp0fz4cml4xzghppz9u0z0vqhs27qn6jkw8;11306;4;11306;0
3836;bc1phu83peat025p6q5yd5z8svyg98508m54xd987sasjy9ml2cjrnwsnevpdt;0;2;16914;16914
3837;1PT2GGeQ2Z5wyKdKQfmcpQAzEjL5XnWrn7;6926827;1;6926827;0
3838;bc1qpk2adkjupe57sleyphl5nr6raahrd93w5ryqu3;107849;29;107849;0
3839;bc1pf003s4rn2778syns3yh64w2qz8ncxmayyjg6erw6fyp2sv39ykmqnl3sm9;254000;1;254000;0
3840;bc1que58pp280ac2y0337g2gxavfwrhkry5sfxnnqm;441191;8;14971884;14530693
3841;bc1qy3zpd6fsweqgsae6e84g8aqmscf57ld2nhfyjh;315000;1;315000;0
3842;bc1q8xquajhfllf5kq7zpezhjup5ecu2dv023ns2pk;3422669;145;58820529;55397860
3843;bc1plck39gahz6wahtshmv0j88glfnutk9p52pmv7d5l42f8u3shx5kspf55t5;1000;1;1000;0
3844;bc1q8tjs8jtq7swp387f4cqmd7jkgd47y9nf5rat76;3987959;9;42326822;38338863
3845;bc1pfjmy6ag8hjcjrp6fpex2raldk7el5gy5mha63j47yrscddvkcpvqjl3ekm;153284;98;45969466;45816182
3846;bc1p74ngvx8mazawe6mfz4jrjcncv2hg5fn0yx4ezs50avzfqfr7v5cs2nhhy9;743307167;268;811371503;68064336
3847;bc1phlcqffe7zyhmarn0upn96palvja2zxfhj7ekp75zt6umfzkn2aaq9luavk;546;1;546;0
3848;bc1pwe3s2vty4ae9my2a3pfemdz26gphdtmdjqrfvnwg8n8hfn3yrl9skzqesw;350237;146;417649;67412
3849;bc1qqdksyjupcwerftz7qqjtgagkd029ww8kr6hc9u;5559879;1680;3368550324;3362990445
3850;bc1qmaqxzrhjju8rjnzhetdpwrld9420kluhler0um;603922;26;6695075;6091153
3851;bc1ps2cp5kyeglna5rhkd03540cyan674njzhe5xe935lfyggqekugcs6hcd5t;10244;18;174403;164159
3852;bc1qvzwpy9z29x6w7k0v2ttf7382v74v83fy8gw28s;4849560;19409;11859477023;11854627463
3853;bc1q6lzqnrewldapuwujqmw6jt6pjyhe4pqj84esec;94313;7;14072346;13978033
3854;3CR95T93ZHZHQNU8X6ipJPgWPPFiuUQZzw;105735735;28;299747996;194012261
3855;bc1p59zf4jhzz7trwkx6mwl9dkwrk4m4796srqq9h2tsnnecwww3q2kqjpncyr;802928;939;358509405;357706477
3856;3JibBeerFCN5NgxkUk5mjdMwwBYL3H6Kof;2113987574;142936;6474622732;4360635158
3857;bc1qsue9kdrynxuxwe8u5cefncvayu805j5xkl0ava;418661;411;343631026;343212365
3858;33u5CPWXr8utYyK5KJjAKtksmcuGf43YQf;13010382;4;13010382;0
3859;34TpXZiNVx3C8CGrGoNRkUEAr8DS2p9c6Y;205509;181;45981595;45776086
3860;bc1qwrtry4d3fatr44l4qxjvs6rh4j8ehumzg8cp0q;51960766;9423;116836989;64876223
3861;39thaKgqu5Z8HB691ipvHfe1fxJ5fnfsYu;1975668;153;274907335;272931667
3862;bc1q4n2x0d2agjwck77jrgsv988xzpsuskmaza82l8;156600;1;156600;0
3863;bc1pjqxsl973f7mdmdu00c85qj2f3ndl7sxw7vd36u4lurefdnzqzr6sw9l3pn;149883;70;150213;330
3864;38AXZwjViTCUQQUKudgrdwoiJ9w9cyEEX5;71023;10;3485760;3414737
3865;36uA5NRiAHyGVF6dT39yY2KgcTNwZJ1U6J;37662389;3334;427420767;389758378
3866;31znWtRpZB8oXejz6xMqX8KyzwG9vKPcRP;1035252;18;4281583;3246331
3867;3BndgR8AwFph8e1z6kNMsDxbx9K7tCu5c5;105245;23;12140402;12035157
3868;3PTCT6mydLA2iPodiqEm2DWYbX1zej6fj4;8210846;110;43803577;35592731
3869;bc1pzz4xjq36u5dka4mvnvzyck95dxgflf7g0zmrcdvypf2vapptdlcqhy5ada;1000;1;1000;0
3870;bc1pwfrenl6vx5xpjjldlu4vkhxqcrc065wa8knh26y9f5ntmsu4cc6s20y9y2;1092;4;1638;546
3871;bc1q7yqpy837ynhfxhsxykf689ynszz6le4qlqgynr;138245;726;11819361;11681116
3872;bc1p9h0eeuefd8dj8wjvl5e092t9rdlfgxr6j3kcgfqpdmwsvas3tg3qkqp4l5;1000;1;1000;0
3873;3GBGeS8z7oChKmfNaQ3NhbLYANtRepUfrJ;313072;30;9970648;9657576
3874;3DFxUm59WWpAHzFkZ1tRy9pCMfo69f4UWY;7017335;145;120925834;113908499
3875;bc1qj8q0ars9k26y4xw7gyp8zdxkt5z793k76ktu5chwjenvg3tam4yshjmr5t;1190039400;1203;1190039400;0
3876;bc1q9lcuz6c5y24dvrzyze6yt3mk2hmnf0jvlghl4j;20752;1;20752;0
3877;39yTzooY3w7X9UhgEtJpV9Dj6YYM3get42;2360314;4;7269878;4909564
3878;bc1qzkzp0wtxq2zc33mwcufvp0yru0xfuzqcuglkr8;7835;1;7835;0
3879;bc1pxs0jklwhmsytgygugcljlwp69fca6ffsrzsl2tm80z09rwgmy3psagvpz0;9332641;89;91440873;82108232
3880;bc1qcrlpnjlql7ppzhtn53eqf8zw3waz2hrqdx9026;5854155;9;47725824;41871669
3881;36uDqotFdYUDaDh36NdKrtwU2Chfzw2gQw;5391189;22;75618665;70227476
3882;19wkTqYy3ENtsNp8ctWYuW7z7hDWBRUrJU;1250000;1;1250000;0
3883;39NvRb4ntoiWSUveRo4QCYvgwX49FZ6Ju4;128311981;77929;197700151;69388170
3884;bc1pquz62anahzfwnqf9wagynvdp8hv7ehy2agxlgy72h0hxs058zqfqk8ksyq;25219745;105698;328933123;303713378
3885;1FWQiwK27EnGXb6BiBMRLJvunJQZZPMcGd;73818239670;158505;30168158870090;30094340630420
3886;bc1qdtaqy03pvs2pn03tjdkudjwfmyetxt7xfjfyl2;667452;67;13190366;12522914
3887;3P4WqXDbSLRhzo2H6MT6YFbvBKBDPLbVtQ;16616798587;955133;50001909626;33385111039
3888;bc1qxuc9k0ynpng3dxzy75g7av0wrh6wg8x9ehqxgv;824330;3;2505876;1681546
3889;bc1pjefexcshfteyqwjt4zfht0gck5lslpf0hnsasdszruam7mpu2gnq4lzykj;894379;2;1813379;919000
3890;bc1q9u3tkpkssqcfl93uusp8jm8lyejd4jer3xg37n;343622;2;698206;354584
3891;bc1q9tegpps88mnq7kxp0jswfkt3zh5vutpwt3yjcg;426254;1;426254;0
3892;bc1pkfwq3nk8zahqptdhznqrgvp5n84yydz4aauh9kda5pd5xsr4yv2qsxxhly;965600;3;2944523;1978923
3893;bc1qmplzsgu3lluw9s8d2n4xtutxyat9qzswnyeae6;519737;2;1050436;530699
3894;bc1qzqc640g28wzkxaxhun288d27t7fc9l8kvjxgzd;365292;2;741546;376254
3895;bc1pevplnfwke0e9hfrjjqhy3m778x63n57kaspgs7rj2n4jcw964fcqz8arzj;965600;3;2944523;1978923
3896;bc1qjj8clzwz06jzjr2z6cvtth96c907zanckmc8qa;75390092;1;75390092;0
3897;bc1q6c2qatmm4x24u8nj3hhngafsxuxkzzxdm72sng;655292;2;1321546;666254
3898;bc1qlzdswzqyhu0zgh3d3k8mtw7cxyzju6nc40t53f;35200;19;35200;0
3899;348NtrFe6Wse5AXBMFNmcNrsmYJ8s1y6Gg;274731;5;2155024;1880293
3900;bc1q8dr9ds8qc835se9jkz8g2zrkht4xadj7t3dmw4;366254;1;366254;0
3901;bc1q8plxl5hzqgpu2dduyv0xxfha7yd3wlmdp4ylsn;154330;3;495876;341546
3902;bc1pa7c2gt29z6872hulpnwf2fp3tgn0apv4eaw5tut24l7vuk3lpxpqhrjf7e;941968;5;3366437;2424469
3903;bc1qwlku2jhnl0rlucrqsmwr6l33hpy6lnzdyj53wc;608107;19;35488451;34880344
3904;bc1qphpx2e5x9ysgn0tmj9lhz8k7ft29z8rn2nzrsn;945292;2;1901546;956254
3905;bc1pvc9j65qvwx5fgmze2l4dm8v7yr7rqfa5fx8y42w70rzm3g48zucsncuxa2;57741;8;306779;249038
3906;bc1qnm52czqz0ruell3jwhyqtuvdflmdc35yu0pqdy;3099330;3;9330876;6231546
3907;bc1qtx6y20csh6ty3pa93l6vscz283d9mctu58fcnm;624330;3;1905876;1281546
3908;bc1qur45qfrnqjtsfsh6mgwaaju8rfy3du7xrj6ec3;945292;2;1901546;956254
3909;bc1pfeejjkktr5jhp0gyv4rg5dgzawachvs0dyfqk8kkdsm5l4d02sus7mraz6;156451;30;874288;717837
3910;bc1q34903vdnqv3vcsu5yu5hplvsehdtfvf0rxxkk5;1124330;3;3405876;2281546
3911;bc1qfqg83u4t6gvx7lqduhjl8kxnnm88yw6gte6j6z;657361;1;657361;0
3912;bc1q5vdg6ljzqknq0n8f758gjle5j7akhtl640aa9f;655292;2;1321546;666254
3913;37MJZNZibuCZYVzWCLoka5bxjGvCMNCP5q;653785;10;8751717;8097932
3914;bc1qr3y8d5pu7mn4gdncsecqmnugdz3kgp7m42q4eu;794469;1;794469;0
3915;bc1qzrcmgusqk3l63xhw9t5502n7v8kzfmuk902wcy;1517566;1;1517566;0
3916;bc1q56u938tmjfwrmv3eq6ww0h55lu2dp8wppx8l7n;1044161;1;1044161;0
3917;bc1q0e5v9psrqdg6nuxfegmjkewextlvw5wrmgxxhy;1546254;1;1546254;0
3918;bc1qy6833q5l5scpwgw885tnsxrr8rnpzwn58cmkmu;999999;1;999999;0
3919;bc1qrt54gj0zxvegxtlhsd23unaqcp7e9gpe0vk3xj;1997230;3;6024576;4027346
3920;bc1q9xtutveqcc7sy7nqygcqkfrx3z2lkyeutfvt5x;495733;3;1520085;1024352
3921;bc1pr2qh7alvz3acejvy8vsk0xy3u29u5ts5up4th3et2f6q78gtlqyqn48dur;100028;72;839771;739743
3922;bc1q7z7ww69kuv95jy72mgx0lu3xsrrwpsz03zuqc3;0;2;1317892;1317892
3923;13ccArL8JDRN2UoQJsnvrmAeoLVsiE1Rac;100000;1;100000;0
3924;bc1qrzf5u8dna79e8kf7sgvsh59q3sm0r2k67dxlwm;1135292;2;2281546;1146254
3925;bc1qw7vwupxcxj2q08k30dcg3tt0erfc0mlfd5txer;1546254;1;1546254;0
3926;bc1qdfmsrzq2a05t790t8jtfaxmdcx2d2c6j46xjsk;2516683;2;5044328;2527645
3927;bc1qsvyx8jw5mt0lwds78ld70n5yr7wsa8hm82l32k;278015;3;866931;588916
3928;bc1qmk45q22rh9dc0qx3sel277weypwtn2ax4upm5g;808316;2;1627594;819278
3929;bc1qex5rtsqxdsmmklmw623tfyc4chwyp3xgmdr6rr;624061;3;1905069;1281008
3930;bc1q4yzac9a6ryamhm72u87h6qx8kvz4zcnj5xvlke;144330;3;465876;321546
3931;bc1q24mmhsuke5hhqeswsvys6l2syf4e8q36k5qsnh;1066254;1;1066254;0
3932;bc1qvjcnc77t2u95a6w4qmw0vs87wnjuwhkl9p7l4k;3042445;3;9160221;6117776
3933;bc1pha0mwka2nchr38vjrzqq92cvw8mg2kw68m55lutpevwa8dapkw6scypd70;965600;3;2944523;1978923
3934;bc1qwrhdk65v543wvkd0j3wd0prmycpjm4axgl2mkm;406282;2;823526;417244
3935;bc1qctwlz5dqz7a9t5smf3v5dc069e94njuxpdxme6;722820;2;1456602;733782
3936;bc1p7a4ss3nwqjnh8dm5fk0mnycx6k3gr5kepg0evvey4kjy0zl4qznq0d8z2h;648884;8;1334567;685683
3937;bc1qn0nqh9m8uyhgzvsas2x2tuzvk5f7cs5nanukrt;1135292;2;2281546;1146254
3938;bc1qsmc8ahftjsn5xxn3jv6vrp9hehstawzgxnxatl;328654;1;328654;0
3939;bc1p9xzqmddjctz9hwzeygfs9aqe260c7440y63a0emnclhe6rywlqrq3f5svq;72588;3;858574;785986
3940;bc1phcyvvcwhkh0q5afgnses67v742sln3p7gj0sgcyrlqjvgeuwfc0szdrdzn;443758;4;2878997;2435239
3941;bc1qm43z6a3pvmfecqxrp4suearrsqaqmlvs66y9xp;484327;2;979616;495289
3942;bc1qhnu4gleujdm6gw0euhlg5qjtph8ruhe7cxysww;1535292;2;3081546;1546254
3943;bc1qgzxdh6sl22fz3m0reahqrn2k4nq4uqp5w5tjse;765292;2;1541546;776254
3944;bc1qpx4j9emym4zyhug3yyl4ufuj98pl07mqvh6zsg;835292;2;1681546;846254
3945;bc1pcn4nuaj0xvjgy3lmge5epsu46evgzfhhvh8vpz82wg45fx2fg8mq5ds9u9;1092;2;1092;0
3946;bc1prutwzwtnh920q8g46ndeu3utx6lctrzzvfep7em8ns25am2yg9vsfxhndh;21417522;1005;21482368;64846
3947;bc1q424va7sj746uz6rnmsallhym0xc63e08mzvrej;666254;1;666254;0
3948;bc1qva52vzvc359kjlt5c0xeuvtjg3z23804pzfphw;930292;2;1871546;941254
3949;bc1qzqxvsawh7nnw7v92u5q5jk0xxy58mtz7q5kp7e;1435292;2;2881546;1446254
3950;bc1qntgqgwaeuk05qfc5zp5g8g0zyts8xyuzkr0vjk;115072231;255;125292231;10220000
3951;bc1q8xquajhfllf5kq7zpezhjup5ecu2dv023ns2pk;3422669;145;58820529;55397860
3952;bc1qfwvgc68y75rxtd47yz2s8yxh28wjpga5kc5vl5;355292;2;721546;366254
3953;bc1qxfvataefta4qk7frujury40q6hr4flc9g2wwyy;1019531;1;1019531;0
3954;bc1qlms2nnsramj6aqr7gwjgx4c2l0kpytsse9c8qj;666254;1;666254;0
3955;bc1qul3a9ncm2a5f2fswc6wx4nm4f4c5ph4fvtdan2;440200;2;891362;451162
3956;bc1qahruf7fh9ffx9pqp43ntwu2qknguyjszqyc43k;89286;13;2026748;1937462
3957;bc1pkxluzp5r3fyrznwz4zrp0dyjvu26s734v09luu0sg5flyruv4q3q7s7v7j;0;2;16728;16728
3958;bc1p4fc0fat899mwlj86nfdxffef3znjzpahukza5xwwzj0rj96gwecq9f95wz;200000;1;200000;0
3959;3JibBeerFCN5NgxkUk5mjdMwwBYL3H6Kof;2113987574;142936;6474622732;4360635158
3960;bc1pl4pkzxf28uz3at9dztacj77t3p8n4ku28gypn5rk4mgdag3tcv4q539eqf;965600;3;2944523;1978923
3961;389dmJFJMkm6AWfhud4UsyFneaT8u7XYUz;1244196;6;3907765;2663569
3962;bc1plwqw8ae8fpnw0sqvvydlwg70cxlyepzyxvcxt0978xxz3mnutnrq0nvxt8;310992;62;5719036;5408044
3963;bc1q3wka82c3el0xsv6x2wvykmtmgw7spyjge7rafv;232399;2;475760;243361
3964;bc1q7ygq4x2nkcmm0gcnsz0g7xhh8vrlx63dwuht65;956254;1;956254;0
3965;bc1qaxmk7dvjad3f6dmmyggs3y5c9mwlvmu2ksmku4;3883687;3;11683947;7800260
3966;bc1qmu2ssen90k03pef8nh47vkqcgce3hu8x6xxq8k;346254;1;346254;0
3967;bc1q0mltr9kgcl6kd3vp3054re433p268mr2n4rmfe;0;2;82254;82254
3968;bc1qm77lsm5p2x05yzh0qte9zketlzqnt77vhmrxk3;0;2;4653790;4653790
3969;bc1q0sd72m5ee7p3p4flaaf7p8cdmaufeu8jddjfvx;965292;2;1941546;976254
3970;bc1p5lekrmvur048pdq5psmp8t972gzg689pytddg4e86mwz5ya0ynss5ala0x;46792;5;46792;0
3971;bc1qxkmy2std8kz000skq3u43vjcal0jp20gpt0ezp;739254;1;739254;0
3972;bc1qd2wkc9hta4xndwljl9x82r8qscrzqj20wm4vql;1266254;1;1266254;0
3973;bc1q48rv5s6dwjaya7e4xyex0rkv8guz0un9028qwt;344330;3;1065876;721546
3974;bc1qhjnj7t0ayp2zn7cqhk7h0wvecq8v69t2x039sy;655292;2;1321546;666254
3975;bc1pwjt84tps4wj5l3hqsp2ns2mscd4hqzqjhrp77k89avtcpp4zqmdsvjce9j;430600;4;1009523;578923
3976;bc1q6ds5gnhmtug6r548027flcxl9ms45g733r8lev;335292;2;681546;346254
3977;bc1ql3my28pc7a2mnh4kzza2qdgtu9ynv0qy4uynmv;404330;3;1245876;841546
3978;bc1q2v0zhsmz7k3msrfvfsa0jrg8xcm4f0nwghaej5;1317542;2;2646046;1328504
3979;bc1qppqj2nef9hp7aq6cydnvzqgeyvg4npqvm9mew8;344330;3;1065876;721546
3980;bc1q55lejj9cs8zug69a4wed4np6ak4k765rmp82vd;402726;3;1241064;838338
3981;bc1qxuqr5xlwpthxu6xvnhlg24dg2j7d5nlelu9967;460898;2;932758;471860
3982;bc1pd3akt09acp3u2vt0tww90j27xl6kczjepvnkk3za80mqpl8mqvkqglrt98;546;1;546;0
3983;bc1qqapw3c8zkjlx5ddvjnsqts8m4799w7gjhah53n;1535292;2;3081546;1546254
3984;bc1qpfrjhmkztkhm9k7ykrpk0jd75skgkmm0jflnk4;355292;2;721546;366254
3985;bc1q0gt045y9vpq322h2nrr8qsjl585vvvw929fpp7;666254;1;666254;0
3986;bc1qekuxt58yek89usnftawgtldm09geph28hr7r8v;683008;1;683008;0
3987;bc1qq5s2g9usgmuatktv4cxh032yqew4hn4kjmgjwz;726254;1;726254;0
3988;bc1qr0ag7rptk0wfafvvgz2u9y80aymx6v762lxcyd;426254;1;426254;0
3989;bc1q6v9rhequ3fypq4qzmw8sua7rkztdua822xa3q6;1481021;1;1481021;0
3990;bc1qsjd9ksganmq3x0x5hylmpmsrqy2lsdu4d6zazv;1124330;3;3405876;2281546
3991;bc1qkzk2r3ml9h62w20pdmardnjhk8tna0xu35vpn3;934330;3;2835876;1901546
3992;3JJiXEASDwQekuW9Krv2RkE5oyNYn9MyRM;4064487;34;31740932;27676445
3993;bc1qa5qaczykf4t8u57a5d6xk3mzuk4q7j9957n67a;2444330;3;7365876;4921546
3994;bc1qypgynw58m4xyqq49fhvvrvuam2h9xarsxp76ar;8719653;2;17450268;8730615
3995;bc1pl2yf5l3v07shm73w35fv33drxnxnefndewuq62ctqldtpnffl9cqh95g4z;965600;3;2944523;1978923
3996;bc1qg6djqcx6v3jx8ret76902sc44flnvvpfntg24p;2309254;1;2309254;0
3997;bc1qzv3mhz79wdsw5f3vquehkgpeqwgyhr69p7fanw;366254;1;366254;0
3998;bc1qve06mjjzrkakuzy4ns3dr962qjygypmkqlj2f0;376254;1;376254;0
3999;bc1qnmwaqhzcggw0z5s4m925c37t4nny5mekauaqpv;501204;1;501204;0
4000;3P4WqXDbSLRhzo2H6MT6YFbvBKBDPLbVtQ;16617046090;955134;50002157129;33385111039
4001;bc1q3eecws8jpa9lpwkc4jw6rs7t7dkkkyunt0z94s;620414;3;620414;0
4002;bc1py9098ytpleawhq86xhkswem334lx4ty4ccq30q3ypnl2fmrwj8ts8lc77j;1047500;4;8971308;7923808
4003;bc1pkj5jjzglh99zxqu6w9vwdlpk7rqr706jw8t2jtsf4yvfrrvc6ggqlefhke;6406776;341;102233068;95826292
4004;3FDxVbEEmzw2EjSkeqyheNGTBQaYP2izxt;462143;9;1875459;1413316
4005;bc1pd5u7pm98s84eelu8acnmt8k8cl7v3h897fcz90w5ccdm7mfl95ws5fdvrx;614486;41;12707445;12092959
4006;bc1pnwf4jhk9kfcc9ct3kjv53kqywd2sdkf99xj925kntewhdd8xalmq0u6cym;91500;1;91500;0
4007;bc1q592xj8rchv4hdyfpukpfyw38qnhnhfuld5u05j;0;2;1228498;1228498
4008;bc1pxw96mal8qhtlp5y6ltfcszr2j3sqp909xpj3l03me6fth7z6sslsj230ht;1379392;4;3013831;1634439
4009;bc1q6c78p0gzvpez63rd0rzqu8kdsplfjrl5m52t4y;482815;1;482815;0
4010;3LxZYfKUJo7ismEhj2uRrRByYZk3ozKL9P;7834;1;7834;0
4011;bc1pn2h98jhe6fg0t7nz93c0hj2e2gv44pfk0k0njgdht3tarde372eq2s8yq8;0;2;14401;14401
4012;bc1plntn0ypu7ma9ev8qpqdgpazztt6xfnp8zehv05cwf5x6ntdcwu8slqg5p0;91500;1;91500;0
4013;bc1psnv5mg0f7xadf3lu5rag9tkpak9nmyyj7wpdqhpy573kp89tm74qa8slq9;330;3;4193102;4192772
4014;bc1pynsglvsxrajzrcjtyxukk00vrzhyuhp9k5jcf4kjlcuvdkw7yfssa38796;0;2;18000;18000
4015;1Db2Nvar79hfrS9ribgz748fJgwjPm7219;4769222;1;4769222;0
4016;38o5QTRHCvXjeDKgPrSwnK9TxfJZHpaqug;371295;2;4171295;3800000
4017;bc1pl0wma3js0se4c5d6wp4qvadmtfwl4mmf3kl3r4g7tsnx9x42ctpsgy6vaq;91500;1;91500;0
4018;36V2wPVMfikNLrwvyhsi4F1E8pKMR3L3RJ;1330546;5;1330546;0
4019;bc1qel4sx7se2jm9hactw0y2jfry0qphc4u00a0dgy;53346;3;253638;200292
4020;bc1qehqumchyz76cd0t3faj2ls7hmm6pk6c45h4l9c;15002400;17097;1202720506;1187718106
4021;bc1qqjanevqkyc6m643kunty7cvxq4cac6exc0m7v3;25739852;76;830768653;805028801
4022;bc1qtvjc8c4vag98ed8uskjc2ceqt4nkat802j8hks;676505;3;2062401;1385896
4023;34Yd4nsNtFcdLDRL6QGvxwTeyW23phzxup;686869;1;686869;0
4024;bc1ppgqjxyur3guv7fc2gqllhlppkhgnw8mdykhr6yl9th8aa7zxgmfq394nm8;0;2;11222604;11222604
4025;bc1qded4cq7m9lf63cx25a00pjwtknr33x23lnnhnx;475170;3;15938208;15463038
4026;bc1qd8z9rxsvm5c4nnz6acpk3gks2zny5eharu5sf4;100000;1;100000;0
4027;bc1qr5yqtg45rheas9u2dm8cre8a7wwgtv64dg60kg;69041;414;129635594;129566553
4028;bc1pqmxwu2k5fz0zrufrjd0gzpfktxskmjrkj2rg3s7cc04cqvua39uq7l8j7z;371410;49;10843693;10472283
4029;3KAPZJxCqXSha2hYnTaFDs4wtF5PJz6vRr;2031246;147;190933685;188902439
4030;bc1p7454a6vlwn20pae7ahqumpqc6mw33tyjtdlr4z8urm5jmwdt9s6s9m9t4g;79860;2;79860;0
4031;bc1q7fp67rjssfyuc3a9qw5k5tq8mck5y0nt9szt2u;133172;41;10320469;10187297
4032;bc1p7en40zu9hmf9d3luh8evmfyg655pu5k2gtna6j7zr623f9tz7z0stfnwav;73196389;202848;2865737188;2792540799
4033;bc1pyvw0f6x285lzy34vterhhnkx8dtjcj67e3jq3aspev7uufnww7gsfvctkl;91500;1;91500;0
4034;3P6tTvz3iFzjxXXwXZ3SpEtxiRvX1xRHTj;1118830;34;13539014;12420184
4035;bc1pwdpqzmdln5cvuwn3k9ugvmt7hpgh9pe8ggxu6wdkg7pqfwdud2sqs67pd8;290243;93;39564897;39274654
4036;32usS36L1BQnZA4FPNcFbmsTaGwKQnkzaa;7986468;133;296012851;288026383
4037;336XMoDaHr2j292eGXx1ekLpYZX46x5716;120963;2;311747;190784
4038;bc1pjd4fp0tmerl0q9x99mstmygpg75s5max7z9xgynn0jten32qqhgsp8acya;0;2;18481;18481
4039;bc1q7c2n6cw4jn9a0m5ss5mmzq2d24wdtz880ksnqq;2084035;53;37741004;35656969
4040;39aPRjyxX4pRHAXvJ2Bxv1z1FHstTC49ia;8806865;1;8806865;0
4041;bc1quh9jm6p06nqnvgvvv733pl0g0y6ycxl0aas2t4;8583291;7540;695618339;687035048
4042;33fVoFgpAhf7CfBM1X9WHUqgnaLSajrPYb;36350;12;161155837;161119487
4043;3DbuDxYh2umXNobct4GvPsUdTJmWe6ZJoy;806493;66;55623741;54817248
4044;bc1q8sevxcnshvpne3tggdya7at5e5d2fez0y66gw8;321286;1;321286;0
4045;33XRMDP3e5NTJ16Sjb7DeHw7uevVqrfCdG;67611;1;67611;0
4046;bc1px5rrpmsu3vxyslyalygxx0qre0v9u307zzk48ec6tmjvr690cu7sk6cugd;18532501;19;61464841;42932340
4047;bc1pnzxgvt8z262djm9822xe8csk65c832qn5tepuhvc7hlqw8xg0lks9j9acc;91500;1;91500;0
4048;bc1px8m4nwapvzmfvpjsj0qxlsaaczkr9n55w32fkf9gcyac20k0s6ws8j9wfg;8373416;3;28159364;19785948
4049;bc1p9v6x3gkvenee8cfzckggg025se55xk3a37xx0hfgtqfzry3wy76qc6an3u;546;1;546;0
4050;bc1qvwlkp5ujyld9s2gtvhph7y7awp4rf8pd7c0gf7h5yy2rafa8hyuqp7pemr;0;2;7236000;7236000
4051;bc1pv7mzeshg5e0a4jr07u6xhavclla97zguq9k2kyj7xsrruwst9u6s2qq3fz;16869302;267;104514391;87645089
4052;bc1p50m8tu0u86f60hrer4nmtyt8hcc8x3a8pug4xsucxkd4pm9r8sjseldwgk;1338235;22;5589392;4251157
4053;bc1pmzq9xs2fylgaa2zxee2v92a65ccpadd80v9cxkeu3lcmhatk7pqsh3c4qz;1000;1;1000;0
4054;bc1q6lxy2yu798suuelzpt84ksktzqkqlcm8q7rw9p;1413541;1;1413541;0
4055;bc1qyy30guv6m5ez7ntj0ayr08u23w3k5s8vg3elmxdzlh8a3xskupyqn2lp5w;1408548063;51827;177280025976039;177278617427976
4056;bc1q3z2yxe6adj53j5d4nm2ze5zmgury3v75jzufn3;1270754;1;1270754;0
4057;bc1q4zu8lfall52sncxunx2hxzvn39y5fh3dahqg90;80381;1;80381;0
4058;bc1q4v9x5x9mtlqcm8mjqx3t69qwahyujm533aglsa;792407;1;792407;0
4059;3343Wz4TUuA68ceMQDUqw6JMk12D9nR6Df;1566131;1;1566131;0
4060;bc1pf3pkax9pzmuyk9d2q38wsnk7569pqagxd8p4q5ujwnk8d2z2ldhspk9tke;91500;16;12816484;12724984
4061;bc1pjxygvslqfnljdykppu7vknfv75cars3gx6c0xelwy6kvc3q3d9lq3vzevx;874932;11;4041636;3166704
4062;36Ha8MiiWghum9j31n5KF8qkZc2m9TKAES;1278042;16;24488949;23210907
4063;3BiyTE5dPr5dMYX3dv9PiEVx5pLzR3kZwA;1223959;163;135147743;133923784
4064;bc1qtsejdmr83lk3qfh4paxrflm0rrdwx28cqvu2rp;173953;28;173953;0
4065;bc1q3nn48m3jk8ga659s6hs546tkypwrd2trx8cvc3;1200;40;45600;44400
4066;bc1q94cs5mk8mldq7yue0ccs48rsnf00m7p9sye643;37471;1;37471;0
4067;bc1pfpsx0kt3wpnt9hl6hjtam3kwmuqjdacwql2perey3zlxmgm8exdqc6rhen;6083;28;5329309;5323226
4068;bc1p883xwyre8swenw5jh7uyxqqk8l8qn966u9lgaztgdz4jj5t6cenqu3mh2g;91500;1;91500;0
4069;bc1qechc60avkj6ytmhmpsaqn7493hn6flshx6gtgn;1218215;1;1218215;0
4070;36DGGpmoRVgSEwujxkbSBYbAJZcqczUgkL;532844891;1212;538885205;6040314
4071;bc1qg3xef792fvuqfwlq5gawkeugz6njyzrj22x75z;284735;1;284735;0
4072;bc1qmxss8tndcs8y2ctwsvg3vu7a55zxce0c9n890s;83949;7;83949;0
4073;bc1pxgmqjntzgpkkc6cqz5365qxv88r5fj8sxsclj9drzdll5ze0fess9z0jsu;784000;1;784000;0
4074;3FUyVymojaKLMitxSgNHeLmmhLjFXb7EvU;2229307;71;98140429;95911122
4075;36zWCFWHt6DzbxQqECWicyA5ukfam5w2FW;180129;20;9697457;9517328
4076;bc1qrvreqqj2la3dy83rd68zxpu0shadjtch3e29vv;68603;34;3137769;3069166
4077;bc1p9pgkya007827agn04qznem9gxazdeqpyzmdczshl83zufnw7ag5st42r6j;55425;2;155425;100000
4078;bc1ps06pfcwg3e7fdns345jw09g4qrwynp56kgh824gxk8ddejd3eh5qnq30d7;0;2;16050;16050
4079;bc1q76mzcxv7a24j54r05c766lvmng0hknpnlw9ts7;396195;95;24909344;24513149
4080;3QghHqTgNL2rWCoGKrFrYP6S32uWiKJZay;99842;19;3074774;2974932
4081;3HWBDHWaFzrfpqLqTm7mD8xrd4q1Xgfb1h;1666240;33;82070085;80403845
4082;bc1p2sfc6z94h5mj6h9g60tnujq870gl0zqtpqa29gegrzw7gg6r83qq8gup24;1941918;59;8525745;6583827
4083;3Fg4bZxHT2uk3tWry32r67Pc9r6KjcMK9A;205260;7;1380633;1175373
4084;bc1p4d9lskqze7jtmazgmwqdw2h6fxkmx6658e2hwfn0f0yh8ydgc8pqy7ny8g;91500;1;91500;0
4085;bc1qpfsckufdjx9mrwjekumu9gmmgr24wd682nhj2awwg8gg6hmc9husfdp68p;73237676;45178;38672535451254;38672462213578
4086;bc1p38s6xk2rjyy5r0j0amejqvp8cu2hqtez6h9x5vdfgnz3kk2z883shmjrrr;405378;1;405378;0
4087;bc1pasadqze4928h9k43qu9m8m5chtc207r9xfxllkaagcatfvd3pcks93unm8;2003246;10;2005453;2207
4088;bc1qsl0e07aj858a32czyknx75qmk27645qxaartmx;346254;1;346254;0
4089;bc1p93fjt0qu4ass42hkxmldnqj4m3w3tu48l85vrp4fq4nv5e4exqms9ae6g7;39930;1;39930;0
4090;bc1prutwzwtnh920q8g46ndeu3utx6lctrzzvfep7em8ns25am2yg9vsfxhndh;20657522;976;20722368;64846
4091;bc1qwtp783958zz5hvk47h45qcp7uuastr2axex0a6;1524330;3;4605876;3081546
4092;36AeEP6GJQqJNmvnvHoe2KBepAoqsaimuG;1640052;454;1489656988;1488016936
4093;bc1pannktygae2rdas8cfj3h98k6a9h2a64s08hf73pfdq86xqe6fgrq39ftz3;305678078;14301;311727582;6049504
4094;3FSxa87HySYF1dWyU5t1UQcwWpCmjhnQzb;185097;15;9280462;9095365
4095;bc1qg07f26mfkz9zcxftt0drmv4uy92zn0uycum0tq;379492;1;379492;0
4096;bc1plrekn68f8nskshudke52wahntuwu4z87um4l6p3a5ct28xmx60nqfc3j37;95327;1;95327;0
4097;bc1pdrlkcjv2pst5nnqzjjxuz9fzaa46n8ldz4j2z2cka7cmyzxcf55qns0jn8;34198808;94;228452524;194253716
4098;bc1p96c2qyr39l57sqluvgpp6435skkdqlad2d4ptk8w2v2cszc2uwcsmn5gju;91500;1;91500;0
4099;bc1pclfqpka5ahstcg0zgakvkl4zctnn2glt6ntatx3dh3tcf7eupcrqt2rtk4;91500;1;91500;0
4100;bc1qxqgy4xx7kmqv0qavnafdyz6q2x5frxs6e489tx;15378000;8;15378000;0
4101;bc1qaf4z7q29hpqd337lu7axjw6sekwrumtyj0jh3v;22839989;5;62800329;39960340
4102;1LCfmHqTYNHunZQZnNaEAf2hGNgsfQHVfj;3971108;1;3971108;0
4103;3Jgf6bBDzgP2ThSVZxYWPZXWwgHFa8S2Hb;3909295;11;84183668;80274373
4104;355XJXSkMrheNNTg296cftFF824TcbvwPH;953736;24;7942087;6988351
4105;bc1qwh8gjkxckxfnkxlg26c4q26vhjccyc2m6q5zes;16100378;1;16100378;0
4106;3Chrzav6PCV5goBRnwHCkbendDqU8dPrE8;1565493;1;1565493;0
4107;bc1qffffnvfzwnuuky077ntx547vqwu6qf4ap3f87w;2829598;1;2829598;0
4108;3LWuuiFq7p8tJXMaxphYr233ceTni3DrLZ;35173;44;23295210;23260037
4109;bc1p74ngvx8mazawe6mfz4jrjcncv2hg5fn0yx4ezs50avzfqfr7v5cs2nhhy9;743307167;268;811371503;68064336
4110;38YtffzmGb1UjvczHgLTDdZPSCw69NJfVa;61820527;21;148682896;86862369
4111;bc1qfta4xxwlu0dz7ppuwffjthn047l3qxqvlhsp43;1866;5;1866;0
4112;bc1p4n3zs6m3re6zcvmse9a97udexdvhnmj0m3smdnemz8vgkchw6rlsrflf0n;39930;1;39930;0
4113;bc1pud8rpclnh7cfrt2l48akgzau55drepmdkkuchv8ymn6m5crvzzpqz3yajs;91500;9;3517685;3426185
4114;bc1q6rv9xksdv9uzrkwc884ls8085a2h3enp0wd0h9;1058023;9;4735094;3677071
4115;bc1pxr8cezhg6wlmpqrp3w2qavn04lrmf32mkhpn96sgkv67qjq8nk4shl7hl0;91500;1;91500;0
4116;bc1pfdtzqxplgx4en2es7n9emup7qmrqhn8253ulpznuupmn7epwwt6q2yve5y;91500;1;91500;0
4117;bc1pxk5tga77uwvw08pdjr2v39ty9hxhzwwd3g5jxa5ug8qej0uhjkjspe6pne;2000000;1;2000000;0
4118;bc1pph85ea3v3c2fw97r84zswrf66fzrnup232c3x3lkwep0ze8mjkfqchw4tc;802730;26;808190;5460
4119;bc1pjzzpjgte4er8szlv4x2ghdln9p6wjl6rz6uyrwejh43qvjzaatzs803n6n;0;2;16050;16050
4120;3312EVpr7Yee3hHR3iQx4T2FMaCjrjbJpU;259851;118;51581019;51321168
4121;bc1p2wjc20pzs0kngqdtu7wlt92pn03xdu94dmlrfg3nt377y4yfpngsyxvg57;10000;1;10000;0
4122;3CVqjNa9Za3LYgiKUuFENxDGWGndHgM5nb;1151898;171;73264811;72112913
4123;bc1p80ejyp2tkuhqtm2zenmh4c6kmgxa398fxsw8agexs4vvxcku2vdq9pmm6r;39930;1;39930;0
4124;bc1p6k8qku76fkrd5vsurdn64xd7gqmm29ry5tx7fnh42a0jvad49glqukkgc6;32415;29;42619;10204
4125;3L6w2KnVMMcLyFbEthKQeg5KagFdREqtey;8568112;664;1555531669;1546963557
4126;bc1p32nktsuffprllv0j93a2d3q33s0l6rlh598hynkgrt60lf6upqmqasw00d;155310864;8026;623331989;468021125
4127;bc1q6een3cuhsmeqrr2s7x6suzfq899jqfk0rur6ay;806287;1;806287;0
4128;3BKyoJPKd1eP7rBo6gzhV2bs9aCTaGApNC;260743845;4388;594666905;333923060
4129;bc1pqe59573ls8v68ywrtqa54y5dh6z6hwzkujyvn64yzz4vndqq7xjqhnevgy;0;2;306763;306763
4130;bc1qg6a3n5rm082f23djzlhe9r7xgnj33ngmlgnmla;162477;8;162477;0
4131;bc1pvh56k6rc6eag523jqpq9d3x9k53trgsdgazztszvhxgzvfec8w3sy8czqq;388453;221;41843476;41455023
4132;bc1pjp5955cjew7swd6mlgxtqdlv5ltklz53089u54z7a3je0cjqgelq6jau03;305838354;14350;311764857;5926503
4133;3Gu3zuX685pNE4iVaFa2HeBnHAfRUid6K1;50302;70;112529417;112479115
4134;31hFWxMTLErLSqCwbQ4rBqJTBgsQDS3MkN;268866;3;762932;494066
4135;bc1pv0gkuf5xd686wvn5u63aywcltyqzzg9y82xu29rdnuk5su7074kqjyh8ts;0;2;48442;48442
4136;19c6U3gaZrpNrh9Y1tGHScn6PnuoYyfKaS;6000000;1;6000000;0
4137;bc1pss3gt36el0y5c3jnfch3zjf95tpm48cp899r767w2us8js2j8llq4p3cd4;27332437;1;27332437;0
4138;bc1q6xwzcrrc7m3r295606xcjf6t6fjvumc6qg6n8u;763431;1;763431;0
4139;bc1qqkvjzttmgafhmentdl93rrfq5xwcke26l05zvg;516669;1;516669;0
4140;bc1qd2rk6uymq2mq6wfyhs6f9n9l8wpqsucp4ev69j;1200;31;34800;33600
4141;bc1pehk9nphx69jdwfughhk8src2afdaf47j0av2amrllply3eywrqhs65g20l;767696;367;862017;94321
4142;bc1pp96yhk3c7yh69vxe0a52ze338tfwan76wvw55q6hg6waf8vuc2uqzk5dtj;74377;7;459186;384809
4143;bc1pzz72ncm7v6g0tv5zvtgvstszvfjknm59fh6dxl0z9na3fnsghxzqnvu90h;1000000;1;1000000;0
4144;bc1pfa99tc8ea5wjrsja3rp0uyf22qa5ca3qw985jqgrw4wmgt2xagxqgre24l;1042159;858;1114424857;1113382698
4145;bc1qrrwek54lly5ysttafkrcsmx59df55qhcstgdsx;1200;34;38400;37200
4146;bc1plrz5hd0ejgwf8qzcwf2mkav3lm0unula5w9uf0qeyj0aad238cdqvdlgs4;91500;1;91500;0
4147;3GaJVAm2bSdGG3kG9GfPdBmwRet9wjiZqZ;515475;71;56199698;55684223
4148;bc1p87xzuvm30vl9z75wre024w2nq5gma4htjqzlnawue4t7sqslqc8qfn39t7;24481985;225;957342305;932860320
4149;bc1q2h4ze7x5y6d2rnue5csgtmt4f3xlpyrelzfnk2;183026;13;183026;0
4150;bc1p3xq0xe94fa4xj8r48eey6nvfymp4am85u4un9txg2sukkwlkcdvqsgv32l;546;1;546;0
4151;bc1qfggpsdu48e85fdpsggh8uv3y8l3lplqwsqfr6e;119227;2;249416;130189
4152;bc1p49ausks47rs5dkwyj67f4mcapa9np2azdktc7wfkpnsgh0ugkjzqyw4lvl;300000;1;300000;0
4153;bc1pvr23x9t8mndlcnymecdd28qtdd66hh4sg56q4dxgatnhvzkurx3qhfcm2c;91500;1;91500;0
4154;bc1p5y9jmp2d3vg8sfc52ngjmcvu5kheqwdkw66u6tcv885qwfhf82tsds3we8;31236142;20;99963126;68726984
4155;bc1pttssfj3xeh0qxmu7w2mvdfwurjlzz5ffc2uq8jhr2zgve8z535es6ac0z8;1146;1;1146;0
4156;18xzV3KLiVU1TcNzzVQjrUcieq3JNKztTd;1281554;25;1281554;0
4157;bc1q49s9qxy7xsdvhx7670au2yrev6ndg783v345p4;315000;1;315000;0
4158;bc1pun28eg2y0hqd70mjr5yvswnkmt60ujekdzu5tm2vxzr79gzrhpcqjqp64g;91500;9;4128982;4037482
4159;bc1pau9c4zr4ca9hzk8f6kzcxf856uc3lpw4f6eezxa0gxemc7uts5pqv9k28m;546;1;546;0
4160;bc1p59y5vl6gt40fyhdtatvp9wmuglcl3uag6ltgs83xcdfqc4wstl6ql8kwq3;2730;7;278346;275616
4161;bc1pcgmjdxr34wm06j6af4c703glzawlslvf5rqqjvxsxju0k92f3g5ss6m593;91500;1;91500;0
4162;bc1qw6jpwt83keenwul5dv99e6p98tucmzzjd67z23;0;2;1238781;1238781
4163;1DFMdE49b4aJ2Z2AdAwyGpfXJ577HPmZWW;3000000;1;3000000;0
4164;38VLu1kBD1jnoJnxbMDPP3AWfqUfqwxJzv;103434;18;6333091;6229657
4165;bc1q9c47yg023aqfyeykdr9jlv7xa9tzqylp7rtzxgtphjv2rf2jjhjsp9sjtk;950502;1;950502;0
4166;bc1p8lquuv548dqd8svtuy3sxgtr2hh5rc54tgtua0s9ru7yzmz6w65s6x5dv3;42455;1;42455;0
4167;bc1prdy4r7jw6snlh9ywqxl0r86hw0qk043gjhnlgsnftzqfqw2f8trqgzz6kz;0;2;48442;48442
4168;bc1p4q6a2suazewf6e9n8q6qhjy507nxmq0h0dgmezd2ltkglkhvrlfs8vh5du;16586;1;16586;0
4169;bc1pxjfn6j4954eg5ehj3he32etlqagt0qt6y08swxklncffrwdwta4qlkvy74;69730352;902;2713374402;2643644050
4170;bc1p0djfw3l0k9tjkv3e5x093dc33dsqrgerxmxl8jlve29822xcu5xs9q0qlg;39930;1;39930;0
4171;bc1qk4jndrvv3c8zls9fsf8uefgvxfnj7zr3qzmlke;73875202;17255;1854365903452;1854292028250
4172;bc1qw2e5tpyy2a2syklr3j0ge46v33rgguvyhq3mh0;1200;31;34800;33600
4173;bc1peftnslmvltkyduqmsg8jx7kl9weflsquwcz26ctp86pauf3j42ssk4sg77;572518;2;1457972;885454
4174;1KuwrRLwBgbhBWZknfhsASSp8CwAa4F5hB;11000000;1;11000000;0
4175;bc1pvyvfhshj6tysy0xdv4helw3kh38nqxcdxnl9zd79wza9uvwscqqq5xt5er;15870;1;15870;0
4176;bc1pvgdxgyy9p9v5nmrm3gv65e3cl25u3ps2mhckead9rxc7nqkgwtsqsuqapm;78745;6;3129022;3050277
4177;bc1p5zekk75px5dneqf4nag0448682unjgvjmwnhlz2yv9fu5d37aksqu54wy4;91500;1;91500;0
4178;bc1ppu33xxhn35jqanzhhlwltx8qlr0s6ljkrw2wuvpflgghqa4ls5nql2aaez;91500;9;3519685;3428185
4179;3GRHsVsXLD4WrF8Bm9F5ubppJK5PmdSLLX;1798881;24;23649215;21850334
4180;bc1qr98tm2w5kv85fgp5v60ca94an88f6xsmg9rxk2;166823;11;166823;0
4181;bc1qguzk63exy7h5uygg8m2tcenca094a8t464jfyvrmr0s6wkt74wls3zr5m3;285160229;899;454474229;169314000
4182;393JRjhGERnqeVWcM7LKr8JDrR5pNnTZi1;48230756;355;867323573;819092817
4183;bc1phuenfxrk3qyj7qkds6g4ammwwvw8wkzdd0vdy03sllypht9f0j2stjltm2;438466;15;7951726;7513260
4184;3P4WqXDbSLRhzo2H6MT6YFbvBKBDPLbVtQ;16613219530;955106;49998330569;33385111039
4185;bc1pnujmu968gzlxqdkee2h3fmtuzfqv62dvjvs4kukhddaz5q89gr9qng2zgy;91500;1;91500;0
4186;bc1pt2zpxx5tmlew5wp2g9tqm6f7tt3ksz9c5k2690vnj2aqgezz09tqnzlkhe;1141284;95;870914784;869773500
4187;bc1pxx9dqppeayjnkpeajvclfenhx9c04laat93mrhecs27hhc49q7hsl99ywh;3310910;4;3810910;500000
4188;bc1pltman9ytg7yum0aje46plvc7rxzmfsaug07x2jth9z5exvyjdwjqe0wp43;6000000;2;6000000;0
4189;bc1qv0q0lr9zxafe0d9ze8v38mefas85zumvcl2qn0;222886;1;222886;0
4190;bc1pe6jr05aqzk5k7u66lmshgtcajzmm63a55kaflenukgeqdcjxsthq9y7dne;4000;4;4000;0
4191;bc1qkqal68j94egm7t7p935xqpgsy96zqewh0c0rua;1384468;1;1384468;0
4192;bc1qz0kk92avuh8326cccjddv5c77nlj4dupurulql;6986530;54;104550478;97563948
4193;3AgRG5ooW7qXiUP3pWnNWUAtNrDHoaved6;3980910;2;7980910;4000000
4194;bc1qft87rzlzxfz8zspsml8l6uyv3w924q3mpual85;950779;1;950779;0
4195;bc1pxk57pnvhy7zcf5tamq9a6frz4skwlg9kmd6l90mznjrmr9dkw40q2wx3dp;424213;36;8986968;8562755
4196;bc1qzhhsgm9c8cd3y2edzp75wwccuf5j6g0twq04dm;288989;1;288989;0
4197;bc1q4x36gerpg2kw37p6zel53h408jz8aks8zvqzsw;711428;2;1433314;721886
4198;bc1q9tw9a2702ywgsxvmkv6sddypejm72vk6f4ffzt;946886;1;946886;0
4199;bc1qyny8z9xfmuh834k8w30dhtzxn2h7c29v2r4y3e;694930;1;694930;0
4200;bc1qvd6u302jmaz429m73x95e8ftfaxhjxz6z7emtv;158254;35;158254;0
4201;bc1pengklux2e8wsqkfnmuwgu745wp50e8rhlchr98sndwfp04yewmesvxmsf5;30671999;187;1829309222;1798637223
4202;bc1q670qxhj5877fuycymcmem2wezjks8ue079vml3;1183531;2;2377520;1193989
4203;3G5Eu5wBffZ82cYVjEribqFuyd7hQqqrmw;234097;11;1271257;1037160
4204;bc1qrd2jxx8wg9uztnxe0q2lqau33djelappxcfyx3;217512;85;4588002;4370490
4205;bc1peane3h2nn2nl93vz4dup9r5p9ma4qpyl8hsk3q908wlrknxkh0yq9fxve3;5460;10;5460;0
4206;bc1q2wap936ghg6huh3qec08gkv75u9zneaprmjeh7;103543;25;103543;0
4207;bc1q4yddvqtzlejg8paxw5qxyh6m8xx2waewswc0gr;606886;1;606886;0
4208;bc1qt2fkggfx5a2rh60ymuahqune6z8vlq9hrdlgvg;3678;1;3678;0
4209;bc1pyaznnnuy7raakaga2kv6lh9fxz7sush987feemghdrzfh33awuhqc5py72;391492;92;191608416;191216924
4210;bc1p0gaxcq4eyhq2efjzvfvqja5u2exz8eqfdngfqqenwzcjdxc6k8vqrl6cyy;705949;20;14615034;13909085
4211;bc1p3whyfxx68mjg058kehwmd80jq7qzjgtxx488uwpcatyscs84ktnsjq5a9n;1692727;115;78434152;76741425
4212;35VGKL4nw1JFtAtXQszVi9fqQERZWEVHtL;1097308;1;1097308;0
4213;bc1qcn46eyd59euzsychdj43qkzvvmwhpfv36px97t;171886;1;171886;0
4214;bc1q37hlhn4v3rk3wxqtrggykwn22ncu6eey33w305;102421;1;102421;0
4215;bc1qd85l3qmfmkw00vhnecjvfajv3kwkqqc0sxlvt4;300000;1;300000;0
4216;bc1qcsc8fyfzvmc0g23c948rd5l4c9cvavwef3s22w;995896;1;995896;0
4217;bc1penh87u98qcg0yuf7lkesqu5lyn20ulxxyzcxtfgf2mce7q96a2vs22ua39;305600;3;965375;659775
4218;bc1ql8k89mfzqwjaqnq0y9uxummllp6v92fkykkv78;107715;30;2894791;2787076
4219;bc1puj75du48knsy0cgf72yyk0hpezzcgtcstaxn8g8q9tq20q5xssmqvc57nv;1225991;2;1225991;0
4220;bc1quh9jm6p06nqnvgvvv733pl0g0y6ycxl0aas2t4;8542331;7520;695577379;687035048
4221;bc1py9ncqs4332tqflyr2d07g0ah9y48z9x3xjc793xxkv6j5e48dlssqshan4;0;2;35000;35000
4222;bc1q8x5q539x6kgf0r60lz8tljanjg8ec7twllxmm5;92345;25;92345;0
4223;bc1q9mhhgzhp5qa8eahvvrdvlmxwkhu9huj69dhpqp;1146886;1;1146886;0
4224;3MXjjXefLSkajPn7iAuX5KGW7nxXvCyJrH;231261;4;455987;224726
4225;bc1qfffm0mn26puz0hfq86rhzmfvkg0wlt3pydyx04;700000;1;700000;0
4226;bc1q8c4m98wl9t6hrycfshuhr5eajquvp6gwca5rdn;257443;1;257443;0
4227;bc1q57y9t7kzs0r49824fkds3z8tvd8h2wd6vz9ef8;920886;1;920886;0
4228;bc1qncthf2q6wtnpq0yqqkmkzs746eaz87m4kuv5t2;536428;2;1083314;546886
4229;bc1plfr4y08u6aawe4l5wwak5h7n6m7e9qqgu508dne52vumhhle2nzs2hqu5a;1481777;93;59513054;58031277
4230;bc1qtxkjc0y4446c90dt8l32rueg2vrhdgy53r4xsa;446886;1;446886;0
4231;bc1q6tqlpk3kftlp5zeujkfp2mnvlk9hpltp826y26;1029002;1;1029002;0
4232;bc1qdzenvwlaemjctj4jltm4ppe0sdvggltyy2yt7p;446886;1;446886;0
4233;bc1qe7g0y6xystp45llrzgne6u6l4du7lt5tfxln5t;12924287;1;12924287;0
4234;bc1puvu4qpmcehpfvrpp6q4jstqhauyt72wwq46fsfdlys0q9x6z4e2q0wxjqn;4204630;1;4204630;0
4235;bc1qdmxaqslvcvf6u82g4h050xdypxe40s2zx9qa9t;1485376;1;1485376;0
4236;bc1q4cdl3vz9q9jp5dfq9u9rlsx8hglkmwa8cddn74;606886;1;606886;0
4237;bc1pxg4esd0r4z0yy5gn3wmyj9u4k787jvc0lacet3xxmd4z6zl3uyzqkhhfgg;0;2;17000;17000
4238;bc1q64x7rane7r4fp6u6swnfl5uejjxhkvhgacl0sz;68921226;1;68921226;0
4239;bc1qrwxvhfexjz9vrgrdtvqtrm0j5fcfytj400ql3m;936428;2;1883314;946886
4240;1FWYxKvcAqF6Nze4UEEdBuFjbyGyarxjji;154281;71;36924219;36769938
4241;bc1qgy45u4azkrwpmtmh7v4ggtm0j6ftkuymwtynfs;279287;1;279287;0
4242;bc1p2pp6mpez7fkpmhntkacttkk8l05s3jrx5c6merssxk6cpd9qz4msmawrg5;11866534;4948;2078508847;2066642313
4243;3E3KwYKq8xHfzUtzefaf9uDVhPw2QVqEMU;1063431;5;2252107;1188676
4244;bc1q7fp2l429anlckava0nq4rm80zf5q6r9mwmnaqj;67927;1;67927;0
4245;bc1qhx6fkdftz3vrq7z59xjy8y82yr0ljvyj5ytk83;471376000;1;471376000;0
4246;bc1qf4qysgx8qxnlpk3zes96huz5hkf4atyapscvzt;124991;1;124991;0
4247;bc1pwf65rqv8vs5lc4dc8tm7q00vwea7ky3mhtx0lxm4vx75pazzqexqdcve2p;36369;41;35850139;35813770
4248;bc1qereawr3klc4pfllpw64x3snu82q4cepnnzdg3p;722886;1;722886;0
4249;bc1qdyhgffz6vzazfwryqfk92e6zppwr7u0tygds6d;746886;1;746886;0
4250;bc1p99qjqtus5su2ew4z9wg72ksvajhhupuw49wky599sj9s3ux2d70slem24u;65600;3;245375;179775
4251;bc1p7y3s2uugk0lt2awklpd6qgssmefpn95yy757smty8pg2y2qpl03qtnatuy;862070;148;29749204;28887134
4252;3DhV991nGH5gJnpb4BMG3ovWmeitFVMw4u;1520888;3;3166234;1645346
4253;bc1qyd3m84mdqd2swxuj5rmnvpre2ewahzz00v3ug2;722886;1;722886;0
4254;bc1qx8k5ufn095zhk4rerwwty06qvk8cwgeduxv6zf;324719;1;324719;0
4255;bc1pt7ydpdsjmjz94urfnt27nlwe0c45tta90977lxdzdha7yx0a52hshm855p;2127944;178;27621801;25493857
4256;bc1qhswmeykjfarfwewqgwr6wfn657ferrj7rf5kr9;376156750;1;376156750;0
4257;bc1padgt79g3k4a4xp4s06zfwxsmcqvmhrgydy4srfasl6ayf65kv6kssf4qvp;2334692;8;19320647;16985955
4258;bc1pk5f3f6dvn2nr5sykqhqs3zvhnqkkrwqfnytyyxvahzezgnl09g5qn44xt2;1051592;5;5201754;4150162
4259;bc1qxntlhmnw2cawpcpusqy4097jgd3m0kzjrq3sqp;746886;1;746886;0
4260;bc1qmrajylcxcezccl7q825wtqppd035jzeuqwe8ju;2764122;1;2764122;0
4261;bc1prutwzwtnh920q8g46ndeu3utx6lctrzzvfep7em8ns25am2yg9vsfxhndh;21075522;991;21140368;64846
4262;bc1q0qymlk94uyu8krvl2qaavtzqc7tdwdqj0l9fl6;746886;1;746886;0
4263;bc1qcjxarxj8dqmvzs970ayqvkse2v55jj7303z9vl;1029566;1;1029566;0
4264;bc1qwtypnne9a05l7uc9a2h8egahyz82jak6vqmrjy;57906914;1;57906914;0
4265;bc1qe4200m83cnfnp3zcl5nw8elvhcm3w34xq02avy;260628;18;260628;0
4266;bc1qgz0w2dk2ry5lh6j2ja7en85v5gs6n68tcrny36;723886;1;723886;0
4267;bc1psx7s6kewx5e4ywzd89etx4as0rzhpgxsnq3wfh2rzk5u7hs22wyqseeyvr;305600;3;965375;659775
4268;bc1q6gx8fksg2vtz5zj0hl7p8vpwy0ztvdswztafnw;817414;1;817414;0
4269;bc1p022a5yqhdtgjctj6nrtzramf90f3jprdvfqwwktsu9qza3464jqsfqf7m6;5556229;6;8835197;3278968
4270;bc1pkxc2mrm63euexp0t9xdxmlaewpvf28frlvj6trth47syemk64n4qs8r0hk;197201;1;197201;0
4271;bc1pp3p6nkr0gptv66da8n8esgksf7km970xcrdksmjexc6e8kn2penq2je524;217204;147;35211452;34994248
4272;bc1q69xw6dn6jjsg8mc4fjvjvqes250h37erjjy08c;946886;1;946886;0
4273;bc1q5r69clgwkepne5vlcqunwk00lh886tv9vrl4vt;2641;1;2641;0
4274;bc1qx98ahrxzvymcp7hnndald2c8yy8xf7lj22ph20;86999147;1;86999147;0
4275;bc1q8y46y7pupvex6t2p285nczh0t20mpmuvrpffja;251540;4;251540;0
4276;bc1pd6dnqpfx25x9a53q5lmfpllzg3uz0fpa655t32vfscmqxrlyj5ns4ssqux;110000;1;110000;0
4277;bc1qrjrvdjjq9gdf4klap85nlda9xk6x3sd6yn8j52;280384;1;280384;0
4278;bc1qejfdq3hmwhdvxuvxv8gjjfx45lwpmyksmu8lax;3640;10;1204924;1201284
4279;bc1qfxs0urznlsxea48q0xdcx7fjr9gnj50ampljwl;922886;1;922886;0
4280;bc1qnypswy2ttnyc2nzgzxg3g0gen346rlqj5zds8d;606886;1;606886;0
4281;bc1q075s4x8j6mrnmzps20hrur8gqsf9m2txnvx60f;100000;1;100000;0
4282;bc1q5rvqgqszjcgxyps5tl5jgkvqu776kdqpchm7yz;211718;2;433894;222176
4283;bc1qghwf6dz83wctqum662zvkus4h28zngfvdav7qr;446886;1;446886;0
4284;bc1qv0jugtqzu2wxjzjkdtylydyrqvl5z3tsdz9ftf;4238402;1942;1150369905;1146131503
4285;bc1q959v4t7cyxsk22swx66snvrurug4wu3mvgygef;146930;27;146930;0
4286;34Wa5h5rosAikoyrvsY3tEZG2kF5HnjtgZ;783743;8;4864799;4081056
4287;bc1ph52s6nlewfqee7tnxfytq93ufmz0hctqq0y02grquksl4g7rtpqsnvpug6;907470;1407;239491705;238584235
4288;bc1ps423ryq8zcd4sp8v6weey5t3qalaktqr8gd20kkklm24tq3anxws2nkyqf;305600;3;965375;659775
4289;bc1q6khzqvygxu06ldyk497v57lknw89ft4a0dnxvu;446886;1;446886;0
4290;bc1p2ptugta5rpqh8ex5qqjauyyl66qh3q83dg842kj3gen2a9wmdzcqxq8rnv;13061;1;13061;0
4291;bc1qcr3un8h2fyx5qvk9pnyrnxh3972k8lx0hax3jv;4936428;2;9883314;4946886
4292;bc1q04jte2dc8gux4pjn3wvluha4a9lhk5fj4pykuq;146219;1;146219;0
4293;bc1pg85z88a0xw283ulp80ada98ycne74pvwutsdmuv2935ksg6nz26safut8u;0;2;515000;515000
4294;bc1qrlqg7xry4fdpnz3xu9dmft8kysuml6uprj0tyu;546886;1;546886;0
4295;bc1qxyhdunjek7l2pd2qsumw5dnxmzy2jwcw4enecx;4559836;2;9130130;4570294
4296;bc1pz0f8rh36l6hvhsp67awc39dz2ulv47j09mznnllq2uerj0jdef8q8skwvq;0;2;90000;90000
4297;bc1ppqd3p52ngss0plhpq2mgr0ew4xr6u0z2vk6tqh6ytmr69j2h3kjqf6sfh3;14300724;93;524248161;509947437
4298;bc1p964ht2vzegd9ga6npy7y2qvx4wj9ynywdfuskuljxw984t779wwqsuxtj6;48418;36;71748;23330
4299;bc1q8ucq5649700uf78j9vc3c2yce9r3h980046kfy;717886;1;717886;0
4300;bc1pktwrjkj7umrmfcwxlqqxk7d2vg4frj8fyzjlny8rnec6rdtff8fqplyj0t;93344;24;4225493;4132149
4301;3AhyweAYqaApNX6uBEjMgnJUpKT7d55A3L;451776;38;16219472;15767696
4302;bc1palwtskh9ecdwjzmfyftcuhp37za0mtk6wxvdu33zsjcqmjt88ghqyt7vet;827916;7;2845750;2017834
4303;3PGZ7QPmUsEsbVHSqkiWVHFCCdmvKNRSay;323485;57;33421008;33097523
4304;bc1qljqx5wxc37sg3c3pyw7mpruepe8sp3mvsn7wdm;10728259;1;10728259;0
4305;bc1p4vkvn885ydphgxyyqvqge07mmd9rerulw8uvf0h3my62h0yd8llsj5vgt0;115834;39;115834;0
4306;bc1ps5hgqhu9lgw8a3alqukxtwghvaf5r8rt9emrtd42mfrr6yr7le2qeazp6h;53542;230;120903274;120849732
4307;bc1q4afy67shtgqm36qaaq6wm509ptpwn7nd9s6z58;946886;1;946886;0
4308;bc1qyswua2yfvmsdjygdfp0pnd02awd7pk93uwd7t6;746886;1;746886;0
4309;3FQrDhZpjZ99EjZcpg9MgPMns8NZPrKzXW;10000000;1;10000000;0
4310;34G7Fhd6cwQWH2hKu2eQqvbywoWFAQvFsH;98568;3;176906;78338
4311;bc1pcwzahasqm0mfsv7gqxkq6jmn00n2t63c8evnzcurl728flyqpa9swlmrve;86123;34;239399;153276
4312;bc1qp024ptr584uf5qga84dn9rl6ahemdzylvx2e7n;641253;1;641253;0
4313;bc1qhl5tcxrn29a8h9e2cyhu7nwnqnsd6c6dv25z6q;746886;1;746886;0
4314;bc1qu7az3c0346d2p50jkmhe6zpjgyl2we2vwl4h9t;100000;1;100000;0
4315;bc1qfv4a0ymjt64089nxc3tg2mtspve9zpz6z7pvlh;313886;1;313886;0
4316;bc1qcxnhudnuvcsw4el3xx73w6t4ffpxle480xdy0t;270060;13;270060;0
4317;bc1q8h0tquvaljr3dkgpp6f7rhggf6k0up2f9y63js;45781;1;45781;0
4318;bc1qxw98kwssat2ll00lmswdk09s262hcetw9l36gj;936428;2;1883314;946886
4319;bc1q7vhdwg0efusgy8hxdvlnmyu99325xcve5rcyye;12000000;1;12000000;0
4320;bc1q6mxtgr35cl6rem60jgs99vrwq9fdt3dgame6h8;446886;1;446886;0
4321;bc1pw4ksnj44k2qx9udkh46yks95pfdgyv5lh0jjmsj0tglenyu3n3xqzlgsg0;3940110;3;4440110;500000
4322;bc1pjwud0kl0y2xn3n527ekl87ptu53ael5g7n4y3jhx4aqjq330ze5s5g86yv;0;2;38311;38311
4323;bc1qadl7u2cszxg8j99wpgj8sqmh58sxfw2k0tfx4y;966428;2;1943314;976886
4324;bc1pq5z0hvxnewyz2kr40j4d32nx9tn0jx0vvdsvjnlckjekyhdm0j6qh7w6hf;15124909;2125;16273147;1148238
4325;bc1pe4u4rm33tpue835d5ly9tluj86t98xwft0zeddys6zlpy9dvly5sttgdxs;305600;3;965375;659775
4326;bc1p5sg8lugx97nv58zd3v2m20ph9t2ysu85wug4jpm7ctp605wnvmfqsmudak;128104;2;783990;655886
4327;bc1pk3qfgpx42thw6chaxmc0hkmnhpk7qr434rn32gdymudua62nmkys6hmaxa;1089397;108;30071340;28981943
4328;bc1pluhl0qpssxnwuynavjhraqea8wa6tq4kx4xdzrwpyt3fkunw4v7scxus2t;0;2;348243;348243
4329;bc1qguzk63exy7h5uygg8m2tcenca094a8t464jfyvrmr0s6wkt74wls3zr5m3;286160229;900;455474229;169314000
4330;bc1q62jn8pgatfhp0n44w05g5hm0trqllcgxw4fq79;700000;1;700000;0
4331;37zWuvfAYJdfwfZzoQJ8hF4NyBVq37dFNd;1833534;5;2273759;440225
4332;bc1pflkce49grgvafjlq069s0e3d5y78xfuzyuez63x76n5yfn8q70zqqwlgd3;0;2;38146;38146
4333;3P4WqXDbSLRhzo2H6MT6YFbvBKBDPLbVtQ;16610977444;955089;49996088483;33385111039
4334;bc1qlm0eale5w6fnd3ga5z456kad47tzxyemvh4rey;95610;1;95610;0
4335;39jE5skca19ADMXfQEHDfjnSf85KSBSwJx;2071738;1;2071738;0
4336;3A1GU3AcMnDXr2fvXbM9iVDWco88bM6y19;469648;1;469648;0
4337;bc1p85tu4trgd8cgf373qhjq9qnx6p5yc2zflh2x5nc2ar3lduf9urpqn5vp4x;2738544;132;37364022;34625478
4338;bc1phqesvv7a7rkmxh7wdy4ee3jk0ds7sejfr4u2hv7dj0sm978edk9qqkxyvz;61731900;3263;655341953;593610053
4339;39WisDXKX1PYyRRVURckrcAM9pXUWnDWDz;4313085;36;20072134;15759049
4340;3BMTovtQvFoCS127wh6qe3szj3KzZJqGbp;1468598;19;8724152;7255554
4341;bc1pzdzp7am2e99fjr5kngayxhswxfvl87ekusatgc2htc0qk60a34kq7mzvgg;2260208;554;88966998;86706790
4342;bc1peg869jdw70ufr0vtsnqazlllucquy38rv484jjctlkse657yzxcsr08jt4;425214;135;44763319;44338105
4343;bc1qcdwxw8utrn6394v59dt09zjd40zszytaaxy6al;1200;30;33600;32400
4344;bc1p884tmjkjqgpszm4kuhvgmexafwekzp9wr9dpqk3g0ql60ay0awcs9hwmdp;5062077;10;44268178;39206101
4345;bc1qk2u8c3huldkjms4h7xyjugu5xr53yuecqvl5cj;82300;1;82300;0
4346;3BwwDV91J3AnyguTBmiHKAQZaaMytUypk4;7193449;231;567116520;559923071
4347;bc1q525vkm4vmx46nsreaxva5kr068cvx0gtnhdl7c;33433;1;33433;0
4348;bc1pmgycme64uqnmsyhl89h00mw8r7srnzevv4d7rmrp4usgnkyvtqyq4nmmhx;286689;329;3718039;3431350
4349;bc1pyp0d2k8mhe9jqg472kjv6kw2zwt4tdpatw2mqtmhq459wl7pn0hq6enl77;35029;1;35029;0
4350;bc1p6lpp6zfwzquztly47kz5dgvwwevv6w73wn9alv6plmq2zshj8z4s0a8zdn;3870123;102;48778683;44908560
4351;bc1qkzj022wa6pf0sktul2ryfn28yxre3v7hruf0c8;20000000;1;20000000;0
4352;bc1q2pxlqvf5myrg63nldfwgq7703trcql5gunnkr5;15043634;88;885374295;870330661
4353;bc1qm7yrjtqcdsu5qzx48twxvz8ny9zujyejjh44ah;54577;1;54577;0
4354;bc1pn582hrvru4sf78gg3h4ulen6y3snt9pennc5dve3nhjahgtvpe9qetf376;1146;2;1146;0
4355;bc1qtgytlj2as6t2w03pe658hhaa95zd9q7d9687pa;148082;1;148082;0
4356;bc1p56ukdvda8nqr5v47a2eu9r85qyvcn5wtatz3zfmweekda3l9f67spfdheg;972998;113;1063660;90662
4357;bc1pl5lg0gm6e3lcvlcdnh52pw4tqsr729u48hqx7gukzvchjfwy2hdstu722p;2000000;1;2000000;0
4358;bc1qyer742p0xgjd59ed5w0p0ej6xczprgyrlrrtdh;0;2;1000000;1000000
4359;bc1qalyurr4g6kdy02feh2j63fzscyr8w7lee9snfq;2342296;1;2342296;0
4360;bc1qn5r89ah26sfqafrdnlsvmpu6c32972l983saju;125581626;2;125581626;0
4361;bc1pl40z27agmx7w4pjknhpxdsyclr2xs36pep8mdj39tx3zt7kmcufqgw0wus;238026;550;631368;393342
4362;bc1qgl8l7v58l4nrtapl4ms57k0m94lwzwef6mqp6g;208307;4;948083;739776
4363;bc1qa7un6k2kyk04kvpvxft8c4hgdkzs0lm5rk2sqg;323956;1;323956;0
4364;bc1q2saw839757lqyqvwjnq7dqfdsgsnn0vgt3243v;11454084;268;1083645339;1072191255
4365;bc1p9zlx5tgdk0tf2lpsyeldckjx8d2v2zr8zv3sf70297k4grk76p6s2hk8vf;19000;1;19000;0
4366;1KfYA7nHG9FDxdMmMMCzVmGUENRusNvCL6;26869771;3321;3636293957;3609424186
4367;bc1qjr242hcxnss4jygjlkmlqt7d3aytaj58we6rcm;6534590;3693;55031347;48496757
4368;bc1q03we2csk5jskdppr2ye5rvf54y9m9x66jdehme;41700;1;41700;0
4369;bc1pesy5ecnc64fk8whdalhv9ksfve6gztd2v895ls6jmxyyfrkak95qtyskn9;330684;27;8126031;7795347
4370;bc1q64xevw9795njxngf444feqf0ufs3zuvgf0psackvd3ku2zuh6stshv3uta;3288572;1;3288572;0
4371;37krVzR6pAsiUa9rhQmTYk15cQSFeuPdGh;20280022;1;20280022;0
4372;bc1p0hwtrydhvk0vd9r50azncffly5lqtxsq65j66fstlupkp8sr7rsq5kny2m;1000;1;1000;0
4373;bc1pk0g6vhprrqqa65r8f20q453muuqzs24w06c4uf2dhzpppykz9agsm4r2uq;5079051;287;95594780;90515729
4374;bc1qrqqerp9ys9suce09xwk480kqxnsum06vejad5v;68351;5;68351;0
4375;bc1p2l0x2fy2msd84nnhd2d0jksrdrhfsfrrm5us2q6kxuxttzlcp5esp392zw;483300;648;983543;500243
4376;bc1phcgy4v0ef3pehn6zrlgnp74fjrzm758rt3mcmk5vhm2lpscgq72q9fpnrz;15410015;818;326173743;310763728
4377;bc1q47pdxl38n3thp9hyu6f9yzle5tn4t0ha6geqvc;69408;1;69408;0
4378;bc1qdhnk6gq4tk7nq9jjl7wgrd0eluue8r5x7wqpxg;168939;6;168939;0
4379;3F6QafdPCY3sfzq5cdCTyQv82FBEZFAbTV;86354273;1;86354273;0
4380;3NNqWiF9osNpjV3ckfNG3miYEARFqkMyqp;950075;15;8319162;7369087
4381;bc1p9df9slrp8nva3qdt5d9js2jw77thgp328d8vevug8qutyk9sa6tsv8v7lh;541163;5;2280999;1739836
4382;16Eqo25wnzb82KEme94nkF6ujG1Zth59sy;37382115;385;301692283;264310168
4383;bc1p3yj2f0dt9zq84enccc24akq8j5m8khg8msjs3qz68hu56avgls5qhz6tc7;0;2;17000;17000
4384;3ML2NYAved6XxDdfM6bo4HLgjQx4fFM9Ne;2695937;314;1057108509;1054412572
4385;bc1pdrlkcjv2pst5nnqzjjxuz9fzaa46n8ldz4j2z2cka7cmyzxcf55qns0jn8;34198808;94;228452524;194253716
4386;bc1pcsj7twallvhrt4wad8qu9e2tfev76q8ml32652wh9nvfxx525trqe0vnes;3278689;1;3278689;0
4387;bc1pn9eh6sxkznam9vcuvs6t23qh80gp7jr2fvd77lr2t9vzw4lcslss9djp2v;989874;1;989874;0
4388;38Sk4p1CHP2z1VGo2dAyQJUug4swQ28EhA;102578189;625;5483752917;5381174728
4389;bc1phnw4cyq3gud7klkdqerg8r4vfq57chc9dpnat4pzrpf7e6pllmesq8d7wn;391335;132;11427643;11036308
4390;bc1qcdlk5kx2mmvlje8yy47dhqsmlwljgfjppfdu9l;92118;26;92118;0
4391;bc1pnp89zxw3jwlzl7mppgdqehwv7aq0tlqn9444jrwd9uu5nma0s82sur6jj2;0;8;32280;32280
4392;bc1pk6kumep7mpyldm0ak9u0d06zq764wsf9xk7zemgppnjkhp3g4djqjrerpm;57736;309;320505408;320447672
4393;bc1qnq4v4qx5qcnlaxfnxudynkjah2ka7fvsr43c8s;468988;2;954216;485228
4394;37twrYEWdurcNTfNebV7EVRuBxVyWPtE7j;4352685;1954;228299740;223947055
4395;bc1qhcsf0fhg5r2q8frdckahl7p0wfnf2wwrd7cq64d9ra7w0eree8mq8qy880;1981262;1;1981262;0
4396;3QqfvsZ9t3M1aqKW1gTG5u7uFVenypUz76;78485340;15;173400624;94915284
4397;bc1pqkuf06fa99aatgsrnhr5rl5ckye8g5l380wj3xrfn7a777s2lnrqll43kp;1000;1;1000;0
4398;bc1qudn9h7lpkzqxgtrtgv3zdmgqmmjy6dxzu4k688;82099;1;82099;0
4399;bc1q0x40grtrmy8deyhxefnq2t46lt29yva5j5l2pl;17067;1;17067;0
4400;bc1pg6vuqkuud7kdhv8pxe0w42t9qhalqrjpq3e9gsd0kawhxjd6eqgshmf7st;1000;1;1000;0
4401;bc1qlcwk8g0kwwcauaf9tc8g5mypc69kckn3ckqxjl;0;2;9426946;9426946
4402;18m3qsb8tKE34ki7Dufy6Ewgn86pyZZWif;6900;1;6900;0
4403;bc1qzqdwv7wg2lu3wu3mkape0tz62s7h8cnnw3u35p;0;2;299217;299217
4404;bc1p55kajmrqazsegqxwcf5ejg2m3g2u40msf5l6l2z7f06rapw9s9sstrpvu3;15573640;3;30187931;14614291
4405;bc1qvxucf0nskrq0e8cdhj9lmdzzrl3h23pnndajz5;1200;42;48000;46800
4406;bc1qdp9lf0tjgunns20y7xt63jlwxps0g03ztuj46grpnjq8p5avqzvqsg74qc;45730187;1;45730187;0
4407;bc1phwz0pv3628cr7q09ntertzealtj9sst8jrfg5s5vh86305phx9rqtk0jl7;1907215;779;2485390;578175
4408;bc1pd27l32y73jest20n9yf72vjnnzfaa2sqnt044420d0d7zz5hgpls235r22;10717449;2036;1003193869;992476420
4409;bc1p9xmktkjeqw6ld2t5444nrrgf9s6q2d6af477muqf6xxmva6lthlqhtal3a;1000;1;1000;0
4410;bc1qg04f867c09ffd02sa0j22uyjjf69607qzkpzu5;1000000;1;1000000;0
4411;bc1p2zuhsgqagl5mzv2gkacpr26q4k6r6yt2mdafh9yms87g8qvqqx0sama0ap;2272923;752;47508632;45235709
4412;bc1q8zmumvsjq90vj2xtmrmk4yf3qfj488k8dwxvya;160000;107;6186800;6026800
4413;36d8xoxRy58f65XCUojYWNU3HKTt81m1jP;38862;3;110930;72068
4414;bc1qfsuesrqxyrnzf9gs7cg8dhnxdxrycmzqad0jq0;1139053;1;1139053;0
4415;bc1q9euzpx7ft3v2nqvwzf8sq4xcu0yqkljy3rlltc;33466;1;33466;0
4416;bc1pwz9ssw0rkaxevw2m305vdnjuswh5ha3snljyrfajf3kzg7zt9hhqcld57k;1501516;129;42956134;41454618
4417;bc1psemwltnd4j7tryhwpm4fsyqual4dr9te8zvmv3zl7yvzx2x8rwnq3j2lx4;405240;228;472747;67507
4418;3PdwT7NnZKfP2wsUUvUBbD1R1eBJdR32gi;34806265;34;200810284;166004019
4419;bc1pe7xeg80dwp754s82skmwknfxyj7rtsjgkcpa0aq3faxy2uuztgmqt5p44z;239083;313;747860;508777
4420;34VRvoNUXTeb4Ejqi8Ddc9dPLx3b43Dejc;81966;251;16238200;16156234
4421;3BndgR8AwFph8e1z6kNMsDxbx9K7tCu5c5;105245;23;12140402;12035157
4422;bc1q4jq8p34263vac8urzewfwz0n9m79zqrxd482lf;440962;1;440962;0
4423;bc1qkfr0v64vfx3srmq3ynp4hrtkpas6g7t9r6jn8t;3447692;244;943776193;940328501
4424;bc1qd25dvp8yyn25slr7f3xu444ad8nyslt5u46ktw;103958;7;551524;447566
4425;bc1pn5av2tjvddxnuzqdcs6nm0tp9w63la9lwueht2qrtw60y8ydx3dqch407c;1000;1;1000;0
4426;3KV6tZLd4u2hRQmNAafKfaUW55CzeGuf42;2150481;93;2230005128;2227854647
4427;bc1p30palhswcpzqvfkm8zdw5jy3etdgjjkja3qyk638ca9ujp4npr0shvmn5l;398200;82;7987989;7589789
4428;bc1qmcuex6p8e2q4elnvh4efx8muvwee5fuqyf6nja;51244;1;51244;0
4429;bc1qrw5trll3jmuc92pdfhxfz3kxugt557fq7eqwtv;88050;3;88050;0
4430;33KVTosdYUs2zsfdbBsAhhnuV6PbinDQmc;261234346;659;18403403196;18142168850
4431;bc1pwfjrhwy8ksywy9g59xa2r7j9p3jecp754485q8n78nepcjwnmqnq2dqhka;2977110;2;5977110;3000000
4432;34KVRcZrdcVpWeSSyfrNY2HC2pvykFLDqT;9585096;885;32155635;22570539
4433;bc1qy22v0unex4lek0ettwzdvr89gjrmmnns2e7xwn;0;2;208709;208709
4434;bc1pskz5hwj09pgwucwvvr59c5fdlmgtsqnfd887uehkdc7z435ya64qwf5xl3;10067126;28;52597163;42530037
4435;bc1p6lfh9tqgkzy9xqhjggca2shru8f2rkrv008pj4zc3rvp9xput7lsf8mtvv;951180;577;1058280;107100
4436;bc1qqu4sn4rk6su8szxeawu4h499fqnr3vjfl5866l;1200;33;37200;36000
4437;bc1qmq5jdw59hv2fnzvsnxfgckrmkfqytel5m5td7c;57953;1;57953;0
4438;3PGZ7QPmUsEsbVHSqkiWVHFCCdmvKNRSay;323485;57;33421008;33097523
4439;bc1q4vcaqz8vr4mt9pl83xzw8sf7durjsztryahtlg;615528;3;1915528;1300000
4440;bc1qzw47dk5rhnfccvxhxxd67ejrvvgd7z2gzzl3ta;1141781;65;26680867;25539086
4441;bc1qna6utjw3lgs883twtpz82fsu8vkec2qgtzv5l4;293197;7;293197;0
4442;bc1ph0ju2hdhc4dpgvcxq60d4z5zffk9r7hwah2w39p2w3jajwn3qn7shvfztx;1000;6;2356272;2355272
4443;3L86Z7f6SzzY3nAtfEcKj6L2AsLfQTFmTu;488768459;408;4416614973;3927846514
4444;bc1p48ttcp0fgrmjrx7a6ap9nkz0uzuu9kuhphgukfuxlr7newghq4fsfs2vx3;2400000;6;2400000;0
4445;bc1pgf4p2e83ynufnmle00m9lhypdqd3grr3ehrynwt5xkzyktrm3ysspupxcf;324314;348;47113062;46788748
4446;185fbnsHQKq5cPWW7U1eSFAE1VUqRJyXYY;1700000;64;95728000;94028000
4447;36UZq1t9fraPVjihrYp4qHwLe1DLhqwLfo;15094890;55;112685899;97591009
4448;bc1qr7jg0ujwl0dc8dnz2f4u7erjp6lkqqejkqs45usmslj0d6x8t50q6kry7t;428318;1;428318;0
4449;bc1qaymr4tp9pzn5f8hetrrnsgk0ay9832lt643cam;5000000;1;5000000;0
4450;bc1q2fpefevecxdapa0mhpuu8324kvxjcpyxj8xyzn;722005;137;81868783;81146778
4451;bc1pd8jthkfy7tfrwj4n5ssu8k4svak74qynps8lxpwq2lnn058dkd2sw4akk8;842802;1454;978928448;978085646
4452;39NcWg3Xe89xQcfhYr5fkZRfmXPNmPoQm1;180358;24;3100272;2919914
4453;bc1p42kll686yz9y3j9fzdwmwqz9vzh4me3sdr6trzlcwfu3rd20xkxselvnuf;142328;166;13974488;13832160
4454;1MrHct9Fn3PzBFVwbyR6vjTTD4kv95LdqF;3164500;1341;15039728169;15036563669
4455;3H7tojdKbJ186DFFc5PPHrgmez7U22zWC3;2098794;301;268322379;266223585
4456;bc1qx5vc8em4eafyx4l7xz7mm2mkx8rvh0n76qfw2c;23859;9;3490821;3466962
4457;bc1plvfpl27w4696z36dkfddvcvagju4268x7rgdpup8smnyvxa36w6sckhf8v;200546;2;200546;0
4458;bc1pah4p7rnaa0lk4q3hu2cs7sgyl7nzvt6yppl530n63s35majq6nfq8dzkl4;367141;15;1497317;1130176
4459;bc1p6g6puu3xmpr8wqkmczw90yh6lcl8vr8au42m8h7w3ufwcvmqw3fqawpv7w;4387808;593;284962193;280574385
4460;bc1pq5z0hvxnewyz2kr40j4d32nx9tn0jx0vvdsvjnlckjekyhdm0j6qh7w6hf;15124910;2126;16273694;1148784
4461;3QnbiP1qXXsqvVTKgxHHBhTrX5dpThLif9;0;2;187286;187286
4462;bc1pquz62anahzfwnqf9wagynvdp8hv7ehy2agxlgy72h0hxs058zqfqk8ksyq;25197675;105691;328911053;303713378
4463;bc1q644dwkafmjk0kt0ktadrel664x3dczmw6sw2c7;114793;1;114793;0
4464;bc1qlq49t42wqegs8w50wt75larvn27vps7s6xjtup;38458;1;38458;0
4465;33JMpyNjGMkBQgsoLduXeJrrPUp1fYEGcD;9227232;1230;7762629474;7753402242
4466;bc1pu7w500lduh22rek2puyvxph5rd36ed6fvzzp7t88dkwvp29kapcsvjqz68;21545;12;32295;10750
4467;bc1qguzk63exy7h5uygg8m2tcenca094a8t464jfyvrmr0s6wkt74wls3zr5m3;285095689;897;454409689;169314000
4468;bc1q74j8zfdrmpcyxr926qc9xrg9npmf0kdqwcepuc;1200;45;51600;50400
4469;34SVDtffKUTcUu7x9t4ygecEPMGdZPoWU3;567973;18;217508866;216940893
4470;3P4WqXDbSLRhzo2H6MT6YFbvBKBDPLbVtQ;16615275105;955120;50000386144;33385111039
4471;bc1p8ytpvedz78vwdchdauuewrvvst55x4nzlw07c678e4m5xrgt53qspx9ssn;592990;13;8326087;7733097
4472;bc1ph8ynkz9sahh9745s40v20mgcxc5wvt3ck668t42uy23wh4wuz86sxe2d97;10000;1;10000;0
4473;32jTBesZx2pRKUv2hQhiBYCirfELpedo4T;215669;177;850930469;850714800
4474;bc1qsta4ypnattutn44xt69sstupuswjl8ggzgc6e8;1263021;1;1263021;0
4475;bc1qx9ypla45lnsx85wqyejsenqdlzes8z4m659jfe;282670;532;990752050;990469380
4476;bc1qqcjqlskmd56jwz28pltzghwwgzjap99s252dqc;34266;1;34266;0
4477;bc1q37t8khvfuxf092njcfpfe420rp7geuspxqmnk4;0;2;3997888;3997888
4478;bc1qjyvcmqvsq82vvmhtp9z63m7xqnwra0gdxuregq;653630;11;82028898;81375268
4479;bc1pznec88zy366vmkcaqugax4e4whz8qr524lskf35kpddth42w2lzswm7edy;491425;1139;21321294849;21320803424
4480;bc1pdjk79f2j7d7d3mct4087wgu8a77du4wsleljm0fzcjqcsw389llsesly2j;0;2;47697;47697
4481;bc1qa6akwschs5fgrs29vekvrtkzqx0rheaxp087lw;18226288;78;18226288;0
4482;bc1pqs7sl7s3ldpd22z02kuye6hdhuyutthgasag24pdg0685pe5e6vqa83y9q;20168062;156;271715376;251547314
4483;33EQ7EbeAxFerCVJpstrKSTAin2FnqjuVE;11271255;696;614460040;603188785
4484;bc1pju75ehad7glrkehal4j6hhz0gch4tut672ly63d56syuwnq4gz4qm09t2t;1000;1;1000;0
4485;bc1pclpj6appxaa8q9ah5fzgydjnkvzwuwrt7qknhyty59l22xn652gs0pczu4;25429177;425;7230627530;7205198353
4486;1NV4Y68ZvNPYkYpwPzPtekbyL9hPNQGvaW;2074693;1128;321357301;319282608
4487;bc1pluftdw07sdljsmtlnczkmcra3nv7t53lm9q829cpjna4qnwjxmrst5yvse;8175020;14;18868668;10693648
4488;bc1p69jcgknuzdlscuqp8xaytn3r3f0gd0ntp95zqhphagqg9mvzjfcssj7tgx;242022;12;54872114;54630092
4489;1Gxrb7kkUmbCpXxEoh7fVhYKPzZ3y1o5wA;13975;1;13975;0
4490;bc1qzx7c9ph06rc2ntwqa3t3qj7wlvmg6le8g0qm34;57722;1;57722;0
4491;bc1qfq7dtqkply24jyn77p8rn25smh07tlzzd6dgra;90644;28;90644;0
4492;bc1q25f0e5snk054fzgtrdhvk0gxguemmjrepmlvn2;1467295;1;1467295;0
4493;bc1q046tyv9j597gyqz3g02qudnddyy6j2zftr7230;607918;1;607918;0
4494;bc1p9pptgzfe4fzmehugluuwurtg72h0h5ugsvzfn4kc2z4tmzx544eqzjlca4;632489;14;7668385;7035896
4495;bc1qlxxt0f5p346a3cdvpwu8f92d9c4ems8m6hp8k37v7fxhht50j5wszta5ax;0;2;87999;87999
4496;bc1q09t9qtn4svzjkg9nuwyt6f5us77zzw2yx8h60l;0;2;1612392;1612392
4497;3P6XQdfVFLoUndNuR1ehd8jw2cwbqb8Azq;338167;111;16833907;16495740
4498;bc1pva3ea52a0e9499yzn6pfxgwgfrkhfuz4v27mlz4es0kkn6cj0edswhn96s;4890404;23;32147985;27257581
4499;3K6dbPmshxvELHedrYEAbztJNn4vUJmoXL;304742;17;5076998;4772256
4500;bc1quh9jm6p06nqnvgvvv733pl0g0y6ycxl0aas2t4;8575099;7536;695610147;687035048
4501;bc1pdmlaz9g894rlk00vf5wkrqfe6gg9d8453c0gc02p3quaganvjw8qzt5qce;1000;6;1888029;1887029
4502;392zZxhAuWCRDL4g1UC4GmbYe4u8jQk2ub;54991954;471;1043588069;988596115
4503;bc1ql0syu8e9fxsz6jsytaq0kxz4nu9yy4q4u40ds2;47072;4;120570;73498
4504;bc1py0tylytk3nrzgrhke90qkhhc8uzhmfflje69jdcu0mtrqdpd67tql2l08r;0;2;117666;117666
4505;bc1pq6k3tp2a5qgu4phsx306mn0jgy6deju0jgk2zhfscs7lu3mcan7saeef88;1000;1;1000;0
4506;bc1qz4al5z8v0p0l68l7caxfdvt4fjeyqtwm38gvnc;7154;7;27502;20348
4507;bc1qsdfjnsaeqymuh66x5nssaxan4heq03q7ndsxcr;361428;1;361428;0
4508;bc1pr52yysm9zfu33l2dmygfgtm0wta4wmqvagpkpv4e4f40xpesy2hq5gyn43;33243;7;2999237;2965994
4509;bc1qfr7h26yf9022j6kdxpzt8awd4f6rksd0l32yn3;1200;34;38400;37200
4510;bc1pznccgez2ppzdu3npfa98vgq20e83xaqs4m48plcsz2qr8tlxg3mqf96mar;9026751;2098;916625131;907598380
4511;3FpNv6tFoYq3BYxCV7c7bgSuW3DLMVyk3S;870299;4;17342693;16472394
4512;bc1pyd7234dyc60r0j30yq9v2s2jn0fskw2uy9pnh6pms67t499anpssx6haxz;3015;1;3015;0
4513;bc1p4xed9rmg8nlys2l06mkunyhjxhfx20gaga5prqcx7085vajcu2wsqteaye;1000;1;1000;0
4514;bc1pvpgcu2p3692rpn0r0vth9vwurxpyq0398gk88y63m3lea0nrq7fq0pktyy;435936;134;16246910;15810974
4515;3D1embyMmKYJ3bNbG8h2kBC4bALuMjHpan;296715;3;1232713;935998
4516;bc1q840j9v9mpq9yutpgyezx7fr5n9ez0xfzelaalm;2514;7;19572;17058
4517;bc1pp3lhqgn5ue6su3n7jdrrgxwht378u5htheny0kf4vhe8gnm6tkgqkmvxnm;1980;8;3090;1110
4518;bc1qjr242hcxnss4jygjlkmlqt7d3aytaj58we6rcm;6534590;3693;55031347;48496757
4519;bc1pdkspf3dh5czns8cussf6wk0e837yu5h8q6w9tzn6n5mkmx4008cssnm0sc;1000;1;1000;0
4520;bc1qpvkjgnln5wns87vjukmxnl7srmmgaaas5yk7ev;379851;13;6830086;6450235
4521;36DGGpmoRVgSEwujxkbSBYbAJZcqczUgkL;532622891;1211;538663205;6040314
4522;bc1p4evx2shf3tm4fn5h58ggyla8nqyjv5meynd6wuprhfv5gn8yc5aqcl8yf8;501000;7;2883728;2382728
4523;19XEXayC1JXrzyF3vbvKuqG9GeQLMBeHez;3743;5;15118;11375
4524;bc1pew9prca5hkp6xrvg2n0n6qan24z9gd5ldez02d8atp3740hrjfasnl9c46;43768067;153;5243909132;5200141065
4525;bc1pk0g6vhprrqqa65r8f20q453muuqzs24w06c4uf2dhzpppykz9agsm4r2uq;5079051;287;95594780;90515729
4526;bc1q3xyf094al9adlhtwcw4psc6lgp8lydfpguqytv;9540;2;9540;0
4527;3QYJfBCYqyeV4GNeQJS3Hd1zcm6Cfxrcjb;168074412;509;469189421;301115009
4528;14yE5K3gu8RyEeecuymRNPrqNuwuAdQEGt;8612714;27;8612714;0
4529;bc1q056nqfyrrcq06fz2gdcu8pz56368ut5fkuhp07;42792;26;2978603;2935811
4530;bc1qqt4epgcqm5xpsxy5ckjhw3n4u4l4ytg79aew6v;0;2;268593176;268593176
4531;bc1qa34appkhf8y2xnuqwsy47g6nr34yjcekvd9nct;18345;2;18345;0
4532;bc1pc3c99s7gmuc68qcsxgnx46yzlytqy8x8yx30hgsxm9e837xmrqdsyln7wd;385673;29;19405054;19019381
4533;3MBXdkZrNfhrMDg712wruAUEjp9Ntrc3JU;9859281;1;9859281;0
4534;1M5WEuHpuJnFvD9jH89pr5zQbyJHKpT1ci;112489;1;112489;0
4535;3BmUN7aGZ1iepaB46xSDYMgHLmC1JPp8mF;304604;1;304604;0
4536;bc1q9emvnh3ewmzswatrlssqlv3mafw8pktk0mz6vn;41624721;1;41624721;0
4537;bc1qellm0vtt0xtk42ryshced5k6jvts43cynh3qwf;226648;1;226648;0
4538;33mmbA49Z3pBTv3A1uvwWKoqyZMa7UyveR;916883;690;201544754;200627871
4539;bc1pymxqfgypxvldxl0wun9ryf53ugzgq6zxj4aklhqdnsagdgj08erqhz78vd;40201;58;78927;38726
4540;1MLxes4Jvxzb1eVwYN15tkvzDo6Kkw6x1w;6568;57;679649;673081
4541;14gnUiSZYDVVH9GPin5BSRqo2svvHLCMBz;95745;22;530812;435067
4542;bc1pl7qyrm9l0kuczt05gqv5p5naa4a9jyvmuw2rv2xka2jtl32m7t9suj8k2g;677461;6;2416527;1739066
4543;38xiJZahVHEnQbRzXZiHceKz4ZPvajc8LT;12461;11;59989;47528
4544;3AkXc2s2nqJE8j29L1wVDgsz8jt58oWJwP;224023;11;224023;0
4545;bc1pfzvuk4zk9fzaswwh4x8aztlqgfeef30qj5cddvks8vr77ntm7k8qlz3sdc;10000;1;10000;0
4546;bc1qrepyckgqm2u5ah6z9lc9sdxe5swsv5qgdu7r3q;788820;9;21573205;20784385
4547;bc1p0x0amhl4hfja5g7ua5vwyjx4lxrzuk9qeff8rk06fyxuuly0uvwszn2f23;546;1;546;0
4548;bc1ptsxwe9c5ajd96qs3u5pvnra27smluae2weaw66z62yqynwp3xlzqxf28nt;11000;2;11000;0
4549;bc1qd805zvw0m5et8jrr4zwuwru5x0x0zrmvehm4e5ewutc2t9lxed7se80lus;150557;2;150557;0
4550;bc1p6x70cjjpmraktfqdx808td78d7rc0yz24cgtys2ew5lfu67er9dqedhpqm;151946;56;65298733;65146787
4551;36m3Rp2KB7t5NT5dTr8wVqJMMGnqqNxkBN;88825;12;88825;0
4552;bc1qdcm338v5e5j7vklxtp4t2r55dkatsyamfl2ss2;2837968;419;156760225;153922257
4553;33zc7To8e3kgYJoVnVugpuQR5DEczMqRoU;1308567;796;495070472;493761905
4554;bc1p68da9t5dalfgku7enduyptwysyt89dmnkt08m3hteeak6shg7qks06xntd;0;2;18000;18000
4555;1BmMJNxsummXpfXr57yN2REgLUjH7HNoop;3377;1;3377;0
4556;bc1pexe3urzuy0l750l9nhxjrpcdn9wxtmqgfdgkatkfq9avtult3ywq3xnkxn;1598518;173;184242439;182643921
4557;bc1pk8jzu5kjlufwk2ugm90l9z5ryh7m65uat5apsfm2a4ceywv2a47sj9jfc9;1000;1;1000;0
4558;32bNnmFVQyodMtj7ErxiWvxBdVrcFo7PjX;312792;15;2358992;2046200
4559;bc1qjunfa7ygxlh3sq4uld24rydqaqplezj5rclsqh;41173;177;35370506;35329333
4560;bc1p7zzzfcpnt9p9m5q6ftw7fggqsvys9vcqhxlav6qel3xmcflgcx6qgwl7la;436620;4;14800250;14363630
4561;3NiE2QUYEkHLUWWrTJUHnXipp7qEgCk4V6;835333;164;178817912;177982579
4562;33QrSU9MBpemCr3mpaj5tMnePmu46BGTKU;235816;46;3993887;3758071
4563;bc1qh4r9r4nmt544zkwn3g73xt0wwnp9s0udxnevg4;8666;1;8666;0
4564;bc1qy8ymx4qjjc7zrqmmk24tws7n2qcrfr5rklc5rt;213064;79;31779700;31566636
4565;bc1qld2yryzzw3y8eu0qavpcfswes9aae5fzkhf84k;336945;1;336945;0
4566;bc1pfagzhsn5aweesj40x4e4s45xxztqzjvmdljfcrg7zra0e2nr9dsqmfp2fn;1000;1;1000;0
4567;bc1qgup7xyvz6c8cta9vyauwefeeplzs8gr9svugpj;0;2;269061262;269061262
4568;bc1p5lu8qttr3pe7mjdvxmflku0hfv8yve9uqjpj0lu6kcw6p2ykefjs8zqxd9;330;1;330;0
4569;1B5VZ7MTpSZz5TzPHvhrfYXT2whEfM5DPa;14195975;1;14195975;0
4570;bc1pc6j26puxfms3u2ekdd8lxj6vshyuusw609unyl06x9wm65lvtutqac7cxc;65883423;1651;6183463391;6117579968
4571;bc1p6l4slrmlke0yqhcl37zs3lpd4q3cn9s9n8xhmjm3seycszhx2lqsmfm3az;77552;4;177552;100000
4572;bc1pjtt4z3f7w9nuph583h7mxsrdlf9nvjsksv56l06vhrlsj6s508ks75akn2;639690;39;3179467;2539777
4573;bc1qqfvkhzwf0f7dh06xtsykqt9lmxza824x3sy5aj;3183459;9;213399697;210216238
4574;bc1q566l0tmqhh02d5mypq006l275xytqer4hcmye3;0;2;106589689;106589689
4575;bc1pj84czvznynv4uyexlfda57mv2r63apmvn5vz94tuqlvgvf6u3chqlvrx2a;104066075;1183;4210612935;4106546860
4576;bc1qyswaccdp5sm2ndp7nl5tnknulxdf33550lu3qt;106625;28;106625;0
4577;32aBKGzkoXJnNL5MntxxaTnuPSYfincqbd;27984665;466;1500334105;1472349440
4578;bc1qe3l2g4e4jkcp7q5998dnv4ux55h5n04qyujhul;988096;1;988096;0
4579;3Kc1xKaE1D1ZaauTBkMGNqFp9AKJFZxmZB;4452865;70;73803189;69350324
4580;bc1qsjc2f2sejsrpsy3e845z9z43strpm044xvd4t5;0;2;267557172;267557172
4581;bc1qfy6ser43c28tp75l5t9r60ef6e0u5s454yhwce;1911832;1;1911832;0
4582;bc1psm4yf2ltxygwnurj9z4n5ycn83sa7dtsx7wuqgv5jpqtwretyn7syy9mf5;9000000;1;9000000;0
4583;3MA42jRo1Yif5WW5ia5UeupSRxqQojKwLB;7261866;31;11689906;4428040
4584;bc1pqgd39wlywa0tk6ftcdwel9t250ykuqm99vr6x0cfr9g8065a6evqanuh6g;19430638;5;24905638;5475000
4585;bc1q2ha6jhhnkcck6veskm3z9p4g999r39npa95yj6;0;2;267278681;267278681
4586;bc1py5geje5cw4ea7y9qz6k9lqhmnr2egn388fhj6mcznzajr430wcwq0d3qfy;546;1;546;0
4587;bc1palwtskh9ecdwjzmfyftcuhp37za0mtk6wxvdu33zsjcqmjt88ghqyt7vet;827916;7;2845750;2017834
4588;bc1q0xm2lg6fvshy6u2g9dpgc6wycjxg7hjzzg0ge2;116817;1;116817;0
4589;bc1qx5vfgwkfwf2yqrxzf9jjxy7t0xpmcwp8q3tav2;297251321;2527;1008905046;711653725
4590;bc1qzgap5aga4rq09mv5f33vkhvg2fzl7ngj0ylljp;326489;33;326489;0
4591;bc1p8u5w4cwhsq6raf20ngwhzgrvdf4j8trxnk46d9mp57fr9yv6n8nsts7ev0;317064;627;1533063;1215999
4592;bc1pv8qlpagsernplnrsx3j8d37zztcyv8ke0ppv0kxjgjvzxxqt04ds0uc6xw;1092;2;1092;0
4593;bc1qhsnnjwa7gvc8j4lcnlq7q3fscn3ceeer762nrv;14510001;500;189632904;175122903
4594;3MBZtxyy1bWPLB6fArWL8wSWmcAYio5yoh;58485;6;1166206;1107721
4595;bc1qfsp4nruwmehgdqt0xde8yd0c3faq4exwfe7g5g;3631984;19;27555651;23923667
4596;19pzmLmmoZxxa9GK8WvDqKGH5bwHNAMd38;247144572;1930;14880803474;14633658902
4597;bc1pmxd4qncaecdwlskdslaylcr407qtmykusxcvd3uyydvwr3c50dyslgq023;2730;9;3822;1092
4598;15bhEcin2BPTgvSrAdmXWzF29k1W8DZdtN;3179965;242;53337680;50157715
4599;bc1q3a0nrp3uh02xtz97za7fjwyxr7jy968uu5lu4a;0;2;267332983;267332983
4600;bc1pu5l2j7m4787l9ct6wzraahgjzghag9eue07e4pxjly4uuz2mmcmqr48kzj;1000;1;1000;0
4601;bc1qs6u5tqdfnfhn8kxgxpgy97c20sdt6qj2l0ye4e;284930;3;1144950;860020
4602;bc1qj3r9k9y5vs4v4936pa2f4hqarjstcq2d0qzhzk;287363;3;321363;34000
4603;bc1p00nk9emvgclp8w3qcq9ercs4fq87y2tsfvz6jwk7gfw8wtmyw57s049lcj;3809173;30;13289164;9479991
4604;bc1pqcljmxnqhmtx943x5pn54ld6tt9n4n0u0zctl7lqgaq82pm4n59shslsd0;28814;12;29360;546
4605;bc1qux74lacjhyju66rtrdkjj6tq9pjr3asrwwt7ma;403094;8;403094;0
4606;bc1pq5z0hvxnewyz2kr40j4d32nx9tn0jx0vvdsvjnlckjekyhdm0j6qh7w6hf;15124908;2124;16272600;1147692
4607;14ojjzkAtMEcV5ZYq9QAYD6jCGDUghV6SW;8590;6;20440;11850
4608;bc1phkhr6dg9etzyqyyjwngr5djfm5wwd3mekev43aydjcxfvhm48r4qpa5d2q;0;2;17000;17000
4609;bc1pzdwanwcz27sgkc8kxfn6j6m3h62jn92zchtnfuak03v3k0uw7g6q75xy8j;1000;1;1000;0
4610;bc1pquz62anahzfwnqf9wagynvdp8hv7ehy2agxlgy72h0hxs058zqfqk8ksyq;25197675;105691;328911053;303713378
4611;bc1q7wuqdxceqd7hnyr935puljzrqhr49emqm8zl7x;31208;1;31208;0
4612;3MNH4KiM88KhRx8UCxxMJFZUxefQmgWU5N;136509261;64;949202983;812693722
4613;1NsszYjbfUBjzekBHgm2QpyLCskGZFa6Fy;13917;1;13917;0
4614;bc1q5pqhf2c5u5da6cpw657qqnq2edrrlqjy344txf;127857;1;127857;0
4615;bc1qxhxnlctj6p4w0t28ndu5fahhp6q9g674ycls3e;305210;25;33311312;33006102
4616;3Lq6pd3mVxBYAb9rzTRr7Vi2gvZ5TnFFHL;2112511;3;2112511;0
4617;3P4WqXDbSLRhzo2H6MT6YFbvBKBDPLbVtQ;16612123272;955100;49997234311;33385111039
4618;bc1qwzzt57xqp8ycjqxnw768y77acyaz0jjg590gqa;8176180;236;259678065;251501885
4619;bc1qa2gennhtz506g0dae4q35m2vk3hdfhk86c9vvd;32000;1;32000;0
4620;bc1qt6a27r3mhcmekuen83vj264xj8vhne0974xd6y;3187111;1;3187111;0
4621;bc1pwqh3d22uy85qj4wuqf5tuvh9nujkfax6n6ez7kkpd4yfhsvute9szqyjxt;546768;82;141239735;140692967
4622;bc1qsyjtupngwuefuhsamkz8qjdtr7nxmkwgwh74nkwn9jut5uc0mpmqzk6tfc;0;2;535778;535778
4623;bc1qd98rwfkwy0z28vv6vxl5nsj7rv745k2gtta997;100494100;1;100494100;0
4624;bc1qcha4cgp936rhdnj9kdhz49ard5kfpws8ytvk93;331214;1;331214;0
4625;bc1qn8urk2pcjs4nyky408ql93lguzrud6ln60740t;1014322;17;4410754;3396432
4626;1N7z55HPURjYNYuz1dtRhfHT9hhFF5yXPD;78641;1;78641;0
4627;bc1qcxsu7k34ctphyw3ntsaavhhakuvhghqu0nyef3;58926657;1;58926657;0
4628;bc1qaew2fxxy20vn8jhflwgjyzf5csdy640nq6xe9y;194145;4;194145;0
4629;bc1qgh4498g37ck0045ryfdtr250p3jjsmvfcqgk3u;131930;1;131930;0
4630;bc1q8rptssrku92cwngkqjjvpclgkp6cta8qt9wzr4;0;2;12264987;12264987
4631;3NaRTbQVdrEYdU3KQgYsqLcrLzHAUKLkex;214124860;123;1387785851;1173660991
4632;bc1q6zazapmvw6felj0xkpynadge8l06s77egyp097;21987598;1;21987598;0
4633;bc1qdzsemj66l2jmj620rckpm0ds66f8835xggay79;390993;13;2315164;1924171
4634;36zbbrDm8fyiwYGD5pCC8VkMRxM7313Axe;1195169;31;3479309;2284140
4635;3JTodBEFW8DTmdiuDLsbkWeE4NNPzMtWCn;3025;1;3025;0
4636;bc1qhn6m0nvh6qhd8uh8ax9gtmjysy85ccyy8csum6;617316990;1;617316990;0
4637;3KsZhiZqjreCzs4mBsqsVH3NMjTCFPJMWk;230997;52;26442245;26211248
4638;bc1p793kyw34cm8uc292kk6g35wymnvqhtyerlp65xu6npm30xq5fv2qg94kn6;117784;7;243854;126070
4639;bc1q5kdy6fwchknj20slew5xcf9x38q8k5x9ugjnuz;5080630;27;1591792760;1586712130
4640;bc1qg2s297lmavn7343t8wyswsql5tgs8ydl6hns78;13625;1;13625;0
4641;3CnuPYVEVQLm957UeipHqfL74uFWkBYL5u;23400000;3;33800000;10400000
4642;bc1p344pv5fqayn5j4r3agqs932mvk5a9pz6hjegtufjljj8wpu493gsjcazua;0;2;17000;17000
4643;bc1qlquq49qcn48ft84tv9cz2yr4pl2n0pzhau25zd;0;2;22478670;22478670
4644;17YX62X9ccLKAPdMTj5qxFdwjeGbajrg8H;623909;78;7190645;6566736
4645;bc1qg6e9prhgqk3nyhasd9ucsuqghnag6a6rh7ayzx;636583;21;15095868;14459285
4646;bc1qvq4s24srzftrcgpupyh36adm0hvulwmdqrq3hz;1200;38;43200;42000
4647;bc1pr8dg3z9z2knk3ehghv8kttmqhlayql4hde52n87s9kt09r39zj6sa7587d;25543575;1984;8907649595;8882106020
4648;bc1qzurn5q78hkvyepe7hu6ymhfwuxw5kzm55hwr7k;480770;183;137461675;136980905
4649;bc1qy6tn6jx7yf78nzfc5t6tvwcjt2g2adw06mhpkz;205028;9;2031253;1826225
4650;bc1q0xkx2p3jqy56k46rtxje9hvdryvj0dvn5u0284;195743177;1833;488692537470;488496794293
4651;bc1qlt22f0tjjs8909dq8ntsm04y8ttc8a3trs550e;423093;83;150445392;150022299
4652;bc1q68hsgkehl0pz5p83mnafpyz6dqnkvrqlkglnry;263783;1;263783;0
4653;bc1pxfr2mdzp9hq0qehx34mcmklkm8x3vckyyewqehhxhlgyprr7jzcsqt7dw2;88288;423;299837;211549
4654;bc1paqscm0wgtle95czc5azq7ukeht9u5fa3sdr70pdnlt9l2y9gg3lq396rj8;346643;153;36657348;36310705
4655;bc1qud4kke6xy9u4yfkql0xephceffsxvyaf2h8cfh;296927;1;296927;0
4656;17PTVnonLPTViKV1kypMFSRvtAmuFafPHL;563;1;563;0
4657;bc1pdvnchlc8503ugnv8n2rup75k9d35yvjnkt6ugrdgqpxf45hw5uvs5m2x3d;3371275;8390;13344055701;13340684426
4658;3CxC1G4EKUbfktSfELX3JMyXMNioQif9UD;9262996;16;40712529;31449533
4659;32hHMmMmk993WtvrwjMCHJAzUo93szJ78G;199826579;130;1284322760;1084496181
4660;bc1qu75j7rvx5pvx2wl6ljnv7l0qgpqk5dv85t9h7p;11194972;21;82155883;70960911
4661;bc1q0j0v2hl56jmj3yqdn3nkqer6776a4uwp5uqy8t;690502;10;1867464;1176962
4662;bc1q73d6kzuq45sdr8vvhnusycky8zcnm0w4f5srr8;845049;67;128671826;127826777
4663;bc1q6zzhw9fcqrmvgvkgxcczjehkeyxgwljkq4pm4s;139278;8;139278;0
4664;bc1qfr7h26yf9022j6kdxpzt8awd4f6rksd0l32yn3;1200;34;38400;37200
4665;bc1peeusvg6l3q4k8356mdzej5zmvggtx9akqmqee9ml2kau7z0xcj6q6k2x88;329795;382;22813211;22483416
4666;15X19xqCuwVHyq2qWSKwWQqFf1YimNA7ev;4663145;1;4663145;0
4667;bc1qwzv5c2hm03ea5mzny3g0adcjvwds874hgdrl05;113499689;77;445540039;332040350
4668;343uqbC6mebDppHcvcf4exwprRJ21iCggz;32042467;41;97145889;65103422
4669;bc1ql7qjf48f3r794gez5utwucqk7h8tmvjcwaf7jj;247840;1;247840;0
4670;bc1ql6aaphtuhklwvz4qv6suehefpn4vqvq0h6lwtg;752517;1;752517;0
4671;bc1qdzs93wvfsrmwp4xtl7xenqa8cnauvyxg2hmxu3;171728;6;171728;0
4672;bc1q9vqlwl7qr8vf53y4nhrxfx86wwnxkkkrv4htsm;4493250;1;4493250;0
4673;bc1p7ruydnwm5t2s7ek0jf5cw9xlyvee0uha0da6w53g82tydjv3cqpqpqjept;7500000;5;7500000;0
4674;3BSeApemEDiM4KcHKi2ghwBjD4QtQg5khf;6514692;108;52031969;45517277
4675;bc1q7la73q6kj6as4lmpzlvsr0xlgpnfxss5fs2u3e;15203;2;474203;459000
4676;1Efuing3JMpQxQmBcNxgavm8BXVma9u9qY;16232944;7815;140220133119;140203900175
4677;32F68753mx3c3gRptpY8aaoHhwk4L9jsPo;1487126;24;24224662;22737536
4678;3CfzpEFwFi5kA9DJki4rD62pBPdcyKU6cJ;141272;4;2764048;2622776
4679;bc1qa5kqkwhq3hnn4y08x27jxqdu5tpk6894m9hchl;1254333;1;1254333;0
4680;bc1qa0kxvhtfg8z237czynmtcg25y5pxsnp39st8cn;60093;1;60093;0
4681;bc1p8tddufydtr2ph4aryqcp2d2g4qexsgrddfdm6q7ralpmf8rq8hysxk70kv;1198671;534;220865667;219666996
4682;bc1ph8hsjv6h0s0tsn22zplm2evwvq29mpepcgzw68yt25z4hpa6uqtszgarhw;2490116;3;4043014;1552898
4683;1PWhWrARmipQ2H1SMreDFLdMrjWFFuANL4;60083943;1;60083943;0
4684;bc1qxvm7uc0f9qv5cks95csq98vvsvmxlyhdkkuyfl;51662;3;646046;594384
4685;13XikNewYRni77BeYowSQvb6Ymf6UHAGV9;1941;1;1941;0
4686;bc1qcs3cvmcdumxa58c6e86xgmd3z623gasp5q4a37;895995;40;6245015;5349020
4687;bc1qy3h42ukt4558gg4xlvky3cmhl8mwtaddetswhq;104107;1;104107;0
4688;bc1q8hkh94an8u3h66drkz9jghtmapcpmfhuhwrqvd;519457;1;519457;0
4689;17MxcpTz4U3WyJ4te4hS7LQ1gY4jJoiDrJ;1146;2;1146;0
4690;bc1qs6ram7cmvd0dqspclu0kh8xfvnrhlrutvxnaux;1300099;1;1300099;0
4691;bc1p7ugpyc7xm9uf538mn9t32jq4sx6tednnj5gyvhyzyp5gdqgrpkpqp3wfxl;452034;163;4973198;4521164
4692;bc1qljauszx97ddajw6hwakemdxs2mvd8vfy375qh4;17955259;1;17955259;0
4693;bc1qvgn8xlmdptz8veg4z7thx44c5nwjwp5sueuact;1255169;22;6614445;5359276
4694;bc1qmgjeuzdjjut9r2m94vtww3t5gp82lzphjtjvwu;1200;33;37200;36000
4695;bc1qujepl0k5n0ga2e86yskvxa6auehpf6dlf84dx0;185936334;132940;5856625066297;5856439129963
4696;bc1q7uv35j50hcmkpl8duhv2eyeq9my22psdmpqu6m;247625;1;247625;0
4697;17cLn5mKNYv9V83ChmQfiJuZcZRZZbAnEr;6162836;33;15090404;8927568
4698;bc1pnas4z07e536en240e9w2a6ndmmcw275j8u9q5668gth9kttwvtwq32vhnt;2939555;4176;2613735085;2610795530
4699;bc1qjrjg2nqmzxd3ddwu5jptw7ggtpy0enutk09dh3;175097;1;175097;0
4700;bc1qsrzvqk32933m0ssr8n0p0wtyv6z33fnfgq933c;193172;21;3986403;3793231
4701;3B1pPKMSjx9NogHjrW9GBfyKPuTQEpb6ec;7036309;1;7036309;0
4702;172Bvf2M2h8MA8JYNzt4aSVZ3JucTR65ix;2743116;59;27371589;24628473
4703;17CxJeBg62Qs8g8TEuqmvLVuj6XacxQsHr;1903699;10;1903699;0
4704;bc1qks4yepz0u45x5e9p67zc5cyujyw9j2yen57j4j;25782090;1;25782090;0
4705;3Nj4dqLhoFFdjmGcDnxHFb3keMaTQRbesB;4874936;473;1739106711;1734231775
4706;bc1q7lrlnzecvwp5eegyaxtm4xtsxzrkymyvauz9uamj3lcrwxasme2qynyn9n;500092;1;500092;0
4707;bc1qmvp88rnznspe49eneeg04zg6y9zramrw85s7de;23374373;1;23374373;0
4708;bc1p8zwuld9luaw845lqf45xadm5rcwjxg8f2uqu96u35pe0es45fhesxhz2cf;1518098;117;8511938101;8510420003
4709;bc1qpwk332zdsjn6szymyulcm0w0xjaqkjgm0cwvs3;11734988;1;11734988;0
4710;bc1p4sxh3evp2ffecfeyeuegar82548cx8htwfhwnewp5rq3q4nsp5kse9cpp3;1508110;95;481675341;480167231
4711;bc1pukfsxsl6gzlls3t6kswc9725y8n0hqhla2t33w35vqqacsy5c8rqs9uewd;1552813;296;25925901664;25924348851
4712;35onsz54SiFzwTZvfL3jc96RF8Mzffnu79;8814397;46;21055866;12241469
4713;bc1qz6xquupzmlf0dlwlkpygwelntxntuu25arq78x;1200;40;45600;44400
4714;1FCPHrQcxhPDpQepms7GWbVKS6WxpEnvdC;1978836;378;791919560;789940724
4715;3H9gmM62tMWBofbWw6NxqvDgDiuutsgWB6;49035702;86;84409387;35373685
4716;bc1qwtpmx5yq65lmhv2lu6tsksz5kpc692tpn3pcsv;1267852;478;64036799;62768947
4717;bc1qaft9380ztlu48z5gv5mpw92edpvgtasru2zvjd;9542857;20;73608959;64066102
4718;36gZDqPVesN2mAfYJBcWCsUYnB9RkvvGFA;220334;1;220334;0
4719;bc1pa4dvk770re3h22da83lga905x6k9vwflktgadl2ct65k0sm8eq3sv8hv8r;4824;56;66524;61700
4720;18cu3A9YmB29QyWy8VakXnBe9qdyrrFm5x;8523046;1;8523046;0
4721;bc1q3xpr87rv6usl5929vn3kchnxptd5n98zzpmg5g;1137799;1;1137799;0
4722;37rCpF1EzYea2J222mutHAsRDCRRQrU8Zm;186859;13;65192548;65005689
4723;bc1qh6kk0pzra6kqfxvzksfqv6m954fs4g4zlmk6hd;3125000;1;3125000;0
4724;32V3xvEZP9UFnt144D3d9H7NvUBsQBpcZe;2868055;1;2868055;0
4725;3KCA4rS3Vs3vVANZdMTzZdmvQJTfRM6Upe;109338;9;4178924;4069586
4726;bc1qs5tvgfw6440tp2ezvgqlr6gfzkrzue9hfxly6x;1200;38;43200;42000
4727;3AP5wjUwsJ2v9HVuZCENqVc46uWukhyyuq;71942;69;267639272;267567330
4728;bc1q50k5zum8unet2adelc922atyfr2gxkup4avmfh;3105271;1;3105271;0
4729;bc1plgmjs572uuyh7qwyy2tuwquv6felx9fc0shxszy3lmtahwzhapwqzx22gg;876;4;1206;330
4730;bc1pjtg6xe78tcys5l9ggzt64j4l7dl3f0e52pt9aynzqxj53u5vw07slnt4j8;2309831;1;2309831;0
4731;34TxB89y8BtaGChuex2gi2JniZYcKREhTg;448033;204;113023875;112575842
4732;1LbA8H7RsSPqk1zWK47oY1u8k2gxfPqkJV;243786;1;243786;0
4733;1K41dUCXngPuCkugkUNZPHrwBnZYbn8hdn;288120;332;248910919;248622799
4734;bc1q24u9jm8kfwfxjn00re7ewy2f355eh6uthf0cmp;141807;31;7305978;7164171
4735;bc1q4fs35z9qjgygg2teuv7sqrs3hu00n5202qz63x;750000;1;750000;0
4736;bc1q046ta7g6ry5jh8pk9mxhs6wwmjtwp4fs4zp96z;10972675;1;10972675;0
4737;bc1pxzazx2qkj5vp7jqmceduwgh35a0ucfrwxtgxycslwhvhqsnysc3shvjhay;14347426;3;28685352;14337926
4738;bc1px8ynww24ag866ufzdcwqvlufrllwmhhkrfe0altafclz9nfgg4pshq4tvn;163926652;494;723331809;559405157
4739;3HJqJpPgcA3V9cVZyu4AnvuTHUqZasi3fL;87803;371;170713885;170626082
4740;bc1q3ajaq2eju6zyy8mp705znrrxeqyy7s3hu4l80m;1565100;393;43741163;42176063
4741;bc1p68uj7ws2xxpy6ypkdnadtcd84z3ktx27tmgfs7qcf29m5znq7h2s0w6h2h;96345512;99;816303683;719958171
4742;bc1pe6vnk4tj46s2aascewztw7wkkuqtmgtlkuqcr77tjkypx9632ghs300mn7;207683;1;207683;0
4743;bc1qg0z7vaemyyz7m9huvk90uwalngmfygnkemgvvy;358974;1;358974;0
4744;378dkkGX18nGUzfbL9wYucRSdCq73wHCh5;1879420;2;3779420;1900000
4745;3JZ2iNNYjvgfiKpmFMpXHoztVonw5jU8dZ;49021352;4;49021352;0
4746;bc1qzxxvt83x5mlnh24zy58lk5l5atmesqkvwdptkdwam3karrkrka5q2ze0cf;0;2;553449;553449
4747;1H6ck28YPeEYdEGorFYNxXdeTGxRQkFruC;34136966;1;34136966;0
4748;3CJHmyRGvdmimXBaMi6JYTcQAhxU2Xpq2T;2000000;1;2000000;0
4749;bc1ph4kwttqa24fdu70jyskxtardt76hrqq5uce3v8thc3yexjp89nvqj4z7qj;512259;275;26761881;26249622
4750;bc1q4amng4v0l7jh74an6t7aqrdgtvuy4yk8tsm6x0;0;2;60092835;60092835
4751;bc1qrvd3ztjvurvqrrgcn7s8u5632akzu2w4ezw0yn;510235;14;41539973;41029738
4752;bc1pnk732rdse8u76w7afaw8hxmd7x0yc07zzx047lsqqpyvjdx7slqqnf2n9g;18920148;10157;547941671;529021523
4753;bc1qpt8fdw85y520jvdksfrn3r8lz6jw8wx8zcsdgt;1200;39;44400;43200
4754;bc1q2k8j92q49tmf4hkwdd5hmk3c6zaazqmzg0kwvu;34298;1;34298;0
4755;bc1pzcu74m8tvnqadf9wz0yjznx0gughxrd46nygzs5zp9axykkx86lqsy6rs6;988946;30;8243933;7254987
4756;3AUBCQ5tnR4sZuNfcJp3ccKFTQaFofDMaY;790772;41;40092583;39301811
4757;bc1pny23shurcqkwkkx7j34yu8ccy4uqsu08lc4u2yhd3ndelmt6d77s50wy40;1081489;114;89806956;88725467
4758;bc1qnnpyw08u0e4p0tzdrj8nqeq3emzks6q5uqq3kn;405202;1;405202;0
4759;bc1qumv22uszfxclcmffrvwzs3zdefma7ruj6dnu0y;566223;9;566223;0
4760;bc1qn44e26xh23tgmq9wgpk4deauhrt3y9j7ygqt2d;1355214;1;1355214;0
4761;12bXvMgqfKmNPjkRRFMJW8ViGHpqrLsXDK;440847;71;49601494;49160647
4762;bc1qvdajkcyhacr30rxpey8vk7quumclrkxg9tjkvs;0;2;131689;131689
4763;18qEHNVotMSgMV7jr7vquMNJCGrcZU7uVN;1711741;9;7640087;5928346
4764;3MsSQpG1dG1BM12PJcwkJv6gYg9RYuDjkg;35637329;260;382586881;346949552
4765;bc1qvmsxpgn7n3gtd2lhfcxseystammkfclw987lpe;0;2;501667;501667
4766;bc1q5vewmd67max0e5zmhflyhkqluza38kwkmsa0dz;179522;22;6216640;6037118
4767;bc1p6muycdhemxmzvnhcm0cwrznsajyrymv6m00mestc058p8e4520lqp68phf;585519;1;585519;0
4768;bc1py8g4v4ehll399qlpaxyxykg37pszhad9yg0dphxvjhdmhy7f08vsn43s6p;9763374;168;1312380391;1302617017
4769;bc1qmy97ekr6l9k78wm8sc8ggu55nrcccw26h4g2rd;389722;1;389722;0
4770;38BpqozQVXBEojeo12uVTVtmJA2xAj1GQn;240000;1;240000;0
4771;bc1p8ul9ch8ut0tajltvd57lnepq29hscm6266fzla6l5vdyq3aeethsageczw;544822;73;8359116;7814294
4772;bc1qlh4309kl4guvv3la3v72l9tz8xcvzfnreajvchvdmcj89d3lzryqf9ehhr;0;2;517935;517935
4773;bc1qx6yh5uyle738hm3sd7csnx9zq2tz97q7w4hejd;15379505;1;15379505;0
4774;3M4jPCofjKFbft5Y96LEvHRMffFLEwbv77;936817;3;2889197;1952380
4775;bc1pquz62anahzfwnqf9wagynvdp8hv7ehy2agxlgy72h0hxs058zqfqk8ksyq;25197675;105691;328911053;303713378
4776;bc1qvzc8wrdh7shcyveyv9kavm0lrkfyjtlcdqyzvt;48588;1;48588;0
4777;bc1q7cq0wqanh9arqhn5ea84kresntsllp9xxwj2ja;1134732;1;1134732;0
4778;bc1pjqrhzx95xl0jkpjtmu95lsy537sxpxvslw2qc3tnxe9e6fn5kcfscuzt42;4390;10;4936;546
4779;bc1qguzk63exy7h5uygg8m2tcenca094a8t464jfyvrmr0s6wkt74wls3zr5m3;285145689;898;454459689;169314000
4780;3Bgk8LEw8wCjs4NHMR2Mkm196b3GU2SHeu;2008745;29;2008745;0
4781;19pAWQ5WHN89h1bMMS9AjVUDPEpsKsMjG4;127049;111;107274962;107147913
4782;3P4WqXDbSLRhzo2H6MT6YFbvBKBDPLbVtQ;16612123272;955100;49997234311;33385111039
4783;bc1qflt3cxskqkhrl9dlhhr02yncrhv03gcz0pjj0f;591813;104;46492228;45900415
4784;bc1p3w7tfuqp6720pn0ytnh02ettmz32snspxfrf8fw77fpy06zuf5sq32698q;10000;1;10000;0
4785;bc1pu5x39jadfa9r85yn3zrqa5k45nkyqvq32t223s2sjsklt387lfcqdd3374;10000;1;10000;0
4786;bc1qaad67kkffvnuqe0q3vsldcncc5e5zpg2vjhe9m;441500471;112890;344980865519;344539365048
4787;bc1q0s2c09z42zjdndf8a6m8y7qu42sc8pmdgrsd4p;67914;231;67914;0
4788;bc1pjzt6texvp4fglvrgch3gt2hdue36nsrfkz3hknaenu00xgy7cdaqyfvxef;888;1;888;0
4789;bc1qqw9t2k8ku8zej4tgqf6mz2mlh2h29w64yq2clk;40000;1;40000;0
4790;bc1qnqgcwz3lanc3wd3hmvltdhxncmc74lmxwf4ndr;264057;1;264057;0
4791;bc1pjh09aut9v8c6aq92xyj0uh0z6f4l6qu8wn24xjqs9j224zh3xj6slxdg2a;19129250;1;19129250;0
4792;bc1prfh5w9gyp9ugdjarsn5jf7vwf2cg9azhrz6fclavvzznxzchc6rsy5gp28;10000;1;10000;0
4793;bc1q8qsklpa6u32f9vy8p0cwzz47tm0wkwuw734qwd;362645;1;362645;0
4794;bc1p4uv49y9w4fzlz9rr07rw8z8g604y22dv2wg7xa2rsfmw2xyp4wxqsq3h38;330;1;330;0
4795;bc1p73xgr08v2y8dq9k52rknafsg6vyeyy37448kt58853clsl4lhvdqu6lw2u;67068;1;67068;0
4796;bc1pzjfplwg6qgz9zh0tprnu0kujr09r9wmwk3yhc0dd3tyydp0lagesswv3u8;10000;1;10000;0
4797;bc1pldmqy5zkvj5ywz4jn9dgfk9tnwc82eg6p2du0c07lcysftgcp06sgvcsw3;757153;79;10239633;9482480
4798;bc1qpwpq6fh3lqap954r8n4s9elvy495q78k62n5zv;0;2;371420;371420
4799;bc1qh26rz88tmrezt45kz7hdwyhf685kztj4g9wf3f;320000;5;850000;530000
4800;bc1psx867tvdslrssrxtau3wq5kk0pv4r80jyasdnsl259qajsfae42qanewga;2105625;1;2105625;0
4801;bc1pzwcsvhdqv02knxll28nqm897kx0sfc5sndtn2lgzjpxac4pzjlas744nun;10000;1;10000;0
4802;bc1q08d9m5ve0t7lkgl8pa4ww6heu4r73u2qz4ruap;1323346;4;9782490;8459144
4803;bc1prgpq2zdl7jt2pmh5h9zylqzwynynjjsy8688r9jm4gsq4w7y6z2s9z4a42;888;1;888;0
4804;1BL7Vz1finewJowY5fqa2HGtuZN7LxDzWp;508976;212;303571070;303062094
4805;bc1p2ngdj0psxjfdmkwm70qcg8wrlz7xpw0ngtuu69gh8587556yjpkqrulcyh;9785812;259;1202116175;1192330363
4806;bc1p6kcps6yt8sjlvgalj9pq6c3t7vgpr32smgwvfnegrdqdm8lz375qn79qhp;1955825;1;1955825;0
4807;bc1puw3vgs24aq9mk7glqyscjvujkqhcqj4qwds2y2ccscdehrw3xhsstw9amp;10000;1;10000;0
4808;bc1pwjna8h2epv73aa4atmqfztm9mj25f957vdemprn7ezukygwcrz3sm5xk49;8748200;216;8748200;0
4809;bc1p0dn52f0hsww2cc2aqe96dmqsa407zfmlx7djum93ad596lh53qmsfjnarr;15990000;1;15990000;0
4810;bc1pd9jju90qlx89jp3yxkrf26jn992fe5auhy8ljsvnj65jhwtyud0s9kmn7a;10000;1;10000;0
4811;bc1pdmpe92gyjug6x9um5hwu7d8d4cps7pn8ke9p7tjsxl3reu53je5slln2yq;10000;1;10000;0
4812;bc1qqq9fzactl3xqtt7fdpegahuhxltxdy42nnrq77;75558;257;75558;0
4813;bc1pjf4m3yeghlavdhppzr8cghc6aj0mtampgu4mqyz2l07yghz6pt7syfujmc;10000;1;10000;0
4814;bc1ppppsemf9ajhvrvmsaj6tem89yv84vd0mxfg36d69yaw5fzhxdl2qr3lhtx;86340000;1;86340000;0
4815;1AzT1E66Q1KdaQAyDyZfm5T2T9RiAM4Rzx;5360;1;5360;0
4816;bc1qzu2eyrz9gv05xvkc8rq6w93lvvmw0m2wn22ju2;71442;243;71442;0
4817;bc1pgppvylhqnf884c08f5d4gcs3w49p8wfvyexyud3rra3llc548stqe0885z;10000;1;10000;0
4818;bc1qrnx2xnkwz9d6lvnu55nknc3ee2jml45skalqwl;310413;1;310413;0
4819;17q3DichFgSa3kNw9tfGJThxrUn78UuujP;71875;4;181875;110000
4820;bc1q8rpgkvp56n09e00lk88nk2lh9njplhk3y93999;757522;295;351483772;350726250
4821;bc1qsgqh8s5vswy3pgjxtvt0xmz6gdh987xqe2k32j;609629;703;625764926;625155297
4822;bc1pqvh06chcud9ge6h0sldsk3y8glqzez2kjasn5g90n9qdc6n788zspedjd7;10000;1;10000;0
4823;bc1pc59ccdyrd0ednnkjqzwy288ez5qhtz0lcjnejhl83zrwz0k76knq0zun5u;1939725;1;1939725;0
4824;bc1p57fyfhg2gm7cnpchkxsv8mj3tq5fmcdc23847gjsuvauhskdweus4ukehu;330;1;330;0
4825;bc1qe687rhhrzs3s9lrh9dtwxu0rkm0a5ja0jn80sf;80222;1;80222;0
4826;bc1qc4vsgtat8eg55rmdhvx5jzxy96s6ju3xgc6lae;888837;2;3422971;2534134
4827;bc1pj7mr3tu932wax8aaw9xx5439aaqwrnu8exds4p2z4lsu8hxeq6fsyfjfeh;10000;1;10000;0
4828;bc1pw9rmnn8jfrll8shesq543wlcw5ljt3r5cu8xn00yg90uutjszfhsns7epx;330;1;330;0
4829;bc1ppqjf2zrtuewnlsg8u5m7a6h6nn4y93439lplmkefx05z0mukle0qavv54y;10000;1;10000;0
4830;bc1q2ct5w4m79nzp8fm0rqx5f6pmj5as3sw8m8dfju;20033;5;228208;208175
4831;bc1qqg59g3x8kyqesmexwdfa2tzsvk5qvmaxl7mkag;1815474;1;1815474;0
4832;bc1pjy68p8djjx40cjrzmd7q0eddtuwq54s89xmatreg56k52vgulqjqsg0pcy;330;1;330;0
4833;bc1p64rghal95lkmtf8jzdhgxlu4kt0mx2dtk9g5wrk57xqc07yrcn4qzmnw2a;20000;1;20000;0
4834;3PdYuEdNtnzSk3b5F81KWLLG1DfwNcrmtL;100294683;339;3529144675;3428849992
4835;3MQN7WYb8s1JDihqxkkWGLUTRgRhkFJJhM;564067;1;564067;0
4836;bc1pss7jc8gt72ur5su3jsy33y5pw453s0l7mfw6v9vzyjj283phr39q0jws8f;330;1;330;0
4837;bc1pwky4ldxg5sv8ukhut67mhpvdc07uads863edqgjdvf3c2l6lm00q3v8jkr;10000;1;10000;0
4838;bc1pkz7d2ypqgqelv7k5npxe2r29rzc3srqkgqxpx6gerr92mns4ldssgr7n20;1929125;1;1929125;0
4839;bc1plhcdcf4mlwntcwjz03d66mmx4vfu5yuzmrh69az36acggpsd84tqu7hn2t;16020000;1;16020000;0
4840;bc1pvhe0mjwej9tsgrurufd05msshgv262wgpy6hwewursq3xs2h2zus49j72g;746162500;1;746162500;0
4841;3GLhrH2ta4jYhYGxBG7yaZhbtpLBHCPS8F;13643630;3;31221346;17577716
4842;bc1p9u5uk8rgjwjfrpjlfslr2hds35z3urmhqveu90u7avp6sqfm5m5qwh5tn6;330;1;330;0
4843;39xSoQ838DNYFCdShSH58XwiY3DTb6wu53;1884589;17;28297362;26412773
4844;bc1pru4fddhgjgdqw6wucx3sfq9j8l32kc27yyzfczzwxtaxp6ar4chqycr49z;10000;1;10000;0
4845;bc1qqh8vl5nfj8c66ch3k4jlq97l4utjc3jlgs2guh;74888;13;851608;776720
4846;bc1pxj0y2yddwd2vccy9tf29czjun97ssmnyxt4n7w0y7ch9w93w5w8sanhtax;465592;21;477239;11647
4847;bc1pkwqm2z34hfsvxhsxgr4wvecywhzknmu0dzkh6ppukg5r0xjrwpeqpvjgc9;30488436;1;30488436;0
4848;bc1qnzfytrxm9z9cst50ww0ayalakk2sdmjhfk3q3k;546;1;546;0
4849;3LHF3tNTse8CvbqmxHTLt5Zwu1Z3ML5W2Z;6000000;2;6000000;0
4850;bc1qa2t3mvkrzxfl34m0r4jqrfs3elhtlj7uyh4l7h;814702;1;814702;0
4851;bc1pjc8e8k6032y79m9qtdc65qlwnhzqfcg4x6ackl2gz3af0s62vwvsdf4066;2073425;1;2073425;0
4852;bc1qh0ytheqaj2gg2mh7uwgm7fgl9ssluk0zgmfq79;117012;398;117012;0
4853;bc1p8yvumwqvwu8hgyzvxmjrkue3xd9mr8wfzg9mrkj6xcrdtzmtud3set66lh;546;1;546;0
4854;3JKnbKhRjnhTr3q2thgMiMpRH8ggCH9whv;7092572;358;582537167;575444595
4855;3L6RVzraApJ6RK2ij12em1UcoWRaE2WeD2;9829739;1;9829739;0
4856;bc1pq7e3vl8nhccjaruka2peng5p3jqdu6t5h09sww9t5tyhaepylqqsum7qdr;10000;1;10000;0
4857;bc1pj5qgnctc6rgk94x93na00c6s3fj4kqp06ypst75rgdas5ns9waus0dk3u9;1092;5;120448;119356
4858;bc1qqcz0gzc79fw3hk5fdvrzutmmwha6fx38pwyeqg;397361;96;24453820;24056459
4859;bc1pqsejtw02e5v9dj4xrmegpqcer6dk8ljhszyszkuh5krf7lj250hsx9cff5;3256977;1230;5024018;1767041
4860;bc1q5xd0q7whlvjnpd9z2kcykvdps040kjzdezqee0;16896;1;16896;0
4861;bc1p3hxyr90dmnx5f74rd9nruq7hcl0pvushf666zhu2c4w6uvncm6ssu3d8cn;330;1;330;0
4862;bc1qmqu6mdmrxcz20gaj4mkr0kth27pjmaj5yw4p45;0;2;544307;544307
4863;bc1qh3gfu3u790jrmhrr8hsqdc50gmlhd0yxjn2jkk;141515;1;141515;0
4864;1LZCLpfLWws1XmyLwgqGAtJaSQaTm7f37q;23904;1;23904;0
4865;bc1p2k7pj5ymcr74uvjj40u77zu0ha7jf4vsksltqwe3l8ru7ql66aas9ymctm;10000;1;10000;0
4866;bc1pzx2x57u8ac9h2zsprt6hlu0ceu6jc2yz38sqtz3cjtm27ry9yycqxztze2;10000;1;10000;0
4867;32AHYruyLH8q4sj57iVrSBcHicPGmJbspb;2731124;3;7240298;4509174
4868;bc1qrsa5s0wh4egu3x6yx4wj5j6pnurcmyaxqvd9y7;134540;30;134540;0
4869;bc1paar858ny2zpnpuhdsygknsxqyjz3fhx2yx9fumtc0tx66mvk092sae6xdm;4697041;30;28572970;23875929
4870;bc1q47y3qh0m5d3zp6l6nzf5ujdfrgs2ces8hp329h;1574817;1;1574817;0
4871;18LAvhkdYimdRU8mvgGVMcaJPZibjbfS2B;7401319;73;9198550;1797231
4872;bc1pun7t2kmau0drs2kdhjp64q3ksg4ufgl77lryjx657lzcrk78mqjsrum287;73909;1;73909;0
4873;1Ptd52goQ1PtEzn29m7R4cx4c52MkyrMoo;9312311742;52994;21140822887;11828511145
4874;bc1p6gr6vkyxvapadn2ykw94wfmzfu3ylxq8xh8rlrqnukux64sqj9cqvw7xe9;19929650;1;19929650;0
4875;1B8qe1mgaXYi5zfozuAudqKso29MgZ9N72;200850;125;97945774;97744924
4876;bc1pw9pjaktl0arkhyaftpdu7k3lggpq3zs0gy7hkpj7n9495s4k8n9q05ahwn;10000;1;10000;0
4877;bc1pat6lysghy06rjrh7pmmuj3ac65d0u4lklu6sklm2pqawzu8d0qvsjdxkzf;0;2;25000;25000
4878;12FrWFeHLyjieBCaJeppiAN63dTHsLGBJg;13020656;1;13020656;0
4879;bc1pf0trn5cu0zm0grft7yu7lsfxaghykye4zzhvztwwheq0uzhr9seqewu2d4;10000;1;10000;0
4880;bc1p3rkzfn2rms80w3p2grveklm9xw287nc78cdt6pttdjlu2ushn3qsw3sur8;16010000;1;16010000;0
4881;bc1qv9xxcfs0am9jnsps6xuasvnps8slxh74n2w83j;96567;109;3615310;3518743
4882;bc1pc08qw3q9vc8tcdp56m26z782kjwsfwe9wgdsvg02s6pneezw052szxecqe;10000;1;10000;0
4883;3PTcm9aRJq3qvxJxrifDm4sEXQhe2487GC;180100;1;180100;0
4884;bc1qlq5gk36uw4rhtsn8zlnvkjuvhg7akw4mjf4gfh;60270;205;60270;0
4885;bc1p7e6ed4p43da23vlt4j9dz8hl9xg4z03uu0x3hcnpatczkss5fkysz562fr;888;1;888;0
4886;bc1q3pefqul95cnq7qar7e60fcf7j0z0scp65kcy8m;814702;1;814702;0
4887;bc1p8w9n4v298668ut2fqwukxamxsr3ssc7lxcja8e6zjgec4euj3ksswckxz6;1797928002;1;1797928002;0
4888;bc1q8mtx56w3kgcdd5kxzqv95djahnu9hcxluqhyr6;271557;31;61874679;61603122
4889;bc1pdqh4v8pj6d0ru2z8t79kxxnxza9wsekxyxl9a6gxtwzwmfd5l4dskrmka3;2003825;1;2003825;0
4890;bc1pqzukvh3a2e9fnu8jp4uznav09fp7pfsvcsyjrk9n95vcts9hknnsa4d4tf;20000;1;20000;0
4891;bc1pry0ne0yf5pkgqsszmytmqkpzs4aflhr8tfptz9sydqrhxexgujcqqler2t;10000;1;10000;0
4892;bc1qledar744zkearya8zn6xfwz8z3pflw09tfmn0k;62219;93;5709662;5647443
4893;bc1pqmh6qr5yfdqkvjq5hx5e3w4wlst6ssvfr9ugq3wwcdtpkzzy473qzq45f7;2041425;1;2041425;0
4894;37C6K8NZuM9WXbrwdFnvgE8e5z63xhuf3H;25685;97;26373204;26347519
4895;bc1pjvy6d2c5a8f7l468lmz2dvjqacvsfstk5p94ykpla6k3jff0a2xs09dqf4;1955825;1;1955825;0
4896;bc1prhudjt449a6grflp39lfvst6c9dwnpxhfvct4cx93pztca327rmsn280fr;426214;120;664050;237836
4897;bc1pkjlzjl7g0gxyrautdw28aaefeyhdwnvgx0c3xym680j5r6ra9rvsvycssq;2310;7;2310;0
4898;3GCBudH4GbQVt9zgH4QsAh7Yv4NZ1XmBeg;179550;1;179550;0
4899;bc1q0t507cyz3t3xys24fg43cvx4ue38xsfkpxd2q4;81294;10;406809;325515
4900;bc1qp0dj5yr2z59kgnwhvqywsj8acet4258waj3dkm;177075168;8286;260565274;83490106
4901;18cBEMRxXHqzWWCxZNtU91F5sbUNKhL5PX;11836190521;46361;36728032585064;36716196394543
4902;bc1prm2mmm73lsdnu0lew6rt8rpgz4zk7xkdz67ejh7rdm0x8u30wq4s5lyeyw;546;1;546;0
4903;bc1p6fq7863ks9gd7lmnm48nc7t2m64at929gexdqpuc2pramn8r2kasy2k355;888;1;888;0
4904;bc1p3azz2u9qmwgwtv6924ejztywm72ztjc9h4sefec8v64p03ym8sxq62a6kr;888;1;888;0
4905;bc1q0fddr9hj43qq963l4s7yq0z8fmmdptx3w8jm7n;0;2;274228;274228
4906;bc1prf48sj0pnuf97tw3uv9lcl38mj3lrs9xf6ppk6kp49zptx8yre7qaqs3wc;106491675;1;106491675;0
4907;bc1pd2nhlsnepsj63u6ztkrfvzr5xml97d4cjlwg4t4t8akxwlftgdvs5m079j;10000;1;10000;0
4908;bc1pemy9q4sr997t4a2llq6lctmuzms8la2339nwmnxsvkncllwpk9uqwfew7f;873461;85;9019158;8145697
4909;bc1q0j6chmm4y20w8cduh4fwwup6m9sndqnmchxadg;49391905;2438;49391905;0
4910;bc1pkhvq2h62093jtewlxjx6y6qmchjrx70wl7zu6yjhm5zcv5phkhusnasyrp;11100;4;800011100;800000000
4911;bc1qkgmqcmsj3l27tgjlmrnf44kh9aucf052npt20f;70092;31;1858640;1788548
4912;bc1pr7ffeaz2u8flg509rpngaq39ztuvtgcan87n4rwtc4f8scwsvluqa7ervr;10000;1;10000;0
4913;1FRaW2WjkNJ7fs1QnhePGUPcZ7o5DgirwQ;46325;3;46325;0
4914;bc1pvzkgctnt00c6rpkep3ltgya5wdyyq9xuphq7wqps38xlqu2y5x4qfqsf2u;10000;1;10000;0
4915;bc1p3wt7kj8l0nmhfmqmzr5j983k7c3wkwryxd65al5kyec7kul22plsrsmvey;195300;19;4030887;3835587
4916;bc1prf8k2qqjrpefl0h3shvg3ev5xvhzzwa0agl3szpejrdt3lacgw8saun8va;10000;1;10000;0
4917;12MoL17DMwdYox5RDWQfQFoBegQHWN7djd;615443;1;615443;0
4918;bc1pfqgv2szf4lxjfw4e86wkq05dflhcx09vyuxaxu0w64dzktyasq7s707hqg;417188;285;44433091;44015903
4919;bc1pkszexc8azlt5gstmwyly4kscpzlgkuuf2ut0wjvjvpe6ph6djx6qu2q236;114339;50;4315951;4201612
4920;bc1pf0esn87pw6pn6m67x5xjw25kgf8q2vfhssh25uwjfvn4lanectrsaw2dmz;330;1;330;0
4921;bc1q9graanr34ujt0k8ackajxjvzts0gk6k3pdyqjd;45530;9;454397;408867
4922;bc1pf2ga79sl7qp6zc3vk7ddar0zw03uj7yg7r3v9u7x6sg2hftymf3sp2w3mh;10000;1;10000;0
4923;12qLiDCJxWjRAd3GMsBFGbzWBXBZYbhUsK;0;2;138262;138262
4924;bc1p8x9ajg2ddm5397asgmvkmlvatuwuuzm3nyd0uasu4sl7h72ax2es2zyuum;198096067;1;198096067;0
4925;bc1quswwrn580k9sqwzlfqmj947za9z2dqgnqt2e55;64014;3;103520;39506
4926;bc1p24we65ntuav3y50yhc2d4eph4qjepx99pae6nnwwtfh63fa255fq0evnc0;3767693;400;73179464;69411771
4927;bc1ppr8rlhqpzzuw4dxa2xl9785wcrksxzeease2vp2vqt62fgxyk0hqngwydx;29509453;1;29509453;0
4928;1KVNLiPz5uuif4BxivD3kj2fYDpWhj4cLE;325431;1;325431;0
4929;bc1pvrlgp000sy5g6uxm5c87qdx339s883t8q9wajr3fgvr4yv73qvesll6afs;16020000;1;16020000;0
4930;bc1pth32ytll32nnuvg2cuzuqnnhc9ug49n7agmttv8h2cj5rypjf4hq8w8mvf;2121;1;2121;0
4931;bc1plvwxtxv98rjwauczz53uc49nd2p4gyz5cnywlvucuewkcy7unkrqgw2pjx;277390000;1;277390000;0
4932;3PuUohZAprpYKEKXC7i8iqfGWZEsMTiU27;136984;131;4295000;4158016
4933;bc1ppgxyuapkxjhvy6heddr82m35eggkj3wrea9hme37cp23kdk0pfgspqurur;10000;1;10000;0
4934;bc1qxkmge3x9tvm5288z80xcex333c9ed9g0u88gps;120530;3;674710;554180
4935;bc1pn2y4t368k2ksxylev08fxphmjl4lkew8vdu6hnnwffvyz6vfmhnsk4zmtz;20000;1;20000;0
4936;bc1pusx9vtmsacy6rpw3suxsvgezps6fkta79r4p9jg2ne9d7gl5zvcsxrva33;20000;1;20000;0
4937;bc1pvjv8dzfnud60w2mmdenxlr8ejjpfe24hw82geqqv96rf6wk6kcjq8uf92s;2121;1;2121;0
4938;bc1pzud9wdyue3zw0q0tc8fj7ptx5rqxjz4hz8lqrupn5667sm53manqvnlyc5;1988025;1;1988025;0
4939;378dkkGX18nGUzfbL9wYucRSdCq73wHCh5;1879420;2;3779420;1900000
4940;bc1q0xa95dphar6cnay5vua5q64lmsr4d09cvmjwvl;5909737;1;5909737;0
4941;bc1p4lnqnu3d5ueeywcvsthvmx5kheg6a76y4l0v86chj676334s7qlsaej22g;10000;1;10000;0
4942;bc1psfy3dz5vkjrtdezc0u4c2fuu3jvrw0p28rnwd30dfr08zysl7yrqzydwmn;104991675;1;104991675;0
4943;bc1plpkpcfduugsf3yl8vjajqah4sp282z0kwtfh7leg3c5w4hvptftqrpu3fp;15960000;1;15960000;0
4944;39PTmWV7qcgugGUiUP7dkrQdLkNYThY6yG;553060;8;2350842;1797782
4945;bc1ppklaf4xcjjhm85ejseq5hmcznd53xvgypzjylj2lrt44enveqk8spwshrn;618350;693;525282752;524664402
4946;1LMPTUreb8SkEovDjroaYVsATvNFVxiiBh;270820;2;270820;0
4947;bc1qrvd3ztjvurvqrrgcn7s8u5632akzu2w4ezw0yn;510235;14;41539973;41029738
4948;bc1qugcl7g6wk6lknvmcfh5lp669zullrh37kjtncr;216460449;3841;471223934;254763485
4949;bc1qds6qga7pwhs7qh32ep9df7ewxnlcfnlcpud2jh;294;1;294;0
4950;bc1p4wrvy2ecsjdc2fs2kv90t5nlygdhj6l2dxvzylg5mys8h6dj7cfscnjfma;2121;1;2121;0
4951;bc1ppk3juecu0lj2f2f6acxfvcg7ed39e708ttdlgcnyw6vzgp384uhq9ftn3x;888;1;888;0
4952;bc1pzjy99gpy6425xrlp5wwy27zh79f5uyucsz7qr56602nj9ndrsgxq73ruyu;16020000;1;16020000;0
4953;bc1ptxacu4v7ts8jdz96ru2hun9zqanzt0kz85pdk554y0rnw965e62qu47srz;330;1;330;0
4954;bc1qw6hgqkgd5g224h6sxczwadnnju5r32vqr5gu4f;1591649;80;24045453;22453804
4955;bc1pmjj5tdlm4tryzanss00qpf2k8445ltvuyk8hmv4zpnk5zpegnt8qegym09;10000;1;10000;0
4956;bc1ps0rp5shq2s7uedgv2q7x3efxqvje5dpttu9tnkml4jajj80mlxnscmn9ne;720000;3;720000;0
4957;bc1p56wqz4trtqy7dmrwpqpxuzvn50ap663kwmvutx90ln3j2dvq5cjslq54d7;330;1;330;0
4958;bc1qhndf94r9xcfld608ggk2uvkrpnpf8dkjxlp4h5;3054669;1;3054669;0
4959;bc1pwcty9df8em0g5l3ay04mq4psjjk8plwypn8tghcqh5w70nkaph6sdt9ahu;10000;1;10000;0
4960;bc1pyqpt4kqkv0wgwgfqp3dz3pevukdz0m594fu4fu53ax9r0xp7v8cqhrkgav;0;2;52275;52275
4961;bc1qqdpd0jmh4kwdj75rf7d30r66fsn4m8uetzg677;5046923;501;2026967824;2021920901
4962;bc1pvfrg7f9aesgmsw9pz6ahw6s76yvzaucryc85xqz7xlqkp83q4dkqpfwvpp;10000;1;10000;0
4963;bc1ps2u5sahgrnlplm2zy5xtezmda9pc884t9nxynkn9ymtj08hcqttqn76xdt;7059611;7;37878769;30819158
4964;bc1pwhngxrd497wjexz8ra9zu37zv9suxadxmd6ued5724jq2hvs2qaqsksq0n;17336;56;3128946;3111610
4965;bc1qp4s0z0s8edjuaxdxlwj4zdxllw2pq096j33wpu;40760;1;40760;0
4966;bc1qw6adls5wl9naupzf79a89xwc8tsxrfy5ls0pye;294;1;294;0
4967;bc1p30c6d9ga8yq5jvzzna6kqu6zlat47hhyzwfxa3huss0m0fmk5uxswgl5e8;20003574;1;20003574;0
4968;3FkK57gqLYwkiUgpN7QGNi7o6bBeWUdCPu;9324111;36;24359632;15035521
4969;bc1pdynaqwgld53gxcxff2tae76h486ykpep6j5pcwsjhjv04f20fz8sw7sdzg;10000;1;10000;0
4970;bc1pezd20dkumw0fsdj60ymygxthzacny23agv4tpg2k7xgftrrgqy0qz6ag5c;2121;1;2121;0
4971;bc1pcn9lz4agal83054p6hdvsrga0429xdy7x98fythzhuwdrvrcqs4qu3ldke;10000;1;10000;0
4972;bc1quwg46m0s5sms8pdtyl5p2rrrkn20meg0k8rjwv;263376;1;263376;0
4973;bc1qe8w44hrnegcqp92ljhyl62nchua2qfn9mv76e5;963452;5;1963452;1000000
4974;bc1pmqxsgtjfhsq46cj29r0dtdqccjqxwv6w4mty7cs8cza0turxlvqq5q8urr;888;1;888;0
4975;bc1qsjsgd3c6lausa98h5p65p32z6t85ecfw2pstsj;195477;1;195477;0
4976;bc1q67rwe2lthemljrn57we5wy3p8tv9kyjxgrqj5r;0;2;536152;536152
4977;bc1px8smt7njk68p9s8nzt2xaty3y7yhk5vkprj6v7kllrx9fle7kefqffmkgd;888;1;888;0
4978;3PKxA5DwhX2P58Gg1XPiYV9kW9xV8Vqx84;9487822;81;61883511;52395689
4979;bc1pq5z0hvxnewyz2kr40j4d32nx9tn0jx0vvdsvjnlckjekyhdm0j6qh7w6hf;15124907;2123;16272053;1147146
4980;bc1p5n7njtzzr3ng88j97yupl0l2vr38w39qj57yme9hjvnj3hvtspgs4e7p2s;1437507;1;1437507;0
4981;bc1ps9ac6ytvhzj6c6l9cmp48rgzq6vkzx39dxpzn82q65g8q8jxuypsthy4zz;10000;1;10000;0
4982;3NDfwvQQFUsT3yxeYMpRSCeX1YjR8ueUuA;38011;1;38011;0
4983;bc1p4dcsqsu408ljmza2nqhe5hlu0zx8c7enwuk8en3spcjrm0qyk6nsqz5w06;125898;8;485732;359834
4984;bc1pamc6wvdfc4z9tektjjnnjd4a9t8w90jpvdwhnux2aztwx2wxfrds7y8az3;41863;106;153989;112126
4985;3C9xYwTtLZTiqwsn6827bQ3LPhWgvK1Ueo;1003200;53;47492089;46488889
4986;bc1p0uq40hnlfzvgy5h4dlxh62j7p54lz0ufzk8whdxkdkxsp2m9ht7qfehrhl;2062825;1;2062825;0
4987;1PfFyGU7wJWzXEddR2DQGpHQFcr3WHN3Yk;4015355;2;4015355;0
4988;bc1p0r4q93r7m77pu2paf5xpkqkcvjtappx8rqs80z2q0auzxc2nr7pqm293fq;546;1;546;0
4989;bc1pe6a6wr443r0ca3390y047z7uhrxtclstmsvhfw4z809a76zejqvqa5xdt3;0;2;16000;16000
4990;1GjQcNFxS32xKLUBywnWNnXpptrTBeZ6w8;6477757;464;418727812;412250055
4991;bc1q4nsrn3xmq2a2x0zjnrlgktwhpz5feyxs06sfcz;45482;1;45482;0
4992;3P4WqXDbSLRhzo2H6MT6YFbvBKBDPLbVtQ;16611045547;955084;49996156586;33385111039
4993;bc1ph2ep7yy6hvsp08amqzmu8z72tusxvrycpgatnccaqvauav9qkryqzhwget;1689999;1;1689999;0
4994;bc1p734zwjwgm43hzgl4zey2yn4tl745t9dz3c4c9sanut8w3d867wuqrecs02;1859999;1;1859999;0
4995;bc1petvt7ku60a4gkgvp8l6eeqcvej27t6dsp32j5cvd5qjuwqxssm9q48sw7x;888;1;888;0
4996;bc1p4fkqvmhc0t7fm36sqhvp5xj3hs2z3n2azyvdur7myff4z7eukgssayf4ed;1701999;1;1701999;0
4997;bc1pcjd6vdktgk4f33ahgfnsjjs6k2axu3kxu0mm0htqwk23hul7kqnqr8akae;10000;1;10000;0
4998;bc1pt3zy7qu9fh7m0e5xkn2a9u5f2yn3tgq7hgrrnqtvtkagxastesns3cg2wa;2027556;1;2027556;0
4999;bc1ptlg6qcvfgq96sl0tecx39vqh6huw9603qr6m38spm27ds2tvrd3scn3t7c;1235860;3;6043060;4807200
5000;bc1p37khx98mpyjrr3xnk9wp5s4wmag6ea62zldvj5xj8t0l8tyghgsqx4456c;1000;1;1000;0
5001;bc1pne5ff664hejjnzmxlrvgvy2sc6858npueea83mkcsm9u0upuugfsctm98x;85970;5;10085970;10000000
5002;bc1p5mjs4t95fklqxvgv7wesul508fxaj2d7m44tfxml8r53pyamxdzs0r6zd6;10000;1;10000;0
5003;bc1py4vnq0s376t20ceccyk4vg4s46rudw9jqs8t67m56jx5xar5vr6q5pct2p;1600;1;1600;0
5004;bc1p3llg4wz9mztjexqh6jsmmjfhxgeyjql6fkuwhwjxru5kja833yhs8jl0dq;28449283;5;63507643;35058360
5005;bc1pv3f3n5dd69z8qtacw9n9dng5jn7ujl62xh74493umckxkd34legs2u9lr9;10000;1;10000;0
5006;bc1pa3a5ej2na2uwjxzaemf57fxpduld4j7elxedyqpr4sgpw7qfu6qsrcltl5;546;1;546;0
5007;bc1p8c2uva8j33zuppq5md54gffs4482rrh9g6qlm373mgzywt65kn0qfpj7pr;1778499;1;1778499;0
5008;bc1pfa2w0s0meaeudlulk9vcey0grf6xh60feuagk83jc290pkwyqnqsmr2fmg;10000;1;10000;0
5009;bc1pavpexudsr94vf0vm7svtdrqqz77mm005pkczjd6cd7uyzrfjhw8sfce5tn;546;1;546;0
5010;bc1ptxvakyld4flv23zg2vykw895gge8jw3yx989f2vj4hgc3j7j85hskmrsr6;330;1;330;0
5011;bc1p6s5uef27lh7y7kty2h95t8ddjzsysursgzstg7tlaxclr8px89rsjx7vz9;2755810;167;111466931;108711121
5012;bc1pjqphd9t50vy6f6z99lvg9frwue77lw4e8eae7hfr25v2lpnnf2dszk4xv9;10000;1;10000;0
5013;bc1pv4p27ytd6ux4lhg7hcugnfq2qsqpd4rkz5px8u9llmwz2ufh2w9ssr7kdj;1010000;1;1010000;0
5014;bc1pffsk3vx0c2t3trvxz9l7f3pevm72duq44l3lmlt6dnj5cje8hezs47dkd7;3578655;1;3578655;0
5015;bc1p53eywpfurr88r7yxcsvltxf46zudrh0xyaqrhw7nk9tsnce5rdasrr3lth;1763999;1;1763999;0
5016;bc1paxv034p2hz6nedhg2ntc7y9565gurtr9pseyjagclxqj5exesk7sah3pdl;2292;7;9792176;9789884
5017;bc1pn8uvcmz4y3ryppxnxsu42g6aze9u77gclkxcsuqt74qy2n8rkd4qc3uvnc;10000;1;10000;0
5018;bc1pv0d40swzsls58d8uzm9uj5yp3luwyg9nuda0k6y66t86d4ez9xmqv5hwn5;780000;1;780000;0
5019;bc1pn3ffafyvrm2qywy5wuusn6vrulqqah97yg7uyv7dvpusj84xredqv8v6xm;10000;1;10000;0
5020;bc1pylzsj4dyc4epas6gl2r9huqaz8neu35rkpcyw90hdp3dvx75kf6skxce9g;6891216;1;6891216;0
5021;33bYvmF7y1L5jCXAkHDPjfajymA6tk2akd;15166215;8;35526641;20360426
5022;bc1pxqvtdkplt6dd5s360waal3jy2w82x4gc8kjgldz8shc4wj233r2sje0wqs;1745177;5;10745177;9000000
5023;bc1pk59fhlafy2q9pjxu6vzm78ljtm69evqahr8wsnv6aw0h4s3zplxsxqnfwv;1711499;1;1711499;0
5024;bc1ps2zsylt0pyvp2qr0225u0gkxtrjy6w5puvn8hr3vms3283lzlf3qavz0fl;10000;1;10000;0
5025;bc1p5xedpqvyw5vyrrhxqfpq8ry3ycpr7axlzwkhv8tnzfqu0ad6fkgq8y2afp;84615;53;85161;546
5026;bc1pnvg2uuut6d9q892zpqfmwgweharx99xnacqta0ecdl044fsh60zsr9ty89;60509;5;10185066;10124557
5027;bc1pgm43g3tx8g7qq0p7qdkh52l7ymu2960csp9aups8xht5g7xr4tusqvmc9l;0;2;10000;10000
5028;bc1qlzdswzqyhu0zgh3d3k8mtw7cxyzju6nc40t53f;17200;10;17200;0
5029;bc1pd0r5yyeswyhyzdyvzglr6hd5s43jls2l5lm08v4tyjwp0rm5rgjqeucuue;0;2;1627930;1627930
5030;bc1p9hdn3myhxngq3frdzwq83rmqfmu2vd48mw2u4zslz2v0vetfca7q78r9yg;10000;1;10000;0
5031;bc1p8wuuu3tej3qdmqdqzz8kakheyzaymdzqsazj0ql3qjhmwku27elqyfjylt;10000;1;10000;0
5032;bc1pvjhw8jgvqf8ekejq2f7fgehd73l7h46jmfr0u3w248zen0hehppqnrgd7n;10000;1;10000;0
5033;bc1px8tg09wu3hpk79qldmc4fgq64gfnhtvtswuvlhvu5kd6zrv5uxqsf7epr0;1711499;1;1711499;0
5034;bc1psuk0jzapl4sq9ma9gfqjs2zg3lt2u084mxmtpxkrqsw94hrenpuqpmzlgp;10000;1;10000;0
5035;bc1pr599n5ulcrslcgpdk4ksw42eatqjtxugh6d6wf6nfk4vxnqfa48s5tmpy3;1603962;1;1603962;0
5036;bc1pylgkye0dkxqs5eszhztmrlwgpt256q7see6s504nxa63yjmshqqqrn4cgt;6969;1;6969;0
5037;bc1pftmu7cs0e8kqtggrsp8krzjrvecex73wthvhzd9f498z290j02gqlrr3jp;16460000;1;16460000;0
5038;bc1pk3g3lx9y5lkqelzu7rpwcmuupnmvnxnw27ylwffrwxcta0s75s7smnmfal;10000;1;10000;0
5039;bc1pkvkalq7hc5ns7pk6qr0fuq0qm6fpe4pdgtwuaqct22vlllwnw0eqnm3euh;2240890;3;8248090;6007200
5040;bc1pjc73u39fvc20hy2zq66f4yg3neykr2r6xnl5rtg5pkjvgk8qhlws3uhw3a;10000;1;10000;0
5041;bc1q74xfd6w02t9akkth0a5ym4h7f28rl0z4z66z89;19998;1;19998;0
5042;bc1ppjlxzlah3sjxr6mlxyeqs7m6epfhn3yp9rghpeg5z2rnye59q0zstccurk;1500416;5;9217216;7716800
5043;bc1pffjmw7r0q5hzsj4qf77ysulz6rdave5m23udu44w4g3rvy0sdfeqz7uchs;10000;1;10000;0
5044;bc1pav0n2v7tzavh84wkh32j6xfarhe6wldnsula3qhtjjlmxeyye09sj8keun;10000;1;10000;0
5045;bc1pdhnce30qklwdkrz678fd2m8jqe4pwq89eu8c4j2ssuyq0a8r92hqstnaks;0;2;10000;10000
5046;bc1pr4d86gflrf5qdy0xuck7r3p5969xjnzjux5qgwydr525uva5dwkqlgcrzl;389661514;7848;1025328289;635666775
5047;bc1pg29gptzqufqknz9ajh2e0apsap5apkedv3z75ttsac8v7mqfd0uqmw0y0z;17247163;8;41075473;23828310
5048;bc1pnpg9qxn63dd6d785jjxczhl8tefuldecuxdggv26d5ar3t022l2qj85rzf;1680499;1;1680499;0
5049;bc1pcgt22sr02v5kkglsttkpmmznjesghlx528zdnapxmszmh2nzhfws3ne3kf;10000;1;10000;0
5050;bc1pvt99mhrknrpjtglly2ysk9tysx6m5wrjagwwtzk7sz5r0ry9ppxsjkd9dr;330;1;330;0
5051;bc1pfrcqazfjjz0s9nxks9frm0zswh4anze7gj6qqdlegl3dzpm768qqf705l5;10000;1;10000;0
5052;bc1p8qetdyvuadnv05060fvpv7tuu4puvc6cagjvrftspllrfwn2tpcsw3uzjn;10000;1;10000;0
5053;bc1qvs2hts5u0mk06ayecd3m85ps5w5emuxtlxeg9x;46008094;9567;104440442;58432348
5054;bc1pjqz3fcltg7yxjr2lncapgs0mpd3x4x53jwac2jaxenw5l9mnhgssaak70y;0;6;27564283;27564283
5055;bc1ptq5fhg98jc6s5fw9lm63yxh5hdsxv2z946w69x22d5d3vqd4t20se9mvar;10000;1;10000;0
5056;bc1pqvq4tltqel52fereln0c2nj7sxdgv5jyt6gru4lzxzf58c8f7yrsmthnfq;10000;1;10000;0
5057;bc1pfgwns62ku5pm7k07mfvudwm727s9uz32uhf06h7fqnhvrrt840pqhfccg5;330;1;330;0
5058;bc1pvx70k2058wyuk7uy2lh427nn2ur7re788d7mf66fvf8sh0gfp0zqfk44l4;10000;1;10000;0
5059;bc1pa3wyamfj9fetj8k92vysdv89uzuayt8w6ntv2lx4szgy96elvccq09eh7p;10546;2;10546;0
5060;bc1pd4js2eux4jqa7rewg3hqkhfvsr8pr8838z7kfrzpdr6egpxnd9sqgzm8mr;10000;1;10000;0
5061;bc1pvjyf6e6gmr2hjqrtaw57fyermav0ep2879walfsp9xavqwn36gfql9llzh;26091557;394;120958807;94867250
5062;bc1p5qr4z76we5edzk220c2kyalefk85xlgxseh4mljxjv3wrzctwgusdhm87w;0;2;1168000;1168000
5063;bc1psvgal75v30gpvgxa2zpkun2x7z2yjly7ffympzrknz5yuv5u93gsq84nuu;10000;1;10000;0
5064;bc1p34mpfzqm9zle6wj0xxcc82yc48vhdy5ca6s4830nypm8x0twhlvsrd3ym9;911092;6;1721092;810000
5065;bc1pp2ae89ql6e2ye2aafsvswff72hscxhl4leq8z3sx5ajryh8h49rqcrkphc;2184;2;2184;0
5066;bc1psf7j9gyskgavcuwdjnrrn8dqeud4j3zteh0n0zkly3tu3n9q0j9s82dgu5;10000;1;10000;0
5067;bc1pw3a2f63rpenh0q9dkree5lxr2r3g7h7k5kraz32jm9xn5mg82wkqlrelqn;10000;1;10000;0
5068;bc1plkleu3zkaq9xp63ltqglzytjqqayawse7zl5zdfrn9xm48px3zxqdtdwkk;1833499;1;1833499;0
5069;bc1prkhpg4rk7w786ngu6wyae9j7xx2luvwxgzj7e4lcu06mnfca8t2s84sn2w;10000;1;10000;0
5070;bc1p9p0zmagu9962q2h78xwla9akfh46ddmr7nkear3ka8vjdfzrgndsufu4el;1092;1;1092;0
5071;bc1py45z2espkdfq92ljqakmt0t99j3z573rct6kctsync86dxtdz6pqp9qxgs;10000;1;10000;0
5072;bc1pqsejtw02e5v9dj4xrmegpqcer6dk8ljhszyszkuh5krf7lj250hsx9cff5;3256977;1230;5024018;1767041
5073;bc1puzk0nh2lffum747ecgz395xz5e732rfpyfdpgk2snuujccde7z7q730fq4;10000;1;10000;0
5074;bc1p57degdj6vzett22vvdfvz5rt72hajrjwplwlxn3mlra2hjckxhysq8gyfm;780000;1;780000;0
5075;bc1pu6a3fkdd4g08jaza6znmknvpa582sxcnn48vnq4p86yq32duttdqs8ehhn;36321986;88;1185396967;1149074981
5076;bc1pvfwuxyswgdnks0pnun9ywhvta38n6ezql6gxnt07vknraglytrfqdfraqm;999;1;999;0
5077;bc1pcykr044lq3gn986dprqu2p0pyxpv0kcjn9quhkac6cwln24rhf5qj6r8p3;10000;1;10000;0
5078;bc1pahvn489kwhvvphzqxyg4dmyzp5gua4ye4xf0dq9fmjcjh45myfhsjk9aql;4266500;1;4266500;0
5079;bc1p8nmjz0m8x42m9m5ds6e5q2tksx7nxhvj8td5k536mxjvjjgp4jusrn3dzz;1092;1;1092;0
5080;bc1pv4ltlhqv7c77cyv29qvmeekn5s5p0eshwkg27633w5kcy29e8dns309nfh;10000;1;10000;0
5081;bc1pug0r9uuydm28s5kackscm4pjs57vnjc3c4e0kvwn23jxjg8rd0ysfuu4z8;5247;8;5247;0
5082;bc1pgcmagggw5w327sq3lrzf7354wstmktgdkcchyqxcqhwcxqxl83dsaered7;200000;1;200000;0
5083;bc1px9ffvltsks6rwnmv6fr58pfw7ax65cw5j9zdd3hl86fuj0mhxzss7ane2u;10000;1;10000;0
5084;bc1pn7hl74vez0nste2dah732l7y8ew80j36cnjvdhqlh276zt4s347qeq7nmr;10000;1;10000;0
5085;bc1pgjsjd2rp3sfkhlawjzufx2p2fm064kvc04nvqmzgqw5rrtcxlgmsh73yxt;3881714;4;10881714;7000000
5086;bc1pp42ff9tuc7wpe48xw93y7w4ve6s4708fnfwum2nm0mv05eq88txsnvyqtp;1716499;1;1716499;0
5087;bc1pftvr8tdy6kukwvz03p2l09mw0ah0s7wwa3avzkuz005k3450ekrqltywgk;10000;1;10000;0
5088;bc1pr79eu54ylretpad0mepduxfqhen63aq7wzehljdk3rm6tmtdc7qshux3ku;10000;1;10000;0
5089;bc1p8pa9haw0smfs6mnkynqcz4h3d8ceda6d6wdq4lkc9eacfl2ske5sd2lqxn;1749999;1;1749999;0
5090;bc1p5xjlvmfcgxxzmwnwmvdc97ww0303uxlpfcfqqqxvq5xudkqjvnuswd7hsa;10000;1;10000;0
5091;bc1p9srxdqx7u4u48ahj4s5gd3x5m932zm4fc4a4ds5ncm580nh864jqm37k26;117128021;7870;409562119;292434098
5092;bc1ptdqm4cym3rupzl267zxssaqzd3q2fjfuecczl7ulf0p8y33gsm8swsm8gl;992565;1;992565;0
5093;bc1ps84tgw6vzqf4z4zeng0jqjqqkcp6af0zmr5mgrvnnwcn47l592uqhev3xg;10000;1;10000;0
5094;bc1pazs2nz4f0p26fqx009ch5u3c4c5f5rg5j3pu0he973wdfshe772q6w0yar;810000;1;810000;0
5095;bc1p7x8rfqdt3362pyq0ga389e9e08akpv7kdd565llp9jwfnc3vy2as2tl0sm;330;1;330;0
5096;bc1q6fmqp3ytm5nzqv00amknm63axjue2ueq3nj90k;59535549;11409;143161118;83625569
5097;bc1p9hw5n0u2663zys5l6f5s4wvhjvkfukl7269gnu4ykmzhdflt3wlque004q;1737999;1;1737999;0
5098;bc1pl7vcj5mdmm3e705trakwq290efgdlngw5tumze6v7gefg0g7fdxsfnrxhx;990000;1;990000;0
5099;bc1pc38z86nwymn6fus752ul8y26zvrl9e3uf3kjs8qegffq7f0y6vxqmzkny9;330;1;330;0
5100;bc1pdk308vyn82lh4x7ap7t5j23z03wjnvxhqhnupg0v6ceuvx4paycqkgsmta;10000;1;10000;0
5101;bc1phepjw7az0dy5z2gaff6j2m2vj99y7kxa5t4ph7wlsk95s7z3pudsg3q428;10000;1;10000;0
5102;bc1p5fy046nxu6zehusaaapcrmwyyahhcjsy3rp7cavg08k7zk0y3cxs6gq9wn;917092;1;917092;0
5103;bc1pkkflf77cwqu56fg8e4hjcftlhhyvvg828jtte53w9k0ev73v9ahsk99k6h;4000;1;4000;0
5104;bc1pmnnkpcnuuql7m3kngmge8uss00q6hh3j3y47v6gydnlmjuk7ny4s7t72re;2771870;1452;394311635;391539765
5105;bc1pmh7qw06suwwcdgta0p7uzczne8fu4pnrwfm5xaetsafwl599a9lsstxwnj;10000;1;10000;0
5106;bc1puxrkua8xred649pkn22ks746zcacnj3t2h8sz86pd9r9xdrzvl9s0uu05q;888;1;888;0
5107;bc1p8cavuc0ujvxjzqr900wwmjsljzqh6z5cm8tyyjly5uava5q6mvdszz20ht;750057;1;750057;0
5108;bc1pmrt4fy0awngdepjttdeu58k6a2uhkt6e280yqxlwnlzv7ca5dkzs9wyrf3;33201;18;4946979;4913778
5109;bc1pyxuj8u3tanjz8gwa0c3wypkak99t4tlxha5x86ajf8903vw5spzqchzuq4;1835999;1;1835999;0
5110;bc1p9ac4ng9yvf5tctr62a8tpn7evk266gmhr4hpr3r2e8ewheuz4txsstdpnr;10000;1;10000;0
5111;bc1pzfk4ktm4r80eacz22nts4z3hkzuw0gh0wymqupffmr4ecdkhsllsmt2l3m;10000;1;10000;0
5112;bc1p63u2zcsm5s66ljrlunxyvn078mcmxjhqerpcs972z9s5paqz4ctsr7msqw;1728499;1;1728499;0
5113;bc1p7ys32m06up3tz9erlzc9hfzezxmyfq4mxgx23qssvhuu5fxu9xcssgt2ur;0;2;1272000;1272000
5114;bc1p29hrp2wt6glhu5w73elkl74puepnj9ja6pljjdn30flnyr34xkyqhq9mcp;1811999;1;1811999;0
5115;bc1p4t47vyqv6jaslmvvv7dhedrhjx9ky6h5hh82nzfpzdh8l7sal6rsnhkch8;10000;1;10000;0
5116;bc1qwta4yaj7gqhsd7kuysyuwgamvj9xdjwehn4zhc;426927;20;426927;0
5117;bc1pfhkg59nem336hl249egy8emwk0haly6dmja66mlj9qesl8wumqhqzmzf3a;330;1;330;0
5118;bc1p5vdr5zszlna68va9rpxgmcw6ds4ljurverz84s2jvvk5m2d3gd8q2gspg3;10000;1;10000;0
5119;bc1pkjlzjl7g0gxyrautdw28aaefeyhdwnvgx0c3xym680j5r6ra9rvsvycssq;2310;7;2310;0
5120;bc1ppshuul4r5sjt6pfwj2k7sc94vzu62228k46fs04mrwt55dacrufqr6y3ql;1000000;1;1000000;0
5121;bc1pkzvzm7z3alw933v2t7490hqf5qayy7zlk8gkhf2zhdmhqh6fkj7qlvrtfv;980000;1;980000;0
5122;bc1padrpgm347hhlqtqvvzplymcepnakgl957u39w52frdu36w53xh6s80x6u2;10000;1;10000;0
5123;bc1pxgq56pftlzyfqhjcyh3efr7e7asdehv55dt4vmafl0mdup2qnk0s8qy09p;10000;1;10000;0
5124;bc1pwxwcfa3whhk0vklm7ndszkeyctvgus9n0a97wgafl22tt6ux24xs9xj747;1625499;1;1625499;0
5125;bc1ptx5cty4v6gfytm7r6kdc4lv0y7zqzazf7d77w6ffaz9a8ufnhurqgc5vu0;1763999;1;1763999;0
5126;bc1pxyrswwd9ke4ggnkzffxck2q38c798c3rv7f6kxhrq968plum0hgsqs9nsz;1869499;1;1869499;0
5127;bc1pnc5a0786wfawxdpc9xde9spv66vs0gupp4028fjenq69dtgfaehsa6wqer;20000;1;20000;0
5128;bc1p9gmukars028dlreyg8qegnue0za3emldv8p8j8lhk3w4dzkfg5asx47m00;2184;2;2184;0
5129;bc1p8d9kj5x2y65l333nxsqsug3azfrw99r67gk9q38sakdd82x6gxxsh8hegy;10000;1;10000;0
5130;bc1pdshy3dh8vcspjegx603psalexdtr38r9ztys7rxa49kfaf0wc7yshex03a;10000;1;10000;0
5131;bc1pt60vzsuzfz6d9pnr7dnznwf8fj2m29fdnnekp4zum0y8zq3ghtuq4drykv;1092;1;1092;0
5132;bc1pald9j2zp9hv9f5vnxeahg42sav0xt0wlthkmqsfhz4v90702js4setk62n;10000;1;10000;0
5133;bc1p3v36rlcn3jyrxlnqtrxz0qnd6pvfnlcrmh6zdtfrsw06vv9ythrsmsuqps;2121;1;2121;0
5134;bc1pgyf5uehrenastxa94ggqqkz5fjt7jvt88splt7s49axcfsjlme7sf2kcek;204648;47;293642;88994
5135;bc1punhdpxytd9h923z30c5c2xh0xz79sjvysace384lhyvy8nesvjwq0xeq9m;200953;3;2083648;1882695
5136;bc1puwegtwvt6w08eyvvsa4ym9k89zartwwlg9z7u2rtn5s5p227l99s98srt4;10000;1;10000;0
5137;bc1qschfcda64ky4mr80fheptj50axekhyacak9kqn;47596737;9579;106763855;59167118
5138;bc1pacc8w6fhlvc0z0u8lmaeth3lfq6xv8ltnum94v7d3ttq645kwtssp4p7j2;10000;1;10000;0
5139;bc1pf0prycy5fm0xzmlpcepq7zxhapqr960r9fh0ljlxakvsuj5pq83szyg8pt;387690305;54;487690305;100000000
5140;bc1p7k59eg45zdgx9amc2cn074gdwfp5mvaf7565yr70aqa5q4u45ups37j2hc;183250;1;183250;0
5141;bc1pqffpd0q7nfv9tpce3k2ggdjdtw8fk3x2nlqm93wr527ph6k7hp0s0kg8v4;10000;1;10000;0
5142;bc1p2a2pem8ymhmmxsjx7j0f9lw8q478fdrxsfll0h5kq2gwz09vx03qjghfwk;0;2;10000;10000
5143;bc1pcuwkad6j2084asfyccfy0esjllsw7drpfqhne2cqr2q4jv3kt3ssqdxgx8;0;2;6875500;6875500
5144;bc1pd4lfpg2yd0p54tfeqj58gu7wq5nrk0lq7mhryqvytl66tvru2fmsufpcl9;1792999;1;1792999;0
5145;bc1pljlwr3tag3dcjszk0yz4vgms0cg82ywq92gxvgdj2z7u56tpghsqr9zlse;1010000;1;1010000;0
5146;bc1plawp6q9umhn4rwquaflznrm66tfargfga3y3m98dwwge64t5xp0qwdz0jj;10000;1;10000;0
5147;bc1pudqpgdrl5lr3afjwtkyuqmla6tfxaf86nwfmw5m5cuaanrc852cqewfka4;0;2;1712000;1712000
5148;bc1qwrtry4d3fatr44l4qxjvs6rh4j8ehumzg8cp0q;51899135;9408;116775358;64876223
5149;bc1pgtv4rwzuqq2d4v4yfnv5299uulv33ksn6hr6p9cf8mg44scrke6sxlgnaz;10000;1;10000;0
5150;bc1p32nktsuffprllv0j93a2d3q33s0l6rlh598hynkgrt60lf6upqmqasw00d;155083461;8017;623104586;468021125
5151;bc1pqc80g9jqs0upznxvu0mz7lz9dfqcpk6xcmawme8sgevy2r7a3z7s32ydqy;1823999;1;1823999;0
5152;bc1pk546z4y52fx3znpepdlxmp2cnuref8e5k74qlu32c0p3l59wu2zs4vjhn7;10000;1;10000;0
5153;bc1pgdrveee2v4ez95szaakw5gkd8eennv2dddf9rjdrlt6ch56lzrrsxgvazt;14207;16;11070231;11056024
5154;bc1pd9q3md25nfz09xr0s63qgu5d4wmvtrz0kj272d2m45qcw8570pcqf0era2;10000;1;10000;0
5155;bc1pufka0l4jd56tp9edagzh3vs9arxl340080hffe0tpx4hyyjfafxsh6wl6t;10000;1;10000;0
5156;bc1pgmznlxa3yjqyqzsyzuk4tuuwjvjpxp9naxnjg5h2u7pm7pmpyl8qrdn63t;888;1;888;0
5157;bc1pve54238jj3pk87ujj0dyee09huwpqxdzk4dw0jc0trll202udk5saedtc8;980000;1;980000;0
5158;3KJinQZueh7wQqEtNKKDmC213DwA2jfioC;2692360;3;10145640;7453280
5159;bc1phxh9sf2f6wznrquzk0tzvptdmhxkkxdjh94jqfcrg95ww22kuf4qky8us7;1668499;1;1668499;0
5160;bc1pznpjg56slgetnzr3s0ad0mxukqhrfzxkeg4w3dtkk3559fyc5veq2canff;10000;1;10000;0
5161;bc1phxcy86mpfnx66lnjewmjqmj83lsx6rqz46musjz0yrgqldrspd4s7w0jky;10000;1;10000;0
5162;bc1pnaja9e07vhfquytk8dwr4rdaejh3938hsuhhk85gghrm4sn4eryqjdu9tk;2184;2;2184;0
5163;bc1p8vcedfgvfjht37jvhtxk9gj57eyq0qf632cf9s4nxrczjta86vjsvv2axh;10000;1;10000;0
5164;bc1p3v3e4w4uxhe09agckjzlsuc6uugmqhmfkfs0gd4vdpqsqmhlfmwqyu7mv2;1010000;1;1010000;0
5165;bc1phqksh3lylev7dgtmajfk9pedza0r6l60jdgr35yvlx0r6v0wxp6s60aed0;10000;1;10000;0
5166;bc1ppnq0pa8pst6a505qsax2zr9rxs4hyhaeyey4hhj7x3jetr7d0zaszf6u64;1000000;1;1000000;0
5167;bc1puapqpujua4e0f9njh45n7pr83qdy3y5u0900jrstx70fnsrpknys6rjzgg;980000;1;980000;0
5168;bc1p04r308sxn07dh67xws58lhatm3hxnyklz7asa2kn77g74v4n3u9srcj8r8;888;1;888;0
5169;bc1paaejwpzlu2m2287uju682h46xsuglxa4f85ez05cpgcs0lur5hlqqwserf;10000;1;10000;0
5170;bc1pvwvqynvdcyq70xuv09r58cwumfwwgrdhpr3z6j5swupwcryk02yq7y0mta;0;2;905680;905680
5171;bc1p76uy6daxjf9uvn8dh3sk5x5cvtwm4pg6jgyg877v9z3427wz5wlql0lqvt;10000;1;10000;0
5172;bc1prg8cdvm8tf45etr3z9lc4antcr2fy2n6fm82pwgu9lkxjywshe5qzc2gcx;10000;1;10000;0
5173;bc1pln8995lm3yw8ev0ghwmjxnpz4n35lp5u59nd5g2qlqrlaumjvz7sq8ua7f;10000;1;10000;0
5174;bc1pt056vw67kpddj93vmwm20qas4uslnvjrcjydrj37s3te2nkw2d3suv0lfa;10000;1;10000;0
5175;bc1pu9l2t0epmllxmycvkkxwpz53a2cd8w6afffvkd93kcf7644d2e0sc2rnag;1754499;1;1754499;0
5176;3DFU3ehBEhU24pYWN4n2LEdEyQxALVtHpz;1244722;2;5970582;4725860
5177;bc1qxll9zf2y9c6p0c3kc996uxrzaxwfsan8w3j6uh;570310;2;2117420;1547110
5178;bc1pneraex7z39sex26pm7fx6kr0hxkdvp7r89fsywv4fv0kva6l6pvq9aqzyy;330;1;330;0
5179;bc1pngfe277g0dt67an9nuhetvm7ul4s3eqsf0ymn4kvwrgn0fpftczq6tz8qx;2186719;1261;795473359;793286640
5180;bc1put50srf36xwc3px8dpdxhvsr2t09zchpssse87tjh0kycy88hwhqvymnea;96105;5;4214563;4118458
5181;bc1px3ksa08yudddxajnj32adakgdjm3zft6se07gag4hxr27qmfl3sqkxdmn9;546;1;546;0
5182;bc1pmt6qtn7dn2ddn2a2xh90uxun04ec2lj307jsgj87qp3a89yxx9pq8rpnec;10000;1;10000;0
5183;bc1p4grxfswzsqu2fv6nqhs9xhjmedemazf5ljkfyhk60eqkg2hgdjzsuupsqd;10000;1;10000;0
5184;bc1pulc3cr4ztq2lr0kskqys6qv5s028fhe6hdxsycqnxs9x2a59f9lsg0ajdm;980000;1;980000;0
5185;bc1plak2vg5e8ywsghlgkmg6zn0vgswm9ygdthr4u5uzew5ddqv2k48s5hp67q;888;1;888;0
5186;bc1pcqvgztydya45pkpgxh8ny7eqrnywu2atrsdnrf0mq6dvklrwffgqszzhrj;0;2;10000;10000
5187;bc1pfzmlznu4y7meunaztamyutwgjq8qnf65tqa6ylgmwxrtv2eszflqplkj9c;1000000;1;1000000;0
5188;bc1p88hdgk6n2vwtk3gexsxnrut4av7sff4r7xk0w886lfmsuhf3666sztqtdw;10042;4;4010042;4000000
5189;bc1p6tku6se8kl78jdxfzve0znxxm4a3yqq5ac42efturs8m440m6yssf4mydl;10000;1;10000;0
5190;bc1ph9n4spg22xja4qmkqyah9j2z2rpl72f385terzte8urvadgc944qv9agk4;10000;1;10000;0
5191;bc1pdx2nqk7k6lkl6p7ghzvlrhhqfeepkyxlzrqngjxyh9h586duh0mqpg3p8w;10000;1;10000;0
5192;bc1pq5f2f0n4n0fl9d2f35v07xvgwrdtwf3p3d8zwphz9j8syn0ha82qcm064n;1694999;1;1694999;0
5193;bc1p2cmhs8jf99klgzgxlqkunmxn9v4uujsxgy2am4f2stdgk50z68dqqxmx8w;330;1;330;0
5194;bc1pk50x472y3lqqwrnvuukj94s4r3hhxkx7gyete0ldtu63ukxzdyjq2dqm93;10000;1;10000;0
5195;bc1p8lg0vhmqmuln8fnhvt8tuhfukj3uzzmrv7fq0dhdht5444sw4qsqd7gu4u;10000;1;10000;0
5196;bc1pnnkqdtvmf0394k6s3e92w9303mx4gezfj0rjch7z59vdduvxnjrqvqer53;1823999;1;1823999;0
5197;bc1pdu8llz5tj82z8a442qk75mmm0r23flasd0lv8z2vy2azwk4agj0spexk97;10000;1;10000;0
5198;bc1qq7mxl5sktg7drpg3u8lqgn9u9dptjcu2gnmzzg;2201020;14;19900960;17699940
5199;bc1p4vhzycv6xz20p58459wmyttq0j7msmvlenea82ujhdzjzhgdrr4sjct2rz;10000;1;10000;0
5200;bc1p9jyu5hr4elrnftwu7tfkycenc6lp344xqd822zajgqdf8dgqnl7qflhvfv;3330;2;3330;0
5201;bc1pqpxrvka8ckttsjt6wln88hs8wt7hzf0nhum6qf42z2dut57c5hts4ddepx;1689999;1;1689999;0
5202;bc1qr03me4ge8ymk59w2jh0xlrhv4zxh2wetuzluh7;109888221;9354;18980655003;18870766782
5203;bc1phq79veug3sq6w6rulrd4gdpkgk3na6jag66ys9ctwsfw3s4dy7ls0wwpjn;12669844;278;322570155;309900311
5204;bc1qws8v226ud64jh3n3k7s4uj3mfqf6hlrn8u7382;160301;24;160301;0
5205;bc1pc2wr72kngsg339nxdxvt0365u5mncv2xq24lgevcu85j6nz9dwtq7zg47y;1010000;1;1010000;0
5206;bc1pjyv3dxp3samsqelddt88a3yhcjlz64nhl5vkg9aulve789ykwu6sfzepzv;10000;1;10000;0
5207;bc1pn6raja2nccxgw3n027lwszghmdz9pu6q2y89et06hhsgk0aqvacqnzh26e;10000;1;10000;0
5208;bc1q5kt3nlplanqf03qskzxn2rpssux88zuxql74yr;235294;3;2377363;2142069
5209;bc1p7tuyj8cr2e84h4fuzwl52c304u4l70gvq0ygtk4r5ujksz4s3vrqdfdmhl;10000;1;10000;0
5210;bc1py3zn3z7wdsckqctwkjlwqvdwlgvr9x6j6yya0npmvppxutavmzns67qu07;0;2;432000;432000
5211;bc1p2pv4wy6hx8ygfy38dltf2w76fe2csmzckv9s727d64uvgmlt6yvsjweqwa;874330;1;874330;0
5212;bc1p56s9najry9apwmqdm3ntdxfh2cq4rax4szfqjmlzkpztgzxl4qysx7e3gm;10000;1;10000;0
5213;bc1pnmsg0rapvlugm7n87henh4dmvefg25f99y5lt6r6n2nesy2f2qsq3r5en6;10000;1;10000;0
5214;bc1px5z8lymk9zreeyyshgy9l5f6zg89jdngv9gws23kmh95hqkfl34qqzm4yd;10000;1;10000;0
5215;3JP99kf5FAUWzY9g7j13GRYTTvj4uwNguS;958073;377;999958245;999000172
5216;bc1p34h3s7cuyywc6v3qgextcdagdgglf24m6dcmja8q3795mfpzwxaq6wlvp7;10000;1;10000;0
5217;bc1pse842w7tagxgst27pxj7zp2cwfzp369gjgwek8dnsnv8h4hqzw0s0rekgu;273600;176;279606;6006
5218;bc1pyrkstln5ypmsxn9xjlc7se273vqqa4uj3dnd7pkd2qee6kx07cds0azsut;2640;8;2640;0
5219;bc1p08kgmunh59y2j7puwuysu5ww6wp68f5xxjt3cvkht9gx0q4m22rqhvgk75;990000;1;990000;0
5220;bc1p3ug3fdpc9raxjff9reestc7lqt4t0c0llaw09gdc04e4l43nj3lsrfy78r;330;1;330;0
5221;bc1plu5ffzf5fu947mx6mrr8ylp6arm47u6u3yvdhm5v5myj2vd9e8pqs6waw3;10000;1;10000;0
5222;bc1pr3t9wgeyd088jhu3v6ejpa9hqhk2qr84pydm3ns2fn6r3eev2kmsyjq482;330;1;330;0
5223;bc1p70ngqvx6rvl7stdsq0rzgm9qswaftqzaelklr2s4cq68m88g8vcsxm2fmy;1020000;1;1020000;0
5224;bc1ptxe3lrmu7lmk26cpnr2hpdsfv5gw2euyjqcez09nnx8hutha8h7q7m36nd;1020000;1;1020000;0
5225;bc1pvu5lh96mwdezykfyrnrj4cvx5tmu5c96yacfj55cn27qcph59jlsrp0atc;10000;1;10000;0
5226;bc1p7t0n07q7s4jlqernn6e79tew8pucw8v7g9zpay8s3rzhk7rgksgqtfjz77;10000;1;10000;0
5227;bc1pj5yhm6j0nssz4g0ljczt7ju2spvxmw66autntvg40r3qkd64hwsslccw9h;990000;1;990000;0
5228;bc1pfln4lsvpj0tu9mpwu6txs0z8csekue3j4yttt40xegush9rcflyscp7kpw;10000;1;10000;0
5229;bc1pe9w34px4h2343q5srwea5gdqgue4rx42rzlal8zzjk52vywalrhsdtf9zf;990000;1;990000;0
5230;bc1plds4zkk8xe7pk27msc0ruju3kl07kmae6lujn3unlc5uz93gefnsg2ummm;10000;1;10000;0
5231;bc1pcw5xfq3xhp77lxzlergkx85nalu9s6elkyn3ynvajrgnlpz9k2qs5x4jw8;0;4;1807638;1807638
5232;bc1p9hfcm49qxjsau6dw3xxzrhe9snzmdfytj97ntwsayume9jjj4zpqmdh25w;10000;1;10000;0
5233;3Axkv2twWaywktJUWKKYjLZV4P5Z59BGsy;1063049;244;182432707;181369658
5234;bc1pe2ncqxdxe9e4zsxwn3tye3yf4ghr7tuqn225e59nfjnx4gkjhtjs00tk9y;10000;1;10000;0
5235;bc1pplgz9afmqeeyahl52mh0skh4a0hylc5vdtecrudqtgvyy4ug5w2suwprvh;10000;1;10000;0
5236;bc1prh3yx2s9r6l5urzmg8k94zgux07vw08uueznqacmllc2t28xfx8qsdsnca;1092;1;1092;0
5237;bc1qas6cx5n6q6f0jef6ynvqfxn9r3ertqxxtk0znn;4215140;464;1037834490;1033619350
5238;bc1pw9lyharl56tllguz7gqdcd6trn35dtl0ehgmj4p2qcr7t2w9wygqzhc0hj;407392;1;407392;0
5239;bc1pnwwzp60yf6h6qu788tks7teq09wrgyk4ses9fgxmys3fdl8weuaqh6n2mw;331;1;331;0
5240;bc1pu6mrtszhtvthfqgnkl6ljdtrrv8dup7l862e4ys2ktv87t5pal2qgvelnw;10000;1;10000;0
5241;bc1pda4w74gaza96vugwn3cttmh46jsvnm5lcx8960m3krvcd59hap8slt7yjz;60837;12;60837;0
5242;bc1p2crfzsynnn2tc2n204qac8ftsfd46hly7hlhpvglcaxnzfssavvsnqvm00;208530;93;36870680;36662150
5243;bc1p5xedpqvyw5vyrrhxqfpq8ry3ycpr7axlzwkhv8tnzfqu0ad6fkgq8y2afp;84615;53;85161;546
5244;bc1pwytt5nxmp98087f7qu0l7l8dsy5qu4257f3vh5n7xec7ptfjgddsfmjuu2;1010000;1;1010000;0
5245;bc1p47rs9mkaudpzk6wzez4fucun37j6zk9dmm69lkmmw576ujfu8lhskkfmdz;10000;1;10000;0
5246;bc1p9523wxgpd5dsyy8p3mkzcagncljkngkz595hfddpwrurp8hawj0st3m6l4;10000;1;10000;0
5247;bc1p56m8esf4qs29u28vyj72l7n9j8256ee495kuazqmqc9wcu9jqhrq77ed4l;10000;1;10000;0
5248;39sje8sewoLmE2VoR6WuxUi2mu8kJsLSHq;52438729;232;1275595571;1223156842
5249;bc1phtkrl5x2lce5ckgqyuz7ae0haendxseln9hp5cpjgna3njkh6gss5alx44;10000;1;10000;0
5250;bc1pjqtzs8692xqdkl9859a2dzy8f5g4ul2zakzw2qwn7fu3730keyeqckw7d5;1092;1;1092;0
5251;bc1p7z8pzwu5s4mcauj97agmtl494vu0h6fldfver6kljppx4zg32u9stpw4cn;419010;1;419010;0
5252;bc1pgzwmnsudqvfzd4j39l667dqg0nfszp9et29qun22aesudamwanqspnevya;330;1;330;0
5253;bc1psntlvrg4847s2k4jm8uf2vd8un6mgpvxy9d0rp5hz3ezx3wtvpkqagvur2;10000;1;10000;0
5254;bc1pm22epy45qwuhxmq02swmmf8gnf7z8ujs5drqqx4kz8e0jgemwmhsm9ge7w;10000;1;10000;0
5255;bc1qpfucdgqef63y4q9eyqed424nmwkr3nqs3pya8n;26579964;13;146144111;119564147
5256;bc1pwwq9tyrs9pu7hnr67lm5vc6uch89c6y48ay7ddx9rm392ln9z9rqqtsrja;13788347;9;28614816;14826469
5257;bc1qxtv072f2suc0x2m9qmy4wsasd5c3stdy582nmt;4124426;45;85497353;81372927
5258;bc1pl2g5jwdkcxxrfnx2qj8d9n56l64kvm7f0x6utrn622f6nemjl73srnldwx;10000;1;10000;0
5259;bc1p4c9kzlatmkqjj80pg6vcw59j3dkj3jmx2gkqpm8xwrwvv0lapvrql9rxhn;10000;1;10000;0
5260;bc1quh9jm6p06nqnvgvvv733pl0g0y6ycxl0aas2t4;8505467;7502;695540515;687035048
5261;bc1p6lefu2z7xkcx5smcteyskwg67v989xmcq25lm2hgsap2glehvassf46fq4;331;1;331;0
5262;bc1ppyasy95rghpedh83xzwztz2c8k37uwez3a2ynlelvzmn7l34hz4swsrcgh;10000;1;10000;0
5263;bc1pr4d86gflrf5qdy0xuck7r3p5969xjnzjux5qgwydr525uva5dwkqlgcrzl;389661514;7848;1025328289;635666775
5264;bc1ptzjfvvzdvpfjvfrl42a2p9779d67kyy8zwl42uc2q5mvz5chzvjskyuagv;1337;1;1337;0
5265;bc1qhpwtsevme4w4z9cjellyn3352uz5c5xpelujxm;206098;24;206098;0
5266;bc1prskjcv0fraz6tq98pl32g7jreetra5p5shl7m59pccpa96vnrn0q4tc3sn;810000;1;810000;0
5267;bc1p58a970v0wy73vx0m7qsg47qvsdmmstqyyxashznc73529vuaxjvsll474h;10000;1;10000;0
5268;bc1pmv50y2665a8mqgpcc0lde3sx7qyllxlyryn5458yrmsfhw5ulyqqkwskdq;1337;1;1337;0
5269;bc1qvs2hts5u0mk06ayecd3m85ps5w5emuxtlxeg9x;46008094;9567;104440442;58432348
5270;3MSiucrUFFMz4NUB6XJFLxYufhruWXJ19v;39488405;359;1836044873;1796556468
5271;bc1p2q4v9kmhmd3rqg09dmysmwndqg0g88ghdef59s5vnw9vaj5rhqgseyq637;3150777;1;3150777;0
5272;bc1pcquka2hxat5j3pzpce79ja0j3dqyq9hd9m32f3cz74sxge2rwz2q4dcyau;990000;1;990000;0
5273;bc1pqt6z3mex2tcx887cfexzynr0f9hyeunvlv6rcfkrneds0fchdgxq7ahh9a;10000;1;10000;0
5274;bc1pnlvvuuxdrm0ssd47lrhjtdh630uhs0kvvktsw4vr9apuugfpdzlsnqkfv4;10000;1;10000;0
5275;bc1pzz6666663y4ewkmn826ht78fdvhwcyzlp32wgdp2ajefmm9zpzzs7m7mgn;1137852;4;2206757;1068905
5276;bc1pw7r9km0q4jcghqvvq8u770rtrdl49u2jqn2tm4u2gyqctnyjrfgqkukg5h;10000;1;10000;0
5277;bc1prw5m7kckl2kxdd6wkhvys3kee0q7nsxs45sx058388vxpk2fku2sd7jxgn;10000;1;10000;0
5278;bc1pcwfdk73va777zymjrwpwuk8khde7chks3egr6rdtz0kd0zk6hv3s2t5nes;10000;1;10000;0
5279;bc1pxd3nqckywjqjpra8za0u3zq82l0zlnq5ufm85lv5zjqs4x3yct7q0vufev;10000;1;10000;0
5280;bc1p0lpe0saaltzrpsszxls2l85wrtgc7k502dg5hj63500m7ggqkvfqu8ykac;385000;1;385000;0
5281;bc1q4pwgu3r78s3lp0cs7xpucj43ayhd3cj40z8l7j;6638689;419;646620051;639981362
5282;bc1pvv4mhjza0qt2qrcgk6d297wsnu3j0a0u0qy9cn5xkd8j4psnk6lqt886t8;61290;1;61290;0
5283;bc1pmz2sc6n8ylecp9chyqhyar7tskgddfsut5up3tpl3fpjyu5qdplszzhdam;10000;1;10000;0
5284;bc1pu32vkdcj2p7qhfxqtt0z5u6vzmhe98ms5x6w9wcd87kmumaggrtswj5yqr;101092;6;1721092;1620000
5285;bc1pjmtscx2ef3qc9c2wy5x8dj7q5033jhplcplvxm6fm0csuj4utzvsh96xa4;10000;1;10000;0
5286;bc1pneg53cm5eddea5wn4qzwj7rzfdl2679gfgw44m4qgjelwzfgfhwsn0x0um;885465;118;154856353;153970888
5287;bc1p0xgpmr3cnl4x8wwjpltrvk52hmez8h76dcuas8r2gmshml9ahg0srl8fh8;491000;1;491000;0
5288;bc1p9xy9rlrcz3yf4kv634glgd7cljn0ex4hc7yjl6d235jc5evx0j0sfv36gn;10000;1;10000;0
5289;bc1pr7kg9c0vsm3euceea3lnnugvnc9hx2hwyy4y630u2vg22wzsqtqqgqf4xs;474236;1234;1474100;999864
5290;bc1p6dpfae5j0m2f77evp4m8exnn7sllzq8sf93vt54xnkw8mpl4gr7qs2ep0x;10000;1;10000;0
5291;bc1pvlhrdze7vltj7q04ml2crnx7l3lh2w7gldxnch09vptten36mupswcsmm4;77656;164;90089;12433
5292;bc1p65tq2gf3kaejag7esxwfu7uz2txq5rp9qv86tjkrnwpurtfw9x3s5vsj7r;294000;1;294000;0
5293;bc1qk9q224rgve4hpeye8sajrpyahmefh3a94ce46t;126184;21;126184;0
5294;bc1ph6ja38jazjetrn0v3syzztp0zew0vn4phwkjawjqrrl72wxsqwvq3xgzzw;330;1;330;0
5295;bc1p0xgunaafwrxtpsplgtfwq2k4a57ve5x6c7zl34crp4farzj6jhaqyyvftn;62783733;804;379928440;317144707
5296;bc1p06c6x2u959cxld2lqnzd66tmya4acg9utntjhyhf9zhljhawyqnsz98jhl;10000;1;10000;0
5297;bc1p0q05fwrlxwc33pl8ercpn6m5qzccje44vt0hxdrgvmrwkj6c6uyqhjn8mu;0;2;510000;510000
5298;bc1pzwpyz0pktzrmwcc4p2ft96dxfyjgss7g0p3xusftfzvjr7tttrgq7zxjy7;10000;1;10000;0
5299;bc1p8m9u48hll3shyhva4d23p8333cz6k4l0qxfmphlf46tyxw2y72dsqnufy2;10000;1;10000;0
5300;bc1pnp46mnepttek9hnllsnuv46snmh7k9s2mep50jcpg5h3qc24vveq8jxwvk;622253;111;35179745;34557492
5301;bc1pe56v4ea2aaj7hsyvgs0cjyz2hjcpr7nywcwwxkjlr990jh84gekqyee7m0;6006;40;14196;8190
5302;bc1plf560fgh4s7e2wf9tgspxarp0j4zqyneech9em546202gwjznamsdpy25h;0;2;301123;301123
5303;bc1pymlhptwq5sjq4ez90rlczcjtrrz3lhp8yve2m5tjz8dcszga65js9punec;308190;183;325660;17470
5304;bc1pt8rhn6dm6amwjr3tlyzllvy4gtr7uzdenwxa2q3mz54m2pzpevzqkcm58c;113489701;8062;413436073;299946372
5305;bc1plwqsshu90d08cu9ulkucuvc2553ahx7c2aad2cmgnssdwetzdulqrk28c0;1000000;1;1000000;0
5306;bc1pqyxw8304nlz3lr2jp8hnpxvsd8vks960ctlve3vucy0g788p8xsq9mxkxr;121788;19;131453;9665
5307;bc1p6rmxtz38rmfhtgkn6qhdukzev9pssquwjx8csgry2zznwkpg54eqp20mlr;10000;1;10000;0
5308;bc1p53m3xv2dztnfef0g3je4a5yv56439zjlcyax7twg0p563n5f4kzqeeqk24;10000;1;10000;0
5309;bc1plsju9kz8jhreu5q45634e7m0v52dr06zv8crxtlt77cl3hmjp5zsm9wdx9;1721670;1;1721670;0
5310;bc1pe4zlmf99zm86afq9tcsppzys360x032uw236sed5cy2hdfk8jjvq4eulwd;10000;1;10000;0
5311;bc1pk6cgec7lq5v2cd2ytpkwq8wmum2kjk4r7rylnuyzl00rz4c7huyq7h4hc4;10000;1;10000;0
5312;bc1ph23p3a57f6z6sngwzxahlnpytz6fcvhg3344ezhxzgv2u0tugxcs2m7vhu;10000;1;10000;0
5313;bc1pr64jpxtae44etu02vgapr85s9d69yzmw2xxl2430v0sy0g58pnnqt6eg63;10000;1;10000;0
5314;bc1py94f34w8yupw4nlz2zjn6u9xu988ddpyszprua2pfa9tq39kgmaq7cakr4;10000;1;10000;0
5315;bc1p4zn85k3swcks4qq2qh2xrwaaypex49llhu0ymkm24qa6mc2u7fnsrpa3j8;10000;1;10000;0
5316;bc1p0k2wyjswe75677clah9ky09y0khtz8k0ja5g6f8s57dkuctrej7sjp7a4n;330;1;330;0
5317;bc1ppud28ttf2905a950632czxhqhs0p5a3v8943h84zng5p97m2ws6skmrf2q;10000;1;10000;0
5318;bc1pznd638h5gw8mme9vf6zeauuvw0y2x2r2fx9ukf2r9hgm70rzrapsh32ky8;0;2;366000;366000
5319;bc1pps8yasxlxs9ntv9cxe8g0djaztdlx2qtrnt6pa0ewq0xsfx8j49qqfnv7a;10000;1;10000;0
5320;bc1qq03cuu4xsfqxfy3358gxefgtfjav8kfcxdp8ev;9084465;66;17550430;8465965
5321;bc1pxpeae8dv3lhesnx5xg33fg9ap54ep8uwlprw30ykdgdjpqelt85qx8ckp4;287079;216;8824615;8537536
5322;bc1pv2m0hmgul9u628kv6qfdkduz26xasrcmth453wuhfyu6kpemyp6snedak4;708952;1;708952;0
5323;bc1pqnmsgk24w5tuj3zl6v8zzv7et634tjs5g0qg9ryz9pce9mdgl8tsdu76wm;410991;291;578247;167256
5324;bc1pgyf5uehrenastxa94ggqqkz5fjt7jvt88splt7s49axcfsjlme7sf2kcek;204648;47;293642;88994
5325;3Mu2WxB49GC9rvHjg7nWwgTdDGkoDPkFAk;983094;55;82387879;81404785
5326;bc1p39gulq355t2retpza89ug45ggfj9el03nmx3s8vc892sp853dzkqw6yw20;990000;1;990000;0
5327;bc1pt9cpdwedur952p8aacuya8tlddfkekwc7heea4ju8puvp4sqz8sq2czytg;1010000;1;1010000;0
5328;bc1qlxxhq42qqp54j3l8af694zk52e0elnmlvl5m6q;4573129;3;9573129;5000000
5329;bc1p4lx4e6ztnqvfxmuk8kjh3jvyrzr34jnktzxyqe9y8cujy56dzkvsteajcv;428548;1048;941324293;940895745
5330;bc1pj0vgkuy5vpcs74vcd2rzr3vju7hcu4hlts6hejg7rsuaqjctkenqm7580f;10000;1;10000;0
5331;bc1p4qg3fav3se8f9ntp4sa5km4gwjztk0d939swy3yglet4vx00wkcq0syuk4;4189977;14;24638589;20448612
5332;bc1p4hlqnkupmzucruy9dhhsg7r5dzzcgky37g764kv3t28c4cvr9cnqgsq6ct;25419111;7;103277921;77858810
5333;bc1pqu0f7kmp8hsf6zxyxc064gse3rpml48l47g6w07fal0f3e6ylnksnkal9j;10000;1;10000;0
5334;bc1qsscx7qhgf9gwksje0zltgyrw3ztvfl9x6zj6m2;49803819;9685;111050707;61246888
5335;bc1pshdqd2zlz0xh2ncmtk5tvj98ex8pqd4ee3p2r79f3v0ggl24yjks954c2x;990000;1;990000;0
5336;bc1petltw2qy2l3j2pprdshqrcvcnxz2hxx3qclupq52mstgxc3556mszl5ae0;10000;1;10000;0
5337;bc1qwrtry4d3fatr44l4qxjvs6rh4j8ehumzg8cp0q;51899135;9408;116775358;64876223
5338;bc1p32nktsuffprllv0j93a2d3q33s0l6rlh598hynkgrt60lf6upqmqasw00d;155083461;8017;623104586;468021125
5339;bc1prranzv969llwyxjy0ztjr37kye8f4mww0uth20kehkdjaucdkvsq7t3dea;10000;1;10000;0
5340;bc1ptk7ly4g2s66xz2gegnfgslcfc6t4vxwg0tdhjt2l04lkvnd9dczqggfqu0;876;2;876;0
5341;bc1pz2ajmjwp0acm9qd83fxgyv7sr0z9y0vmga9n7pj55ek4q2kn4w3s0rnlmu;90689;622;149545726;149455037
5342;bc1ps83tlnl69k5yjjdtmlr0w9g3lf7wauv34nsg2awqfxalwf45gk5qvrz5vs;1010000;1;1010000;0
5343;bc1pktjlq4wk4kn3r32c4y65fpqeksw5chy5zw39pmmc993y6hyk0j9sgkcph7;1000000;1;1000000;0
5344;bc1ppcpvnae4h4wwk8452qxewe8andaxz2p9946t8qk2xs7jsqaxzcgs9lghmk;10000;1;10000;0
5345;bc1pd9vvuxrsnch87xhlr3dm8l50u5mhktw2ezp9y4803qx7vhxjz96sefhq64;2730;8;4275;1545
5346;bc1phyr42vxzlgs87w2v90wf6zsvec007ds8tx4qfl589hkkkvzz67vssp6qw0;10000;1;10000;0
5347;bc1pnaja9e07vhfquytk8dwr4rdaejh3938hsuhhk85gghrm4sn4eryqjdu9tk;2184;2;2184;0
5348;bc1ph20sjwufcwd98tvh8xjmz08ecp7ha4f5e98q68vrm4g8snsdx4aqv9rrf8;10000;1;10000;0
5349;bc1p26dwhkguxs33z9s2yqnn3uhzwvn8wn5a5wdxztdnmp5p4sw25azst2c3dt;3330;2;3330;0
5350;bc1pg0wk7fndvtvdtlw487dan8j95s6qj8y8fj5zw6df228yft2lgqzsuylxdq;810000;1;810000;0
5351;bc1przeplhuu0cz5pke0f34c0z5l5gxdshvhaggxhrdn22urajnnftwswnl8tm;10000;1;10000;0
5352;bc1pn5877d4n3fhaysjguv7ul76kg2zdvj65wpqddsrra9su0fl7hrqq3euwaf;10000;1;10000;0
5353;bc1pvmcxxgyr70gsm3at4sg0p6kplww4yntp866jnkz79p7ymkyqcwesxfe8qj;1092;1;1092;0
5354;bc1pcqms2fr4ytkjda0svyrn56h0glpzq64mflerae9ku38rjluxusxqa954sh;2206672;73;2206672;0
5355;bc1q275nt9ene2m5s0eqw9h2j5pxfl8ml7hkx8uup8;11541940;4;125472950;113931010
5356;bc1pt4c0wzxdt488ka2n7tqrjf703zk9fakn9zffgwm2la6mt4ka5x6q8qf744;10000;1;10000;0
5357;bc1pdgsythkq3pgnuneymmg23duwlqfy5uu26w3nzxe4h3z0h6yg357qe4ma55;10000;1;10000;0
5358;bc1pxhseq7zwc644fhk55hvx37rzkskjryxddj0uzlrw20jz35sa326srjrvva;98630798;4;198630798;100000000
5359;bc1p86fyehmkhk6elhca68ycd0x7xvfy526jra5e7f295hdf4n2vvfdsuvn6ht;6825376;1;6825376;0
5360;bc1p6lnercs2l0fv3cmx22usst7yfafnswghv9kmgwz4kmy2kxndt7us8gx9nq;830000;1;830000;0
5361;bc1pgmeas4kj3t7agkrs486rqdw4zgeh6d9cdvysc66xydr3rfvvr37qyy6xnn;10000;1;10000;0
5362;bc1pa8zj7yfuxhxzuzhxmhkqdsm3e92v6kak08hpt776qxpm3l3nqdaq22g0wn;990000;1;990000;0
5363;bc1p9whtu5lka7d0frs40sp867609l6pmrucck4zfz6t75adgxqjculs679j28;1010000;1;1010000;0
5364;bc1p028smc35a8jxvjdeet4dwq7ttthnrvnwsu3ht56zv72pnpxsu23scrwgmc;10000;1;10000;0
5365;bc1px6680x9d6x2dk7eaxmc0nkzapht9txdhtx45utev48hwwscgxs2smw7305;19905700;1;19905700;0
5366;bc1pptdcxugzewyvn9t7x0jnph8crt9zwmxc4sv6thzm305f4wgkdc7sdr5h0w;10000;1;10000;0
5367;bc1pajnjerj6m950gssgjdnxgrupylhcanuvexm29cmqavrrevpvjlqsrpwd3r;10000;1;10000;0
5368;bc1pn89h69nmwtcnmdvud7e0r3pvej2sz5lplc3f20k50f633quutk9s3px242;330;1;330;0
5369;bc1pg33nctx3mnw85s3nnxy3p2fu43t6dr9wgevynteepv0uhk7qw02se36t02;990000;1;990000;0
5370;bc1ppu2eevegx8gef6wek83w5p2fg6e38x2xxuf2c47649q0vz9t8els5cmnx5;0;2;422000;422000
5371;bc1pmf8uejdffjmn3s0e4stghcm0gj9rvp803g5fxxewa30lktxuj25qg0t3e2;990000;1;990000;0
5372;39XuSofwsWFm5icjSNHtwM2zLG3iHseLNo;321115765;668;12344709321;12023593556
5373;bc1phwv2dx28medh7lrcgukkm8r55r00mrgc22uj2eshyrs72nexq9cqzxp4y7;3181472;75;3181472;0
5374;bc1pc67lcxurmtc6mvy8335qh4598phc8epp0574620egz732htryvgq930zkl;10000;1;10000;0
5375;bc1pwn64un778dhgqqxf009vje2lyrxyg0pm4gyjtp55epzs05vqe9fqwyy7nr;990000;1;990000;0
5376;bc1pfae5fcg6v3ruwqeuvrvrpceffh36r396qcqe9atgt9dwj8pr30zq6rp6xv;10000;1;10000;0
5377;bc1p7kl0xqz4e7wfnwxcr5sk08x0nfrqfewxdj7azh8t7av4wl9wrjssmaevls;535092;1;535092;0
5378;bc1pzzg3rrtfdr0xyghhe52km3jesm5kmr5mf89jmh4w80dx03l7d5kq0g6ww3;330;1;330;0
5379;bc1pqewphydjnfmkmafa5a0tc0facu05nvq2k7ul4ms6r86vsd06sc7s9fy2qr;59630;3;2059630;2000000
5380;bc1p3m9sahj2fyexj8l46vq0kde0xplm4ypev2gr23mczed466k4cxkqmpcjxz;10000;1;10000;0
5381;bc1qqhaefwq7yt2v9tk6nchvvk0q4yfu9rjmka7en0;60881;20;60881;0
5382;bc1p7jrqtzkzwq3xudjcjwfdhngpf3stvmn25vwdeh0zd42r3w94wygs9kckjk;10000;1;10000;0
5383;bc1prjm9wqp7mjunw5k9mpx29rx4c5x6ae6mmqn9xuefacav9nw47qtsl9yww4;2149848;458;463416241;461266393
5384;bc1p7m3gmwf2mf5glvp7v5x4kn8x5rhh7lrvuyes02t39waxtpmnsxwq3wlpz6;10000;1;10000;0
5385;bc1p9lxaaxqa7cex7t60kykk3t3r3am8e7626v2nemay9pjc25t0schqrg8nzw;48450;4;1548450;1500000
5386;bc1pgvxc33l7yu546gp54gzx58jyrd87p3qpqfmyup2p50n4dw0lz3nsa2y5sn;1092;1;1092;0
5387;bc1pwv48tz9f4ua40c36g34kwqzc2kvv9s2fkepn3cr9swwcc44pykgs64qa7q;1010000;1;1010000;0
5388;bc1prucrnag7a90rv3kx20aw37dxm7xevdpn74mhvvl5u6lmsga9n2rq8jl9md;0;2;422335;422335
5389;bc1pfk0engk3ld434c9agxcxtn340vpkv7stegpxxwyulnsjk29vnjxsau4pd2;10000;1;10000;0
5390;bc1p9d2dlux2m6al6m6qezjts68sz88d0hmn4sgugf4u569r673m0j9sarzlhn;176389;217;366927;190538
5391;bc1ptxp3l9xz9jlldcml3shafvcgjvzyhhv2jnxgqwzc87ln4mkd90pq9e9ap3;1010000;1;1010000;0
5392;bc1prtcarfdh3kcal5utwh48fh7yglxy8rw8dk2nsspcvxmenvq574fqpdylaw;790000;1;790000;0
5393;bc1pl8wv23s6xftj45gs73nh7a5x7ev2hxh6fjrx9yyqju77ut2gstpqrzk3sm;5460;5;5460;0
5394;bc1pyrkstln5ypmsxn9xjlc7se273vqqa4uj3dnd7pkd2qee6kx07cds0azsut;2640;8;2640;0
5395;3MoFpZfk8iP4q58hB1KPtU6XsqPKMSjj5M;1004917;53;13334667;12329750
5396;bc1pggk9lckpafcd7g5xazsauvrqf2yp9k8ekfqrpt9lskmt90tkc27sp926k2;10000;1;10000;0
5397;bc1pjtrlra4hmndf0cu9qc9q54ecarqkpf3sc86798mwwuv7y8u67asqy8uqc3;0;2;224000;224000
5398;bc1ps7rd7v50fhkq6m765fpcv03xau7ys7448t79eg6vzgp8zrkghmzqu7j7p2;274388;1;274388;0
5399;bc1ptexetg2062l9s3ew0u0mrut0unyxjk72sx5sj7h04xgraa6v83uswj3uee;331;1;331;0
5400;bc1ppugsf4nnzd5smrf096rdardzauc3ep9k96w269sxx2tqu5j3m9rszjeh2z;10000;1;10000;0
5401;3AXb5Daqvm5VHjvXNidL9k4hFwGkZX3vHK;326123;5;2450815;2124692
5402;bc1pn97rnqhej7h8jsf5uglzh35xtw7rrkl5z6keczacl06mk9h2wwrsc2ptr3;0;2;176187;176187
5403;3HonpsGswSVUib3B2q3xN7DjhWGTfnW6bc;1977090;64;317175813;315198723
5404;bc1pws0xq4zvleqfkfj3ujav2fa59zyetnyaa2ahwkf5v3x8reje7k9s27zt6j;330;1;330;0
5405;bc1p5p8u2hc86hd4z85rzc22qyk75trql7uz6lyhm4h75dpcft3ac4ps6uqld7;3276;3;3276;0
5406;bc1p0lnt4y7kajq50pz5x8srlmlqduw5883l6dhe55q56lnxs9qpmwwss5j52t;10000;1;10000;0
5407;bc1p5ckxtrcn3r66g5sfqn6s0vfg87cj03klftgs222mxa9sfvfyx87s9xqzq7;608905;1;608905;0
5408;bc1pzz8glusndzj36ct4fjwg55tht09pge24lk4nfrnr85dqxgh4hn3qwcx6nt;232092;1;232092;0
5409;bc1px72rv5zskzrm3z3nzkmam20jrxe3gv70rttru5e55xxv7ggnz9dqntkl47;10000;1;10000;0
5410;bc1pv505ge9h6uta4qngem79scctqn6nudyadqlvuz344ypljye9qkxqmc2tz9;10000;1;10000;0
5411;bc1pg9dqfrgkq96tc9ecek2zu26sdl7m66myg6c6crn2lv4l375qnmssv29vx7;10000;1;10000;0
5412;bc1pmed5xxv2q3z4rgd2hx0ct6lmfh8hwdknck3xrvsupmvwnl9hpkgqrsa8fx;97152;19;98152;1000
5413;bc1p256a309dqhqhfnqe66ktvq6w03fx5d05yq6p2pda3xercqgq2d5qr0ccwz;3276;105;388337;385061
5414;bc1pxm0knuhuh8y70539x9ulc8h638zhlnj7rp9vv7wrvzy29j80q7ksurq4n4;2517;2;2517;0
5415;bc1q222lxkv9hztj0nvfes4wgjewzzrjctdn073qa3;1425701;3;2225701;800000
5416;bc1p9nfk4muy0refra8sw6g6zaygc3jmmphylmaelnvf2pkx4acqz0vqevd9md;3822;24;36018;32196
5417;3MXnvAc6eVabBEkSCDmTfyBynKW5FjDZ4V;2822642;956;2525406420;2522583778
5418;bc1pqc6mzwd3dnw3qc4q8g6jqgv8la0qs70gga4f0lmgyj3sd6wumdvqaa50w4;3150471;1;3150471;0
5419;bc1p8y3dd0wkttrpvm4dc0aaa6ths5fkgxmp7a8tcgy0ydv96n92uhtsq0rq0v;6830692;1;6830692;0
5420;bc1pgckglaj5z3f75jwdq43w54qrf52aw7508u2f4rn9wsuta6ee7t0svh2ufq;576555;1;576555;0
5421;bc1pe7ju6esj9v9a4mczju6gt2kujq0pm4q2kuy90j7rdhkshlggszdqqs2pc9;31774817;4973;2720836030;2689061213
5422;bc1pzzxsakptn0sa2d8leqk5efm9e83y4kuj38vz6tmql327u94e9nksvnym5n;330;1;330;0
5423;bc1pzufsl2chapq2rdkgjrtqnxwvuf6kw2ayd0rnrl4xlqy3f3kpt5kqcqehpu;330;1;330;0
5424;bc1pughvded9lhrwxl9zzdvk0rktf598k5rhn790c7kytruz8crdj7eqfz53nj;10000;1;10000;0
5425;bc1p3jeqs6hhpevk9kzyruev0cxthvgtra9gfjywqnkzkchkgk8wwqzs0wkzts;600;1;600;0
5426;bc1p0q0dugpsdgek83flj55s7anppw9ulwzpqdngld2s4g3jvjgd6lyq8sfdqc;244502;1;244502;0
5427;bc1pvkd8uz46k78yqcf83v6fk20h3xm8en2rywp52dpq0dajr7ldk7qszx0zvj;2408543;267;85987236;83578693
5428;bc1ph3lrnyp4lvveha4t3dx8xppq7z00xa94r3ucx0xff5472hrqyq5sza965a;59609;4;342952;283343
5429;bc1p8ex2u5gnpmd9gtxsek6jjul2a849c909r04tkndv9umt9m7723fqyq34c4;3789087;6;13389087;9600000
5430;bc1qnku4emgc5p3htvvgxpwp0xr7spfx2xu68cgw89;36776;3;536776;500000
5431;bc1pg3n3smpn82h6d6e9jfyyseceswha7fc0v9ztqqnej2urhxd73r7qe2a7tn;1149856;800;89995863;88846007
5432;bc1qa02r74lqf0jsr9sla5qwsvepejlyvtujjnl65s;10000;1;10000;0
5433;bc1pprms7aqva4ft533w47epttw53vrgk20hluy67kf5lmlh400lk6hs80wgcn;330;1;330;0
5434;bc1pr3dwc7uqvw6au8d3sjj36sp2ty2wqtk6sgzd5y02qmm7gkjtx4mq8ua8yc;0;2;200000;200000
5435;bc1qvs2hts5u0mk06ayecd3m85ps5w5emuxtlxeg9x;46044802;9578;104477150;58432348
5436;bc1papkhf80p3qufysfm2n4ygh3pmdt374reewkewenracv5uwwzhhzqh5g3gz;330;1;330;0
5437;bc1p69z47fp5sr332tex4mpyg5pg3h2c4060zvh9yamwycq4zu9earfq7fwna6;279600;1;279600;0
5438;1coin591buk9DHJp62FDtA7pEVWY2RdBe;185961;1;185961;0
5439;bc1q7jd477wc5s88hsvenr0ddtatsw282hfjzg59wz;8596103;26;104675281;96079178
5440;bc1psf3uw99ch2uwcdtyxv85pyrkkfzeyvae0gpnwf504wtn6myu9axsn52ymy;0;2;216000;216000
5441;bc1py7qncru6wqc7tvywdddfnlkvcjdgtpx3d3qg4g29qz542g8k4f5szegq3q;4256840;7;12866767;8609927
5442;bc1pp2ae89ql6e2ye2aafsvswff72hscxhl4leq8z3sx5ajryh8h49rqcrkphc;2184;2;2184;0
5443;bc1pwp322dpnajt5cnyy7hzvmxcjwsfu2ckprgh7y4hxwlm8f0eu8rrsum7303;3026000;1;3026000;0
5444;bc1ps04g5ytt7q2kyx95zcdr40dunmh94wrrhkynv7sny3nwtwuezedsl8sntq;330;1;330;0
5445;bc1pug0r9uuydm28s5kackscm4pjs57vnjc3c4e0kvwn23jxjg8rd0ysfuu4z8;5793;9;5793;0
5446;bc1p6hdyvvzktruw9td8ryfcfgsdus0a4kwz3xsv68pqrzn7q5a534dqgekljt;103219585;5921;3856872093;3753652508
5447;bc1p3c5wcs60jz34f00s2husquqqc0x6rcluccff52pxdtf9fmkwd6esmh0tvs;10000;1;10000;0
5448;bc1psupr9j008hw7w889krfg3fzeswn8rgvy38rr56k7dtqnspepawxskd688w;3916581;213;193489911;189573330
5449;bc1pr7kg9c0vsm3euceea3lnnugvnc9hx2hwyy4y630u2vg22wzsqtqqgqf4xs;475874;1237;1475738;999864
5450;bc1pver84d97lvtm87899nhpdutrxuunr2h8jacs7u6wutvxl4hl9rvssglwgv;546;1;546;0
5451;bc1pvpgalv6szxn4eyjh5xq2jfz8wejvdy03edrgdd3n6h0x4znsskaqxhq9e0;2554;2;2554;0
5452;bc1p8adlvg4tqagq9l9czx6c052fz806a2ldpz4aj3xry0shmf5wt00q9j93gc;10000;1;10000;0
5453;bc1p9srxdqx7u4u48ahj4s5gd3x5m932zm4fc4a4ds5ncm580nh864jqm37k26;117142165;7875;409576263;292434098
5454;bc1pmpt5n73gsfgy0c8nfhmja9df5nrzvn5tsyy5lvurastvp6emfrrqdmfefu;58470;18;58470;0
5455;bc1ptdnqmjdagd4hu4vel23ac2mtd5es30r64l0tw02y79qcjm6cawrs5lryz6;633447208;3573;8879582487;8246135279
5456;bc1pv7k5hslus4s4tq5p0xydya3m9r8dcqjyg3gsf9c4p57guazjjunshy90d5;10000;1;10000;0
5457;bc1plsym2hmrsngu60cm7g0u4vux68vhq2n3cenlefarspamznacgqlqdkvrnu;93051;102;311430;218379
5458;bc1qdqjxm0ta57sq8ajyly85n624npwehl4seucl7n;50597;20;50597;0
5459;bc1pgzzds4k53gk6kcgwlsy7m6kecm5qq79f22er0srcyxycakmcfqtq6ul22c;10000;1;10000;0
5460;bc1px0asug5t9sxcmv6gpqrh4t3pjjaxqfv4x0q7kkyr8fg4tll2yp2qnsr5wu;330;1;330;0
5461;bc1q6fmqp3ytm5nzqv00amknm63axjue2ueq3nj90k;59574301;11422;143199870;83625569
5462;bc1pympptmaqjydxys43he7690g2g0nm6pgxc9t4m9jhnvcx4vdkvdvqs7mnrd;0;2;181000;181000
5463;bc1pvueeq00qf9kmcm6qcth6y4dssem2nsep7pm90npdns0d2tmr498qlpqpey;19900166;517;20879206;979040
5464;bc1pp9n3rxmtgsupha384z9fyxu5ldqgp4xpuxux9u4phmy9kmnpwrwqrdd7gv;0;2;202000;202000
5465;bc1paau7pf7x0ufvwc45zwu27uhf2c3k86v7650cafctpdgfxzazrufswdxzcq;0;2;203000;203000
5466;bc1prf32z7enq59vzrdsmvejsmaa4yl903wl0l45cmpz0pgaxge8v2lqgvj9s6;3429314;1237;107204251;103774937
5467;bc1pt8rhn6dm6amwjr3tlyzllvy4gtr7uzdenwxa2q3mz54m2pzpevzqkcm58c;113949896;8070;413896268;299946372
5468;bc1pka0uae6rymqq5qnuqepcwhqhexcccz4y5fa4sl6aem6zjnrpp2sqc2yvdr;411200;1;411200;0
5469;bc1pdhnysypaqfkdmernenhf2yncjjvx8sskpj85j5a5wx48xyjdrmzszrc09m;10000;1;10000;0
5470;bc1p29x7w70v99lhrgdrumx6n7ghzfddq7s4ccdgc7ap7jvcdvnpl45q8k9wwp;10000;1;10000;0
5471;37j7xbUGyUcSPLz2GkwReYpSHkFkYd4z1W;2830083;8;26630768;23800685
5472;bc1p9zulwu8u95dmcmmnm3le4l0tnwj9ldktcva3k23xfd73eg7m4kcspy7uf3;2909052;211;327591235;324682183
5473;bc1pc6q7n3ay5z9xsns6z72ut9re2ak748ferktzj379lwc7upsvrd3s8uxtuk;330;1;330;0
5474;bc1pemwvuln9v0ce9lucawx8juuqlrkts934qj03dlvz0nxpu2xsve9s65r9wl;2517;2;2517;0
5475;bc1pq676syg9hklklldddxrc2rtcmm7canr2dw5qxd7anen8hfyhe2vq2pq49x;586705;1;586705;0
5476;bc1q7mwh2p5f28q4s9jx78yj5yw3580gr3ppk8w3hk;89246;16;89246;0
5477;bc1pdwprvxhkmx9qpxdga2yqnp59rgvy50lydt8c24nuaac5c2jtv5gqqm3xtf;0;2;329130;329130
5478;bc1parst906lqv4um8jwntq8w02cvz6lw5kupucastude28lsk3fmg0sh5h9wr;607605;1;607605;0
5479;bc1pzun4zl8nfvvfpazsffl663p5xq9ggrgk8a6vr8pdrr64wrjumkvqfqynqu;586705;1;586705;0
5480;bc1pqg682p9hhpf4z6pj7q8pcumf6jeeeetnj52wr4aruqk62x7vsafs6ugz8p;591305;1;591305;0
5481;3Ahywje2UTneUmNeZsTtFW4UX4QocxPHbM;1835624;10;34212192;32376568
5482;bc1pelut09jylwruy2m9vaudezxesa2kxemls2fp0qzr3cq0z3d0fjzqe4xka6;330;1;330;0
5483;bc1pynsprjzuhv7cah8nhdymt98qknaqk4h5jm66qd4urqfe3tgyue6sjqtvwh;264600;1;264600;0
5484;bc1pk8ppnx9mhstfpa70xfdrjxwtana4uzlg9htdlz0x53495r4y4f9slfzns6;14797869;369;594885174;580087305
5485;bc1p5ft03jv3g5svspu0v08g00qmswqn2yf4w7uul6y3ffeq604t2pqqf6g07h;10000;1;10000;0
5486;bc1ppdlahe7ukryyqqggadtg28uznktc4tk9crs5cspythdz34pw2mhqc8gm4r;20000;2;20000;0
5487;bc1pu4q05p95pzs9rw6ccvdfxzlstvduhgqz8l5kvy9py8v790mkuwasky7er5;2253495;527;845178908;842925413
5488;bc1pmavk6zwy2ugr3g8a9ext2fjl32lch495m5zx2jrfttmu8jdut6esq07kdu;121329;121;172829;51500
5489;bc1pymr2nrtmpz2lkatyw5za75ulx3vpdnayugaxjx2nuz20ef7gfznssyje72;9224760;219;9224760;0
5490;bc1pvfmz7pc0trjpzzp07cn2jjjpu3emh5u8ql68m0w0a8j4y5rc0v9sjkkvcs;581555;1;581555;0
5491;bc1p5m4qnwzfjsjrlgyrjaad3wt9jan3axjksvvrqyum38nceg7qflhqzdn45x;1417576;743;149431499;148013923
5492;bc1ppa0zaus2zyq9wcxgkelx8dya4z56a7hjf6kc7zstaext0ghl8jwsp7ey2z;259955;1;259955;0
5493;bc1putzwk7axcjsm4paj76gu5nwfvrvksypdrpvwmst5h59wa259n6tsrf7zyv;3730089;4103;756681851;752951762
5494;bc1pgyf5uehrenastxa94ggqqkz5fjt7jvt88splt7s49axcfsjlme7sf2kcek;204648;47;293642;88994
5495;bc1phjg763qnw908452qevcne2azsmd9xz034y8a7mw0elqu5l04x4tsn5tgvt;330;1;330;0
5496;bc1pj2rq9sqpzx4rj82f7ps7748dh8x4gqywmws2zr7wgmd8ad2mkzfsj54jj2;10000;1;10000;0
5497;bc1qk75dpmq924wv0upvmz0wy9pq9nlyjfudue0uje;87655;29;87655;0
5498;bc1pd68vj37yj3ptmvhzukf06wl77a2lnaykz6xn4dwg7q08mcrl2xwqau7ttg;2646;2;2646;0
5499;bc1qschfcda64ky4mr80fheptj50axekhyacak9kqn;47632924;9591;106800042;59167118
5500;bc1p4rf7c9tzxkpms6n7n4m9h3v0feapmlkzx5dhwva49ff8ytdgtdysn7kkmm;10000;1;10000;0
5501;bc1p379jxzdahw653shy4kywttya93h3vg79pvegmtnjsaw9ez0rhlqqrqwvdm;0;3;431092;431092
5502;bc1pwwhd0lafke3y9j4ezmwj7rj8s6et2gwwssl52jj4jt8vcdfa6j2qw4r9dt;10000;1;10000;0
5503;bc1qsscx7qhgf9gwksje0zltgyrw3ztvfl9x6zj6m2;49859289;9702;111106177;61246888
5504;bc1ppspuqv33jprvvpk67a40sf7tecpp8xhmdazvjtkkyhcg7j0h68msryfymx;6492826;312;114874155;108381329
5505;bc1qzejcr9ve69txthzcsmwr5t5wy4fk76uqa2vfh3;65458;20;65458;0
5506;bc1qwrtry4d3fatr44l4qxjvs6rh4j8ehumzg8cp0q;51934563;9418;116810786;64876223
5507;bc1p32nktsuffprllv0j93a2d3q33s0l6rlh598hynkgrt60lf6upqmqasw00d;155231558;8023;623252683;468021125
5508;bc1pxgx46ldw0k8rygj64pa3z9r47zr7tqgrr54zles66zleaxrn6wtqphdf5m;330;1;330;0
5509;bc1p5td78zz96taf0c2smy4d5yawu6ngzfp9470sdv0nhrrwgwpxphuqz8h6s4;81400;1;81400;0
5510;bc1pq6gxcqm7k47r9xae9ut7ndevr6kcxpn9appwjt4wznhf7j2g54ss44xacg;10000;1;10000;0
5511;bc1p5hwetdnp42c7qwv7vn90j56ajaf5vjdhchffmkj554s58wuunfsse2u2my;4368;4;4368;0
5512;bc1pavxvmpt7hg42a9aasm3yylszqderfu32mg66qfyaw73zkepxyutsdfyv69;10000;1;10000;0
5513;bc1p3vrjk0y3wpeq5s7efsxsl6qq97ss6z9x6reajed2l3cucc7vvchqlc5q5u;0;2;205000;205000
5514;bc1q959v4t7cyxsk22swx66snvrurug4wu3mvgygef;146930;27;146930;0
5515;bc1p5k780nvc358mar3d4ue99hpfczrx0rq2aqmgwehpm6h4q6u6efzstquled;684608;618;278333594;277648986
5516;bc1p29l2qhcxh4ckj3glwzcwcqctpppxe6a2y4gvurzwcenunlu75lsqvzsrjx;1323;2;1323;0
5517;bc1pe53w46lp8mj55a3j6vpu6fndemnfyag97yy8p2q6slnaurha74nqjr7jsq;3831678;34;22234185;18402507
5518;bc1pf56txtw5mmmtp87x4pzcrl846u846suuqa2fxk8ju6g40rp85u0q92um57;613307;367;35112118;34498811
5519;bc1puccff7yqcuwf573dwp8q4f5466d678xztm86ek4n927qnc6cfngqxs722c;0;5;1561020;1561020
5520;3PCm55RYy6bxbV3T612X4DkrkihvMsABqQ;1970677;3;7682173;5711496
5521;bc1pm7xceuykxzk47lgf9vlyajtvuhgxpk02jpuyk2lvjjjsgxqmj3uszcmue0;233092;1;233092;0
5522;bc1qdpvc29ak7lpezgm3hun658nhdg4wdxqwq4qjer;137970;247;58590611;58452641
5523;37GzyNvuwuvWm41h7F5Wg5DqA4L7wMF4Hn;214582637;926;10573212314;10358629677
5524;bc1pp0l9shrsxrwru5276nkct3klch42885t92chxrfu25e72rglygcqrtqrhc;1230546;3;2830546;1600000
5525;bc1pchyqqv06yn6lgs4wjq45z24wmlu82rz052h43uwzfm87ms9l87sqjfx75x;86414;9;6292747;6206333
5526;bc1p7y7cpj0t3c37qgu4v7awzql57lmvrztzfmdka8es7tqyek6s58ms5sa5n9;198864;180;12972470;12773606
5527;bc1pphvuk0scx6guy5aqcxgkecd4fv2l0luxt4624064a4gr8m8rvcgq2e5drx;990465;1;990465;0
5528;bc1pxuyckxhnpq7culp09ee268fu52tupck98cd7m2vr583t3284vlpq2gk9aa;352053;4;1589780;1237727
5529;bc1ps7kdzdldva0nx2tp5v07xypumtf68n5xayfhw2gqe54n9zqeee9q6syljv;731825;72;9286476;8554651
5530;bc1qhsxvaqfryfv9phktnqatv272vfpchpv4cz00sy;75018;24;75018;0
5531;bc1prlw5srdmjz2h5vrxfhj7azw6zu8wfdlgmk42fl64p4tr80l3jytscjgsu4;530303;14;10662029;10131726
5532;bc1ppgu70dg6t86xs8n2s5t98h937da8pmy9ft2lnwg5mn8dejllw37qffhyfk;7908768;210;7908768;0
5533;bc1pr3rvly5kreykuk5a37dlktuldk7s0t8v842ka6lpg9ayudhrw8mq5nv8rz;5908382;1;5908382;0
5534;bc1pmkjdzszl9zu7nrw2929ujefcslfx9sk6nz75uvt3f3tg29f2kxwqsud8vq;1327937;229;42722224;41394287
5535;bc1pnc7msj53xvn483e6w8qakakzjysv36njmu2p3c4vax94u7um4c2sf33vh8;0;2;194000;194000
5536;bc1pkwj6j4a3ug9up9zwnpc573a7e6ku6g0yn7mt0z46v33tdul5pdusy82wjh;330;1;330;0
5537;bc1pw9h94eac475snpuke2s2kmte9cgylkgs09wcpmgcrhn8mdqtpsqqhcxnea;10000;1;10000;0
5538;bc1ql8lwzc220yrps5nn8yhqthn2eh4grlgyhgxyw4;107536;26;107536;0
5539;3LETKsZ9xz7DmzozKF8ZunT4P2CtLmTT9n;3882202;4;9445140;5562938
5540;bc1pua5glan89rwtgkqnw9hgzdfr8q6vnthsgx0gk9maxtjnk8ckkyyqxpcahm;356;1;356;0
5541;bc1prhn9pgwu98u99vxfa4ldfjq5czngpy5pckd5pc373nwx3rtdaesswyrrpx;10000;1;10000;0
5542;bc1pdg33mva9y5uxwweky8ctkqwq05g5sqvvkqzwcgm3te49ja74xgaqqty5mh;10000;1;10000;0
5543;bc1pdnwnnsvxnxyqhscmfnns3t7cetwcvauummdsv7z8a30r24edj38qrc5r07;1092;1;1092;0
5544;bc1pd3c6c6purcyztxetfcuws8t7qnvnn2csqzyv64ydtrcue9asjg0qxk77gp;9856368;230;9856368;0
5545;bc1pw4khl6uuzf6hrxugn9vkgwn5uyu4e7jys4rhdm6gh02ywwt3d38q70gjhq;609905;1;609905;0
5546;bc1pdjlxt7v4572fqkrlzdsx986l6zjtvl9s7ymazc4cv3rpxgqz3wlqhc76uz;115280135;7900;412268629;296988494
5547;bc1p0c0sm6qnxnsx40u8mgqdr8p8yqx08p24qdx2qw03cch5dfmjf6qqd57aqh;2184;4;2184;0
5548;bc1pynumvvx7y2qcam5gtcpzrlkea6h05n79mqsrsptap5g4z7j6l9tstvuy66;546;1;546;0
5549;bc1pnlc0yhvtqnntatruk8wkcmnkhl2csgv4yuv02pp0ng2ehrqec6as86fpqp;19875514;30012;12593711137;12573835623
5550;bc1q7wt0ptzxw3z2c5uxgsc0umze7zcwjltsvutefc;108141;28;108141;0
5551;bc1pp5dtmu5ddgr00s6jc3w63aheyes6v26ke902fya4l3c3y8qfydqsv36uwm;583005;1;583005;0
5552;bc1psyv55jdc5ngeerxfvhlm9tzq2fu6ft9z7khv9p8806yh6s4j8w9susmcrf;20000;2;20000;0
5553;bc1puxnywcxmkzvqgmv8grefrng60k0nttfal40nt89jm9n9vx2rxstqdhtqr7;10000;1;10000;0
5554;bc1p0lhenahy6tn6cuv94cr292v584cqff6yf303xcyepnctssy4suesny8gg9;7338;40;3399354;3392016
5555;bc1qg8yrkq78wfw4edzhsgz527l42njwmrp03sfw5l;41193;3;216336;175143
5556;bc1p6ynvhf363etjwhewuqdn8gw30x47gtwmxylh3rp0sxp6dcvudugshufhwf;607755;1;607755;0
5557;bc1q50agktjyyrssw78clct7pme2h23w2lfw2lsq8a;166719;1;166719;0
5558;bc1pnm9m9960yhzd33l6dmjla39dnm8m7wzzgjnpwu8ex7l2l5t6ntnq0kz2np;8295699;29;56437173;48141474
5559;bc1qcx9zmphmeuph9f5fjx6nvd9s24hjwmmt74huld;104983;25;104983;0
5560;33yX5QayW8ap4eZVByf2cCG6qLjK7aird4;358472;13;12720410;12361938
5561;bc1pfns054558k0em4e0g2xlzs7sx258lya0s9e86pxsutnn72megclqpts3vs;10000;1;10000;0
5562;bc1pysg8zaf6zamanwvh2e6gk9sug0ymwprde94thhzkac9nvlr2w95qq72nyk;1202042;32;19344380;18142338
5563;bc1pyfh40nvh0hkv6s9gxrl7lj96a4y7h6pdxuhh7n3u5fx5kqjxgl2qzakn86;9610950;7;39228564;29617614
5564;bc1p3xtgrdtfcegjtqgnv33uzgshwgre0egzvp4p7d0ffzq6hmfp5xcqd4fuyq;0;2;177000;177000
5565;bc1phrsygxpdd93jjuqgvcrudtux4ey0l20kqa7ulkanh3wp4c9unn9szcr3ay;1618249;157;45118452;43500203
5566;bc1p65mmjqed4rp42xmdzgwzj42s8g0w5kl52v5t0grkzhv0mn7s2pwsjqd7vw;1802;14;4704705;4702903
5567;bc1prwns6jr3evn46yavnr5nfkmxh9s2ctzhu8n68hf3xq7sdgmtkqzqpegu6j;10000;1;10000;0
5568;bc1p9d7mxl2dlnznqkaf2qfa6ng8l650xkrjache5hs89uu7v8a8uhfqfjecd9;1237958;2247;1988959;751001
5569;bc1pwyrvp3uzqpj95t6hfdftycy6a0dru777dygsukprhkf7ufzrwfaqfrvzx9;10000;1;10000;0
5570;bc1pk8p29pm44uplt74sv9q2ks2d0ygtq67ewwpjdtemkuhsz8w594ssjtlrfh;257000;1;257000;0
5571;bc1ph4ncp564rsqm7jlldqg2gfp576cs74cgcngg8av6xn27q5a78fnqpusr2v;9884737;8;19885283;10000546
5572;bc1p6y8qh6j4r2qzlfww5ev7utcqd7v5mlclmhu68vsyr0ue6e3ch2hs7jdmyf;2596218;535;122375895;119779677
5573;bc1p0vpz8r4pyxa7fz2r0pjdfjnf85rvket5tp6h0lsn780dsmedwyuslltvzd;15878;57;28527007;28511129
5574;bc1plmkwj3swchp55wye0q4kthhf8qut20kwg655en8s34y0uw9mpckqfd3pvk;10000;1;10000;0
5575;bc1pctx4d8up4wqkrvgn0hk4ddu2x5pttfyhyzr4k07rceet9ac5cmqsu7j7gm;10000;1;10000;0
5576;bc1p4t9zzde343j6jgntheyf4pfze6ycd2gvdtfmn6mg6w56ktvrtdwqjhgvdv;10000;1;10000;0
5577;bc1pwjna8h2epv73aa4atmqfztm9mj25f957vdemprn7ezukygwcrz3sm5xk49;10377968;286;10377968;0
5578;bc1ppjj5p3hc835ughmjcr099xt7ecxjjnskyxluuf9lc5quqmt7pwjq7mxc04;0;2;82019;82019
5579;3CNxVQYTbcUTSHhUj4Jgr1VjgUgAgDNxoR;2715882;8;8885425;6169543
5580;bc1qqz3pt39s0xd5eh8cpltk9xaw4k56nv2jqjgrnn;25676;5;7048114;7022438
5581;bc1p5thl80kpa9kssdsupjte2tj2cqdl57nh5mzra8rt9f232vap2tysmh6fpd;119960;24;119960;0
5582;bc1pp5xre84rz69aztmyy65m3g6el6sg5ae00s34cvd6r7vgyt44vxpqhfqtvu;10000;1;10000;0
5583;bc1p463604ynvr3u57jza605a8dhghhxkdnlcmk47k9l2njmrt9w6whsllwfgp;160567;1;160567;0
5584;bc1pf5mlysmfl5m554lazqw84sv949ntlw2ghpdrs0y4m5gyl22nlhhqq6wthj;554750;5;2264158;1709408
5585;bc1p0c7hymex90rhhhx6up298gktz9wqg8s3mucvkfsr677tcz2vprpq6gm4np;168092;1;168092;0
5586;bc1qp9l0ecu7s9dkv7tlkq8v3py3jxr62rfqfx0lud;181499;25;181499;0
5587;bc1pvtyrf040eejylk0x57hyqdkkura0trg0cuj3jvvyzajyuhc6smksldlmqe;10000;1;10000;0
5588;bc1p6w9uz4jsek9yf4nnuh6pd22h6f5tur9a4rgmr3sft0f9klwtrycs0t28yt;841065;3;1341065;500000
5589;bc1pv76hfc8h0zydtx90y8lzc43tdn6xdgsafvutyvdahkrvpggy9ccsz8dje3;415877;135;34868537;34452660
5590;bc1pzhaac2k7esuvwh5yu3dm3c7cglngptjmdcr99jjl39clz68r2hssz5fy5f;10000;1;10000;0
5591;bc1plk7tmyuzsn7zj0gjwh2zuc90njnrq3y4gxualfglg7lyzh03xges423hja;169000;1;169000;0
5592;bc1qpfucdgqef63y4q9eyqed424nmwkr3nqs3pya8n;26579964;13;146144111;119564147
5593;3H2NV7i6XboBG6sYwPnCaBFtFHbypk6v3p;5671291;41;65911936;60240645
5594;bc1quh9jm6p06nqnvgvvv733pl0g0y6ycxl0aas2t4;8595579;7546;695630627;687035048
5595;bc1p2fyfctf54ef62k6697g8yc6q4tk6xe8jj4duzjj5a7d5prllk6hq39upe8;7612047;278;16684589;9072542
5596;bc1qrw7zf9tvxffp7xsx4wm84wtptqts0adad0qhf2;278917;2;657834;378917
5597;bc1pgdjwv4qxkz0mk2cwva22kc3vc46s3gaaueqtue0nqwh70v7pcy7sp49pek;161200;1;161200;0
5598;bc1p9yz702wterl63psqz77a6s34yna524ss0n3hj5mr6fgtfg787qfq2em7g7;152545;1;152545;0
5599;bc1py7kngd02vejp8t8xsnx757rc4qumzcg2v6tftqnjmln3clhp9cxqzlcg6a;4741318;1;4741318;0
5600;bc1pr4d86gflrf5qdy0xuck7r3p5969xjnzjux5qgwydr525uva5dwkqlgcrzl;390645958;7854;1026312733;635666775
5601;bc1pjmxsc5vmj9xagkxrr2xuc5hy52fu3mqa42k87ctjzzqhwz8y7ukqr3lwnd;33000;3;145000;112000
5602;bc1pkcqwd2lx6grty4wy49hsfnu9mkztquq37v7rnwp0jqx9jfckjpssg3gleh;139842;1;139842;0
5603;bc1qvs2hts5u0mk06ayecd3m85ps5w5emuxtlxeg9x;46055947;9580;104488295;58432348
5604;bc1p8al77jah6fngz2zvxp96l4ew4njadn0jlktjgvc4mxr9c6mrau0sva85f5;420;1;420;0
5605;bc1pph2a3u00vekjds2wwf3mwmvy9tf6kmjgnaup50vcuk5aw0rfeetqcu7ey3;331190;1;331190;0
5606;bc1pk3cmcxrvz8hrzf899f85n2yekhr75z5x9dwqu6hrggdsng24nlzsew6djj;6188823;17;13154915;6966092
5607;bc1pmg2pfvrs0tt6kjm0sd8rw6d9a3swjlx4va9thcq8zw6hatv4zm6qethrjv;7383792;3431;515379807;507996015
5608;bc1qnxzxkrhkehhuetppap6xka6jznmy5vx4ckd52h;161510;27;161510;0
5609;bc1p7j3esnuy3w8dnl06x9w5pk7723fnjxxfa3sen28k4djlx5l4njjs5a2rna;10000;1;10000;0
5610;bc1ph60srsezq2ac5m5kt9p3zccds9g2mj9th570pln6cqgn7l5ep40spdnxya;6064645;41;20546532;14481887
5611;33Ph3t9tBuZvpdz8WVNaNLze2y4qUr1QN5;2384200;18;28732650;26348450
5612;bc1pmjancgdx7xls9gy3675tjqjtc9pfxq0673452u02rm45zazyx4hqw2eweh;10000;1;10000;0
5613;bc1phggxftjc3a4nr67jmty4fjd8rm3pwylqc46sdaewuw0dc6080g6qpnplnc;5678318;9;40173094;34494776
5614;bc1pn8g9uqqt7rn60nyj5ztqw37tdhf783f5ey7yqvj0uj6a03hpeqqs9c2g98;546;1;546;0
5615;bc1pvvnzq6y9fupjd42qq6l7rv82xymemy40s2fqaxe6jddl9mn83z9qvfnzry;160567;1;160567;0
5616;bc1pynhskqqrslzgd4xdye7e0d9z8rr7xtzlulyu6zz5fe9puqpu8dmq8g236t;16000;7;16000;0
5617;bc1prjyadgwmwnxsysjjwm567rw7t26rtg7z0psk3zj49466rejppyuqp5ectf;289129;59;3251297;2962168
5618;bc1pwpw0wfgddsjk694t2sj0qsh7weezmruucaq5dgzw7sgv7lj7hplsq53us8;0;2;56835546;56835546
5619;bc1pvwxrz9j25wgywfgy4tx9g7v8cs377q4gjrtmu3u9t025wep3jsjqulsd9g;10000;1;10000;0
5620;bc1pyvtdh2gyj4hp4jrxewl0uqsya0ple5r63kstmv9fmvv3gu3s05csa7kr9w;10000;1;10000;0
5621;bc1p6hdyvvzktruw9td8ryfcfgsdus0a4kwz3xsv68pqrzn7q5a534dqgekljt;103219585;5921;3856872093;3753652508
5622;bc1pas4y858fuh8sxuzagn8vejxhdn4qxf6sfcme6vzy38xjrqd3pp4sjvxxsd;13650;7;14196;546
5623;bc1pkuqdjsev9p0hyv9egtr9rsazvn7htc5ttpaqfxn6sqfjwfj7e6ys49mdf0;0;2;101546;101546
5624;bc1p6s0z65885nvcq7qk5kmxuu82nsezedr73q5xcd9ngy4p07qwk3hqqsgfj3;0;2;103981;103981
5625;bc1qffgs99m7g6zfp9gcq8c3kzzsmj8w76ug2l0pr4;778614;1343;188031043;187252429
5626;bc1pa82xeggdpuqxlpqq60fvh0sjent3p8ngqxe0eusee2xytx0mkjhq4z5ftq;0;5;930984;930984
5627;bc1pprjx82tp8tpf536rqz26kf0w05u3dqj3ae7v3w43ag8yxdngdxqqvtf8h7;9741318;1;9741318;0
5628;bc1pp9gexgcu8g3e3n74lfpaegfz6vd6m5cacpnyjpw8v200w8m3z4ssccantn;546;1;546;0
5629;bc1pk29yqth7fcu9mgavvmzpp80wryrh406nqglglpxxzuvskrwp9qhsr0nzqm;10000;1;10000;0
5630;bc1p9srxdqx7u4u48ahj4s5gd3x5m932zm4fc4a4ds5ncm580nh864jqm37k26;117423721;7880;409857819;292434098
5631;bc1p0s4f8grqyp83xnlymnpm7dph5a5q3l9d0x4tuq9t68u35gzm6l3sm692mr;0;2;302991;302991
5632;bc1pg38flaf9cplvs7ymdkr77qmcn34jrc7ae0hkjwg0sp740vex552s5n5e08;10000;1;10000;0
5633;bc1ptywqrhfdpne0hrjyr0urxstaqj0p06hmpprqgvwf42hj35lmph0snzukvd;474643;1;474643;0
5634;bc1pe5uxx70dkkf8yt0vrxwj5dzr8yjdersa2sdlpexqk0rhgm0wlvdqkjq6fp;10000;1;10000;0
5635;bc1pj20y0u6dxceghhc55aywstke4pe2mftqrwlmj6j5a890ndacre3q8smhq8;9741951;1;9741951;0
5636;bc1p89dwu40psdy2h6vmxg5w98xh28n4w6cqj2kxnws37kyjcceskgjqv0ncxc;0;2;65046;65046
5637;bc1pnvhv9hulzravrc6eal835r0gdxynazj00mlp3vr6af2hh77f7q3s9h40sn;0;5;853584;853584
5638;bc1q6fmqp3ytm5nzqv00amknm63axjue2ueq3nj90k;59581799;11424;143207368;83625569
5639;bc1p7enr4ysjn3zx5psq3jth8xe3u5prwt74u7eehexj4h9j2eex380sec2lfw;10000;1;10000;0
5640;bc1pjcf8v9ejvujsejjh9maj6q7kqgnrrrxn5z8md0phy4fsyg7cez2qd2x5kp;1246744;1885;502768506;501521762
5641;bc1pnc9lhm6z0j2y6wym69qv2xs53d66huqnq49ymq83qa0qtgps4a7sk9r0yc;1092;1;1092;0
5642;bc1pwt283aah9xkxhfm82n7rarsk86hp5tp9n9r5tw74k4ghaneh9dws74zue3;10000;1;10000;0
5643;bc1pt8rhn6dm6amwjr3tlyzllvy4gtr7uzdenwxa2q3mz54m2pzpevzqkcm58c;113916671;8069;413863043;299946372
5644;bc1p4adr5svkn574uzaf7pzvcffh3sjv4c9k3exe48qz38k0yxsrls9syp74tn;149221;4;1520999;1371778
5645;bc1p4hykwkap9vur6tvwlepv4cdgmm9lghu7n8tyjk9lcer53gaxd3wqvxehnx;31638;11;33062;1424
5646;bc1pe3nqygzuvp8dym63ndgsw8hts0esuw59k5l926ge4yshg0esm6kq602as5;8459813;265;539023544;530563731
5647;bc1p4y78e4scdww2qmu3jasvxgdmez889yftx4efx8a3dqh9eyfysh6q4u6950;237177;3;1055154;817977
5648;1JacekLovesLauren4ever1oo823WXyxvC;1000;1;1000;0
5649;bc1pkukfzdz8605er8j322m6wvhdm4c43ny55k32h8vl8ulwswugj96q8kdruh;45695;2;360695;315000
5650;bc1pwp5v7ashhwyhzjw0mauyxxhn3z2dp09zazqk48taqw8jvncsac2sgd4dhr;48589;16;2506844;2458255
5651;bc1pvlu57eh0fs7hax4hjdzlck2ftqk62zz6m7eructmv9eevlla54use07lns;330;1;330;0
5652;bc1ptqk6y5jpp6kz48t5unfr294exzh58geny9dp5prmyux3jygdawxqpag0gr;1092;1;1092;0
5653;bc1qlyx60yreq75skq8mzapamns50dt56zqzkruq2h;205096;1;205096;0
5654;bc1qhq89qmwdfjkcksphyf6t9qlz90wf8nr0u3v4md;5047182;2078;743898609;738851427
5655;bc1prfkvyjkgkaltrgsxeufxgc0qlshnhxcy74esltmkuvhe26jfn23swq6uag;0;2;15000;15000
5656;bc1pr27guvgj053a8zz405dty0efw52fl737fmdyz0n7rjzquhm7v02segfdhd;3276;4;3276;0
5657;3BSZjeNFTWjBHUMfqLf5VzDS6uAXmXY2ep;1520284;71;98746500;97226216
5658;bc1p5yal007xtvmsmgvhdvemvf5qfyzwrkz98ss4n6glmv4xc3l94ncsrrc7ad;0;2;117651;117651
5659;bc1ppuxdxpvw0nrskev4sv6ankca8nwl3kf626xe0rd9grv0ujffux3s3gyw05;5042266;1142;789884801;784842535
5660;bc1pdsyj5w75v8d4anl9yve9krmgvqnphe2kynasalczvldqykqpq3rsu0tgt9;0;6;161979;161979
5661;bc1p8vp2n9w83t5mmw2uzc527znucnc3d8jytfh5y8xgyxk80wnf6jqqwtutc0;330;1;330;0
5662;bc1pu5wahsymmwe7t509w2t5fchvdpe5k0mlu5yyh0weg82z3jqtyw5qlvd57n;1092;1;1092;0
5663;bc1p20snydkw3uq80722ys7ruxw3aapayekwnsu8sx2kv7syu8xjh0vss939fn;10000;1;10000;0
5664;bc1pmfgg8qqpd63x96s328ewgre279xtpsrfqu2hh8rh0vwx9v362t5s6skphz;1812508;27;26604457;24791949
5665;3CKjGH23Ap4j7Yt43DTNg93tijn9aGZN8R;52178875;643;2262231893;2210053018
5666;bc1pmm8yfgj46xkqgcl60eee0u6kfvdp4huy8nlmva4wz7w7tpqw8kpqcvkxtr;0;5;930984;930984
5667;bc1phg0x2pxr5uq788a4p4k7zetufmnqu4ahpksqhrzt5tapqycyx2ksuufq9q;1448461;3;3126166;1677705
5668;bc1pdhpmdpks3dwnkx96tmw9r42982ks6aqsp60f5lh4vjwtqk4l5x9s9g57m7;1422;2;1422;0
5669;bc1qlfn4dm78atcnhfn6texzg4pqll4tng6ttugzty;2629784;4485;694561690;691931906
5670;bc1qschfcda64ky4mr80fheptj50axekhyacak9kqn;47638198;9593;106805316;59167118
5671;bc1p6xgh4tu7fyup33gxjvu29dmgegnlr4ugyxru6hf55mvetmufl0sqf3g4g2;330;1;330;0
5672;bc1pzchawyrejx7vkn9p8g9jzew3r9atmq03vn9dpahshfjvqr0h86ss8gwm0l;10000;1;10000;0
5673;bc1qsscx7qhgf9gwksje0zltgyrw3ztvfl9x6zj6m2;49864246;9703;111111134;61246888
5674;bc1qwrtry4d3fatr44l4qxjvs6rh4j8ehumzg8cp0q;51946431;9421;116822654;64876223
5675;bc1pr43kge8qsdp90pylptn9ml4cyqpwpsezal4u8zfsyt0wddd2g4csf37nrg;9741951;1;9741951;0
5676;bc1pskxjup78ed857kk6w3lxj7nuqtxj9c54ge0763t54sraqegyuhvqha9aml;66161;1;66161;0
5677;bc1pj24922up6jlv6zmh4hxtnnkum8zh0lla6wwvhcd3a0rhru2h8yxsand25e;725000;1;725000;0
5678;31zN31ccmpArTGY3NFR5jtjnL3gRkbx8kD;925152;43;13956924;13031772
5679;bc1pcnmr42qyj3q2uan65n24t9x9rrg0jhsglra8ypjdqjdxg82dnrpsyly97m;765744;5;58453488;57687744
5680;bc1pdsj0jurlwckjhw3uf9vpr6mmcjclne70ezpmmnz7c2myvye5hm5sz4f50j;10000;1;10000;0
5681;bc1pdvqapy580gss4kfdezu9zqlzdymxenjmw7wa8trsx6gx99ga4weswjzlsz;755107;9;27153453;26398346
5682;bc1p9nvy75tuh7f0k42ew4a3g5ucz72kdcpcp5kfpkemw9x8lncrzkyqmx4dtc;1092;1;1092;0
5683;bc1ps99c4pmn3kjngzsdrz5vj2zkj3wry0dp6vys3clqhutwv4aprrts9q07fa;1464275;304;106280483;104816208
5684;bc1pus7q460ssz8s0v6w3g9pdp9km0h2nspyavu04qzmxun72wjqcesq8ck93t;144430;1;144430;0
5685;bc1puh02aer5jh6c8etxugymy5q6pksl2l89zxp0xetsfflkv2gvxczq5srjj4;710826;166;968596;257770
5686;bc1p6q6mqyjl0euue80dqted8z4c63pvxffv8nmuuma0zxrgj8d8lecq944yxt;546;1;546;0
5687;bc1p4vccvvnpq7a9mdxphndksjdc8f4mlu397mzpmj78qtallz6fl6fq5x9gth;312550;1;312550;0
5688;bc1ptuek2z03kvz0anmq4cku9rn3ws07lv0gncmxcdqshr7r2yad87hqdm5tta;161200;1;161200;0
5689;1PjGZv29D1akgBG1dLS98X11XCMM8hLApp;185000;5;870000;685000
5690;bc1pr4jgwnh8zqh27quckpxgt524hg9hrgxujk8mx7rcrpj5d4l09xlquq8ded;0;2;123046;123046
5691;bc1pm0muggcw2gcqpj283v7s0gr2gsfff7y8ls2524dwgxsa7ljxaf5q428028;2730;5;2730;0
5692;bc1pwwv3uugfm6pur98604kw3y0z0t2qwdkyz0rnsknyy9p2wjgmjlnsxhkmfq;1975610;7;5243639;3268029
5693;bc1p024jy6q6qjjx57qnqcj5fnned9h0yg8s4yjn4v6s75nqqse9sndqcm9hmv;546;1;546;0
5694;bc1pcqms2fr4ytkjda0svyrn56h0glpzq64mflerae9ku38rjluxusxqa954sh;9684400;292;9684400;0
5695;bc1pt4u0hhfvqr8mhvn29vplnuqdat5t534hjvh6rpgey5fvqx6kcvzs4eee7a;330;1;330;0
5696;bc1p5pt6fxqpx4a6h6smmksw38symmgas7m4y63res6jcqjjl777d36stzrqx6;4368;134;496184;491816
5697;bc1p37mk2k0d3dxyraru6d6r2udt0f22mk8whlvjc5u4lv64lwn25vssz3dwka;749709;7;10886745;10137036
5698;bc1pn9exvrz4kw7jdr6vtqehwt3pktgfqyqyfdxwy6jcc95rh7tfvrys2026e5;229073;12;4095084;3866011
5699;bc1pl35wn7k578zg55exz799m6v6pnu563wg34t7yg7jsnmxpmvw5fdscdsmvu;10964696;269;10964696;0
5700;bc1peefevjfq4cnxp6wnxl55n84jcwwl7468vnqc52dqaul2pyednuuqhunqq0;40215;25;741761;701546
5701;bc1pwkx0cq2v9r5rfy6k5rffn2t0wjs6lc0cyyhguqprvrnl7vex4p8qvwumk2;330;1;330;0
5702;bc1pavplwrccyarxecw56lhfsdafwa4x0rw96qqc844ec97wskq8jlwq8y8xy2;786500;3;1787046;1000546
5703;bc1pzwdmej5za9ftnhdew6fvqspm9kt9p8ck3jfdzmu6lc22vaqs63ps9gx3v2;169465;1;169465;0
5704;bc1p6wa9ef6jmwx2mppdu87ldrp9xv63e6q9k2y6v82265hyl6sdfs0qzlrktd;9954608;274;9954608;0
5705;3BKgJ4Jrqqc1mrMWvnbqnGhdE9pf7zvubQ;719074;33;10700685;9981611
5706;bc1pd3c6c6purcyztxetfcuws8t7qnvnn2csqzyv64ydtrcue9asjg0qxk77gp;12044456;282;12044456;0
5707;bc1p225zyk03jr660v7j5ntet0438tnyw2puzelwnnsmuwvhwmn8w8assk3y6k;2042680;922;117075538;115032858
5708;bc1p2sknjuhq3mhaalrvrg02kyedx3fj6ykz6l09y20lvrcekckqn3eqrmd87z;2747697;3;3747697;1000000
5709;bc1pm7u33f6ut05a233ds3v5lj7fql3z4fag7tjpnf7kp8m7h0nk26fsld4s28;0;2;97145;97145
5710;bc1pdjlxt7v4572fqkrlzdsx986l6zjtvl9s7ymazc4cv3rpxgqz3wlqhc76uz;115349395;7902;412337889;296988494
5711;bc1ppjvt6fw0vumjpcnwgrhg69f2mmhwte0tqm2zv5xyzn03fc8akr9s4qydw5;0;2;163000;163000
5712;bc1pjm0l7sslxa4ug24yph46due67eng5g4udxlquq0wrx0mqu3qp96q2sqxt6;10000;1;10000;0
5713;bc1qvpeyh6xz7l8quevdqlz7g9t9c0wj9vt9kkkavh;111776;29;111776;0
5714;bc1pfzzdztvqpn0wk9feen74z53z5fwz24h70l2hm3364lddu64wvd6qmt9grq;9632663;7;25829483;16196820
5715;bc1pgqh5nmhfuartz5qhrvh07tf48uk0hmp8dfmejsl85rmfaurpf7wqh975yj;12121;1;12121;0
5716;bc1qhyvcyrlcypvlsep0p6pw58c2jrndh2tq2faafx;5154;1;5154;0
5717;bc1p5sf9qa4d9zjd62nym40zqahrs8alwjysdau3zfu9rvnv4mynd8asqxcnag;64628;32;85675;21047
5718;bc1qjtk65sm53mxmhv8dz74sw25jg7csh68cmqp3q2;26490;177;877197877;877171387
5719;bc1pp280ts6a5qzua7c2446sg6sskkryysy0qhhv7a0ff5jduq6h67aqgvptdt;1076876;612;1280674;203798
5720;bc1pgwf7r7kcd3umvggty6xpmmmzjxkwz4ejua8df5gm7720wlp0yafs0ngtl3;196119;1;196119;0
5721;bc1p8zc9d5lyara69n52srpr7950yx7zt3aeyfg4gjldstrmlfm40ccq57nh0l;1092;5;2425;1333
5722;bc1p5rp8exc96d3at0r3875paperk7pmvhde9fmd5k2k369rws6ls4psyznanz;55790;83;62158;6368
5723;bc1pkmt5gth9hjtm7vy20d6u0uq6xxp2pn55vrl40r208rkxts4pl4pq4lfpfg;0;2;707000;707000
5724;3Mw2YpdfNGNM5X3F8UacPS4qBX6ssAmi8F;654932;3;654932;0
5725;bc1qjky79n6cqgs9gsfgw9srxj2j4tqlf47s5dl69c;2158835;3;3957835;1799000
5726;bc1q78df2x8cpmwyje5fr8j4dfllqheh88dl4yj5k9;250000;1;250000;0
5727;3NT79PaxfFsry4WVWopMKrjNaG6GVSqomj;447361;10;1423985;976624
5728;3HC5uiXQPP8Ug23m66rn5keQ7go8V4s4aE;3536191;25;17831645;14295454
5729;3PRNrsqE79J24bpdbWc8g3x52BEsWmDvKV;5380374;3;12876982;7496608
5730;bc1pfnekm5345gzmlfvmv0ckt85scv9wenfrhl40ynev4gd3nh3d2qus7wrehh;119785;1;119785;0
5731;381KrtiMLDpZHP63DzAD7dz4fTouSm8kHx;6286476;6;15163056;8876580
5732;bc1pzfgrpsst6c52jjljf0qjvzd56aurk5m8n3xdvxqjw4sz8fgsd2eqdk2jjv;0;2;69000;69000
5733;bc1pyfh40nvh0hkv6s9gxrl7lj96a4y7h6pdxuhh7n3u5fx5kqjxgl2qzakn86;9610950;7;39228564;29617614
5734;bc1pn0ywkm4qae9gmv4069g4x7jyu9fpk93myjhfc5f9k89gycu88utqqcja6a;546;1;546;0
5735;bc1qww8v7cea7h5kkqftjmycsyung7vpmpeszgjquh;422000;3;710000;288000
5736;bc1pjfwprqgr429xy0jgzm36wuz3m3z4jy0k9rgw3yhthva70sulgccsa0rkh4;15953456;296;15953456;0
5737;bc1px22dvfpzeanea64aezjhrzqm6t3c63ra9df70kpk365yx5rq5fwscqmmwk;2000;2;2000;0
5738;bc1p54cfrfxe9uczz8y4y5lttyxcfz5hu7uu0lw4wswr2y8zpt5fxtrs568gvn;3000000;2;6163333;3163333
5739;bc1pujvh0vufh2e0x86rcxxhu3de0s6kdn7q645rz37xz0r9ygcn79tstjre2r;1292020;23;18347445;17055425
5740;bc1quhruqrghgcca950rvhtrg7cpd7u8k6svpzgzmrjy8xyukacl5lkq0r8l2d;264495169483;130482;349684820164199;349420324994716
5741;bc1ph4ncp564rsqm7jlldqg2gfp576cs74cgcngg8av6xn27q5a78fnqpusr2v;9884737;8;19885283;10000546
5742;bc1qtxu6zftt26ekx6ww3ycc2j2e698ym3f2xvxfv8;3022595;1;3022595;0
5743;bc1pehkdynp9g2m5khed2cxsjpfch2s9553pdtp9yulfsc4ph0mxenqsqqwhmc;1092;1;1092;0
5744;bc1pt54462444xnwvw80utv3twndccjwk5ajr98s7llst5xgv9xa092qj6q09e;330;1;330;0
5745;bc1pvxv42v2836uxfvvgdtrn6cuuglz7hu6yvxe7mh3l6ym4hry3rcpsxqaq3k;1092;1;1092;0
5746;bc1pwrjhyk5m4vmmc25p438jjknqh0lnq62kzv3c63w0xku2ngjlgg8q6g26dz;1079000;1;1079000;0
5747;bc1pprkw99f6f2a7h7zsdwawn9paj3cxp2nw5mpu52307ldj0jl00fasuuyzlx;5254537;6;22068476;16813939
5748;bc1pscj2dnvyg3l662huvgw7wq7v6p4qzx0cj7m00xqe6pux2wkuxnzsh2000p;1426995;319;1647476;220481
5749;bc1prhmh86u9g7degwka7pem94slmpflkg80sat5n7a9h4kze7xq62zqpcmcz6;0;2;76000;76000
5750;bc1q630zwq6krs3ywdgee2f9zuyjyfzjeffyj3an3y;2040145;13;2201330;161185
5751;bc1p9ej5xw6p00hketkdyqmpxm29yhu3peqsvkfnwh05pyh34z8h4uss3lvgpj;19969000;1;19969000;0
5752;3B4jpCFhsFBSdSwXLvFRNF38LZgPQef4wA;4369339;333;1447190954;1442821615
5753;bc1pzqlssqp9a9g8w6xy5h4cvl64hjw073prs429h38qdncefjmeuxlsxgs3kc;10000;1;10000;0
5754;bc1ppwz3zqa0wwwm8gt0dyvr9dxn695mqhvhp588uy2dt4uttzmdw3nswyr75q;600;1;600;0
5755;bc1puf2zfzp3g69hh94gu9mr7f7wzn5tm5yu7lkqafk08cmyknp6mw6sgtx0tw;624882;6;774882;150000
5756;bc1p6remfgl8sjrragsc4f98733jz4k2c4f6fl34px00d09ukw4xpcusd527sx;10000;1;10000;0
5757;bc1pvtufmlqhxxkyczpf2xtjnn45vu3wdf3v0um6zxm5j7affcjlfk3spjsmpm;170435;1;170435;0
5758;bc1pyw0mgxewpsnyhnwxac8efkzl28rcgm4w2aufyyj2hy9a7gemz2xsrlry7m;0;4;362838;362838
5759;bc1qlfxlqhnneguc97rdcwlt66u8uh0ft4andnkakt;10000000;1;10000000;0
5760;bc1qykl9pdftzf8qh55ear7hdyqyppasjr8kl703e7;25143630;104;2746755066;2721611436
5761;bc1pd59pz0hzw9xqxgerx9sa2s8uruc4zwx2kjz9qjcnt469ru35wrnsm98hme;128782;186;1797524;1668742
5762;bc1pp4glp8zdsq7eh66ycvzaszesv6kxvvlrwfkaf8yfx8hvxjqftdqsj0vsvm;246995;431;1317306;1070311
5763;bc1ptnhkrzdyet5ukd2fzaf5n9r4lzgp5lackgt8sn7q9pq5wmx9a6cqe7y4gf;104412;1;104412;0
5764;bc1pj2dd2q2lrrs8letygf42a8qnvfahzchxt5jgakxufg5kjp842nmsjwzr8d;119365;1;119365;0
5765;bc1px7u86hrzmh44ueg08sht3rzlpxd8rftt72npm6snqa29gcxrpqfq6gfv3f;1079000;1;1079000;0
5766;bc1pqvtv9y66yl2h03kdzv4e3e6xgrll0gk2wd8skakwxur2mkufhd9qyxftly;1092;2;1092;0
5767;bc1pq7rf96jqzqdqu8m2r07735r5lgwfmc49pcl5rvqxndxrzkkza5vq22d08v;1461293;24;5396411;3935118
5768;bc1qm54fsc3e7mtrkhzgnwk6lf5anqf48zvy02vmes;156984;344;47455735;47298751
5769;bc1pvuzu48ullv7kgrtdsa4ny24ptnndejxl9cyjm4xhc3p2mmphgkys22apm5;137544;35;7095059;6957515
5770;1HcsyhVWsnx8E8697ufPFwbBUoeiVqV4hC;3166219;1;3166219;0
5771;bc1pv0j5vsptd4jrrryzzyeeywx4gzkqdlc4ch3w4k8wfxye7mqdh2tset4vru;0;5;621384;621384
5772;bc1q7zkj9rmvsz4rwdn5th76d9kzceaudtl60430v2;1184753;10;2045759;861006
5773;bc1pds2vpxk8tutg4m596d5urxx4ytjm44ahuq04vu2vm50rkql2jltqzef4d5;0;2;78000;78000
5774;bc1q7jd477wc5s88hsvenr0ddtatsw282hfjzg59wz;8596103;26;104675281;96079178
5775;bc1pt8nqp3tv05pwafchethz46gpz9af2h4zz67f6qd5v58n8yufxxhqfx0wsd;12012;22;12012;0
5776;bc1qkgzt0zzsp5hnjzdye6lz5rwjhunsm0gywy405w;755613;6;7945280;7189667
5777;bc1pu660m65f8dqycz7vcuyf3e0yyz93a95jq9qsvxuza0lgqug7d8kqxscxw5;253510;6;446806;193296
5778;35RSCsUTfwd82X5uCRpsn5Gi2SgKdt6kFR;2847705;13;21345110;18497405
5779;bc1plnp3c3vnzx2k038fsg28qjv9wxf4pkdcrqqv6qjq2wvxe88yvy7sfadp7y;129000;1;129000;0
5780;bc1ps7rk56mmucq3alva96ar5wzg7zyzrjpjfvy6anm6j34fwnsedrnsg740pl;3101937;3;3605288;503351
5781;bc1pfxl2w5237pxyrjm3p6vt7nrswjctc7q434c9kag5uy7a02u0wgtsxm6dy6;1285496;1;1285496;0
5782;3FrKsWYcDecvMR7sfjYobj1E551JBjU1nR;15789339;83;334379105;318589766
5783;bc1qp32ryc3vs0986gf7ckpag542ft0vg6c8wya8n8;185864;1;185864;0
5784;bc1ql3rxxtu6zh0ul7xyts73vazekt84zsc3ttyay8;167044;34;167044;0
5785;bc1pug0r9uuydm28s5kackscm4pjs57vnjc3c4e0kvwn23jxjg8rd0ysfuu4z8;5247;8;5247;0
5786;38kdbbYepTnCptvYYqwxGryCtsXz9HtxbV;4623020;1;4623020;0
5787;bc1p9cjj6a9ylz3jr2x7nj94d88ng8d0qgvjdepemm03zhv4w6t58ltq8zrtcn;24330184;6;59701910;35371726
5788;bc1q7agzwqj2ehrzl70wx4ex54jfzm3zgf8d3gje2n;753226;1;753226;0
5789;3QytC7zA1qaBJGgpXFjaQPYHXgLoPKKfbg;624169;13;18312320;17688151
5790;bc1qltnt463zhnx3q87fmps3ywczcsw8qt4tw96plf;100000;12;25702610;25602610
5791;3CXc3Xou6zQ4tbkdB248xG1hy7MsiXFVJ6;257247;5;1267149;1009902
5792;bc1p9srxdqx7u4u48ahj4s5gd3x5m932zm4fc4a4ds5ncm580nh864jqm37k26;117382455;7879;409816553;292434098
5793;bc1q6fv9djs0xc8976uanf833xlejhc5q84g6jqs2n;7379681;48;115619443;108239762
5794;bc1p5vx3dfs0l5e376mcuerhy3f3kut8zsh0klflc46dnnycdukl3gzsn7gtj3;217895;10;1973409;1755514
5795;bc1qnh9z5svsw8pudzd6jwaq27k7vnfv5rm4q2wsuf;1438107;166;13980972;12542865
5796;bc1p4456rp747565ktrru3rmfamppjew7ftdypnupj0ugx9ght5kv7ns0fmgxn;678875;647;135782411;135103536
5797;3A6vUjh7ZaBZf2mNf4w1QjALqEN5ZiWsU4;219692;60;178020243;177800551
5798;bc1q6fmqp3ytm5nzqv00amknm63axjue2ueq3nj90k;59579300;11423;143204869;83625569
5799;bc1p3t7sk9ekkn233skwn3500kpcppg930svdwhxv40434ng6f7x5c2q74y7cx;0;20;9569274;9569274
5800;bc1plavajefdx0thn64gzx9lgdrw428rupdhkkf8rdm7rt5qrf98jyts55chn4;2840154;263;822591575;819751421
5801;bc1plxdgyrlttepcgrapu37v2x522wywuverse0md8puqrdmxf0uhqfsa92rg0;747735;30;28328392;27580657
5802;3Hr9wCpWhySkiqo1WAus48QfK4fyyUSg6k;4127123;57;144249122;140121999
5803;bc1pkj530sxlqstqeh6kkzyje3llrzt7xggrqy94svstwzfuj82l6l7qlmp450;3764840;1;3764840;0
5804;bc1p5gru09qhvudhmayxxaxs2th2n0mr8rj7l0kedfrz593lcu4p7r6snddn2r;2000000;1;2000000;0
5805;bc1plzaa95qyfdjf8rgkxsr46dncdffvd8fhhdh7cmhzw4pxp784eu5sysv8zk;103178;49;117573;14395
5806;3GWse1LFm4ViSuRLPvTLzBqJU8VEL3XseC;351645;5;3101704;2750059
5807;bc1p4hykwkap9vur6tvwlepv4cdgmm9lghu7n8tyjk9lcer53gaxd3wqvxehnx;31638;11;33062;1424
5808;bc1p46des8kwsnzq86m6zhxxtcs7tdj38vtu20hf5jum20p22xw045wqem6wcf;4202;33;1769546;1765344
5809;bc1pswzpuclhjlcyf2s42ekeg4n0g9ln8ue5x5k8545ur746q4lwl6pqtkg4ac;1638;2;1638;0
5810;355XJXSkMrheNNTg296cftFF824TcbvwPH;953736;24;7942087;6988351
5811;bc1qd0grcglqaecy26srhg6p5ly5jld8hndg7q7d7l;488115;26;1792260;1304145
5812;bc1qfdg9m7p9utw27nppryjwn77hyamvq2rjwpajtt;1008152;31;43138419;42130267
5813;bc1pmmhkjpkuc5hdwym2m9yce9ak4mxkgl67yg46swfkg6ga6379h45qxq7aqm;119785;1;119785;0
5814;bc1p83t4rpg000u7c2t07648ylk6f7h3hlww56w33cwxa8s6z5fen72stxze3f;2030746;1;2030746;0
5815;bc1pyfye0ljd2vspqw2htaftrs53scfhr7te934lve8fazpjjaje0nnspv404s;869316;5;3648976;2779660
5816;bc1pymr2nrtmpz2lkatyw5za75ulx3vpdnayugaxjx2nuz20ef7gfznssyje72;11546064;295;11546064;0
5817;bc1pwy4ase37gkwfj54wwkl8wqshgnsm9d3tug2yykg5rh87hl0gewashjzwtv;100000;1;100000;0
5818;3PvD19KxJ7GimMo2hDs1CaQ4YAFTEwueMT;13398955;10;34843397;21444442
5819;bc1qschfcda64ky4mr80fheptj50axekhyacak9kqn;47645834;9595;106812952;59167118
5820;bc1p388wjl9zzy3fvezl0sltpvk6v4g6rd2vcg7yeu3m5rf7tssx5wvswmx6dd;2298019;68;24243339;21945320
5821;bc1p2vsax0lhn6qze2fkvdt4hqqy6ykcgpc2702tcfpe7877k9cmttuq6cfd4d;2568433;7;9914959;7346526
5822;bc1q055k6gt25ujw0vljwgqhzn920srsf50ljel9gk;751842;1;751842;0
5823;bc1qhfftwn72mz43nscvjeqk0hu560g90jsytcl33f;6269918;8;9290492;3020574
5824;bc1qwrtry4d3fatr44l4qxjvs6rh4j8ehumzg8cp0q;51951430;9422;116827653;64876223
5825;bc1p6cdwp7v8hxun5zqm6atcl2tu2qf4hy0ltju79nc7w6566q2wq2eszzxcq6;89698;2;569698;480000
5826;bc1p3p59k72ezad8lhm8euucxmcjzuy2lcyqx6ztuag3dewt7zl3l56s4d6ud6;330;1;330;0
5827;34pXEH4Rqabc85wLrERLNgQusEpnAsy3f2;54108;3;889108;835000
5828;bc1p32nktsuffprllv0j93a2d3q33s0l6rlh598hynkgrt60lf6upqmqasw00d;155312288;8025;623333413;468021125
5829;bc1pmz4pw9u2ggg397d0egf8daa0h6l97k0krj90edf5wu6vn5wvmyvqg4hl25;110546;3;110546;0
5830;bc1pzudnz5d8j3744drjgerhrrmukrqpdymdnp0as4knurayke7cdggs80gevk;1893275;1;1893275;0
5831;bc1p4uc44lu2359agh7x6jy6r28ph8kh6t449yquuqy937unxzasx7hqcujj3u;171955;1;171955;0
5832;bc1pjjkyplmwczdhl8wz4d9cpad38fvhft6gvrd66wptlr06jvhunmuqvwhmnz;935666;4;8176882;7241216
5833;bc1pj65sejqlnv05cflxvfdcgpxl00tfnaxscpxe9mpsym4ex074f26sxl99kw;0;11;2804760;2804760
5834;bc1p9nvy75tuh7f0k42ew4a3g5ucz72kdcpcp5kfpkemw9x8lncrzkyqmx4dtc;1092;1;1092;0
5835;bc1pr86fu8qhkcye6sgt7k3pw8qk3mvv6wj3nl7y05yqspyru3sgn7jqqvfml5;127592;1;127592;0
5836;bc1qa4n4ae4acuheerzj2allzeduuwgk0tw5nwtggt;2169372;3;3977204;1807832
5837;bc1q34q9n0g8f7c4alzzxkyf4xj9pdhrfkmnxc6rp4;4284364;1;4284364;0
5838;bc1pkqdqt5k7knf8m34sa0n56h86rh62y02qckndn6c5zpu8j0daqytqcejydw;116592;1;116592;0
5839;bc1qujh566q0mc92sa7fx9uudcv6xl9pkjwqr9apar;834790;73;51913260;51078470
5840;bc1pf6djwvg042rxt73c7kx8m55sxthkvxtssxf0sy5hafhv2kz5sg9q5u2kq0;330;1;330;0
5841;bc1p6y3hhwvjxw324wlgw9qgedmj2gppzsjmanf5t2uf8hkq3u0nwqns79tptw;170335;1;170335;0
5842;bc1pm0muggcw2gcqpj283v7s0gr2gsfff7y8ls2524dwgxsa7ljxaf5q428028;2730;5;2730;0
5843;bc1pwrx739gm5he5nvlv0nvvdyndj5chnpp9nku4w8fuztq0su73s2lsdd9ujj;3276;6;3276;0
5844;bc1pfyuzfqe890vxnlq6n7hyh0827mvj3jt9u4u2fn0z4llmjezacpcsyvdrnc;23085159;4;105723415;82638256
5845;bc1pcqms2fr4ytkjda0svyrn56h0glpzq64mflerae9ku38rjluxusxqa954sh;9454088;293;9454088;0
5846;bc1p9nvgfhkv42g48vu5xmuqz52ysvtfk5hryx0nfanwed8d8wzyn53qj0h8dp;4820519;1;4820519;0
5847;bc1ppgu70dg6t86xs8n2s5t98h937da8pmy9ft2lnwg5mn8dejllw37qffhyfk;9545344;267;9545344;0
5848;bc1paaupu6fe3rfmeck3rd32vxaqk955grlvcdkm7avtcv7m4xkyjpgs4uxne6;2048260;2;4117260;2069000
5849;bc1pl35wn7k578zg55exz799m6v6pnu563wg34t7yg7jsnmxpmvw5fdscdsmvu;11073248;266;11073248;0
5850;bc1p7pnf760rx46nt0m2ufp8wmejm69tpw3a230e2ecyeskm5vmzp3lswcasr8;1092;2;1092;0
5851;bc1q5uy2fxjv7kvsnsa33pjrvr5gcmtdxxpzsvpyy8;361000;1;361000;0
5852;1A1zP1eP5QGefi2DMPTfTL5SLmv7DivfNa;9975752803;11565;9975752803;0
5853;bc1q2fs6su0w0kez6q6yav5flw3n8sw9eupqavancg;1693658;1;1693658;0
5854;bc1pp6d8f2pezkgzyg530qlnspc60msyzacyp6gezumujjf63ahl4r3sezkurz;0;5;551724;551724
5855;bc1ptmj8a7yncq9kesr9ah56qzr4tgk6dxc0mam5a2tzx8ucc7cm9qgsmv3wuu;0;20;9569274;9569274
5856;bc1pct02y9t3gwwje3c74crkkgmgzwjy3hpx36n2yck6f7skrgqmu8ys0207gx;9425492;42;73154638;63729146
5857;bc1p85a38xeyqptvnl52wmfpctemrqpznluevdsp9w3y5t2f85xcv49ssjq433;125592;1;125592;0
5858;bc1p8dn3jqxrz9gqactl6s3dzfqsehz0gvnlp8zy2gzv4ddvfh6u7vds8ypagx;0;16;6506565;6506565
5859;bc1qj5u8y8559f9g926jv66hwtc7sup46eg6p3g3xu;51710;25;51710;0
5860;bc1p6wa9ef6jmwx2mppdu87ldrp9xv63e6q9k2y6v82265hyl6sdfs0qzlrktd;9855576;269;9855576;0
5861;bc1pad2cgwsuzsyl5gfn0l33cxszlfp6acakl8klqa4anu0xutjrat5qjrcwxw;0;10;2210814;2210814
5862;38MbMe9BFV37dNPNePhzi8cpdnu8bnbDyv;6572214;6;16875028;10302814
5863;bc1pd3c6c6purcyztxetfcuws8t7qnvnn2csqzyv64ydtrcue9asjg0qxk77gp;11896256;282;11896256;0
5864;3Eiwv19hfBWGHDtgqGDdUfbGP61xRbVkcx;1329284;10;9173857;7844573
5865;bc1phwv2dx28medh7lrcgukkm8r55r00mrgc22uj2eshyrs72nexq9cqzxp4y7;11530672;302;11530672;0
5866;bc1pv54hg5gxnecz5qghnw5avtdzvn23wvzxcmdl50vrzm254t3fpfyqrct4xw;332244;1;332244;0
5867;bc1pua73q5t437jq6zlt4k0h9kur0x4lcutp6w2hh6r75rp30u2ut9kqm24cju;1092;1;1092;0
5868;bc1qnd8jrz2njf3w7m4k4tn2tx3yyfu4w83xe3nk2s;1092;8;5671488;5670396
5869;bc1p24eec8f4zlfqgc2zfazs4ndzm3z7up0nv0uu5z3s5cx9j35sk4eq3xs0gm;1974275;3;3074275;1100000
5870;bc1pdlhnz877yknsw0llsy8vfq7csw92xhwt49ry9q5md3xcmgfcs2xq9vllmw;0;2;273092;273092
5871;bc1ph9kh8296qt7kskg0ckdnwd9gchmkt56ker07044q5vz3q4hdca0qd23vn5;1804360;18;14640783;12836423
5872;bc1q2lxwlxum39s3q34qhkynfc8syqsqh3s7fnze2q;1000000;1;1000000;0
5873;bc1p6p83h7qqq0pw3wlf5k2zld8flq7stddkdh6z48tdsjs60qyuyhvs6uhr7g;64254;1;64254;0
5874;bc1p4f37qgmdz8eh4n7mvzzd5dw6gqnxqz6stns2flkknkqpdvymcs4s84a32q;831225;38;66356964;65525739
5875;bc1qjrr37ej36cpey8d4frnu4fg8aw9zqh7w9xenp4;116838;24;116838;0
5876;bc1p7n2635qfsqqcl7my99h9wqed43w6r8pk0r9r3df9z85fh9rd99lsjm29fv;116713;5;116713;0
5877;bc1p57npkkh0pdmpsnps66qz35qlmdyrs7z7feydlufq7xjqkrxmvxpsles5eh;73938;1;73938;0
5878;bc1pxgnyg5q4q3rwfcaprk7j33gegty2vrxj7gf8l3y442xqgmavt27shrrxcj;71076;1;71076;0
5879;bc1qjghdrq3g2wcjsxu3aym2mmqccaz25zc4pxgsu9;2162103;2;4662103;2500000
5880;bc1pyttnn3t44lwk05uaejyk3xsjlecltf6f02lm8zk4hvnz0ftg58cqvcmepa;71904;1;71904;0
5881;bc1pysg8zaf6zamanwvh2e6gk9sug0ymwprde94thhzkac9nvlr2w95qq72nyk;1202042;32;19344380;18142338
5882;bc1pjfwprqgr429xy0jgzm36wuz3m3z4jy0k9rgw3yhthva70sulgccsa0rkh4;15805024;296;15805024;0
5883;bc1p2ps0lef8z36d59vt2kgv3c9un2gn3n40u5axf8j8d78s98dq2x2qkmyqa5;2334597;7;9133259;6798662
5884;bc1pwacwg8vhqdvh4rkxvl7k2j9h889skz76sxgxtf0f9c9ay4tqgveqa8rmj9;69792;1;69792;0
5885;bc1pucxy4vhjyu8k80adlw582fh8pjyehtk33wm0ad6s39ftdfd3fvxswcq85k;546;1;546;0
5886;bc1pzv59x98whxz5ml09kw7d209pe4mtanjp4cqda7qkxsku7utnvl6qvv2u5d;69234;1;69234;0
5887;bc1puhdr7l7vp3alkrfgqa29hassq5qty50tsmztw8u2uwttn3gy08eqhu5zv7;152474;88;11330648;11178174
5888;bc1pyk90mtvrpag5847p020fdxpc2rmva63d8rkwggx69eve2rdwu0cs7flmlm;360658;410;1638921;1278263
5889;bc1punz9avcqzfpes6dra8ycpnn24qpfzlj2xq50fyjzpdydtqxl0flsshl793;2794916;32;133931775;131136859
5890;bc1qy9cuw4qax456ahclkkgg0na6lkymet5duxmfwp;1000000;1;1000000;0
5891;bc1p0s7y2g6rxydfr75xya87hf9skf9aeyhe7hus69xznsvpk6n7gd3q504p5w;74898;1;74898;0
5892;bc1qnmkyt3qj3jgvxmsv3tel2xp029unn2ks88y79y;121000;173;334816261;334695261
5893;bc1p95639yehj67hyxaf3m23h3uqcy6zwnty8ehh7uwa2sp2mdcnwpjsh4y5cz;0;2;75240;75240
5894;bc1ptr6rnx6m64vgzn9du0vncqruhjvtgcujhdwkcpeeavzugk0gd0dq7e0dht;69474;1;69474;0
5895;bc1pj527su6eecgheyujmw0xkn5q63xyazswfq3mv3spt34j55yg2yys0y5uhw;2973744;3;10908988;7935244
5896;bc1pzvzfsjtnjw2dwetgl94ew4qgcg9n57knlxds5ur7mzue0a7acdmqcl8s2j;69234;1;69234;0
5897;bc1pfga4dzxuu0ayvxf79gyf86es89yejxrp0l9p267vsda7rcx4s97svn2fvy;71364;1;71364;0
5898;bc1pnj74tpcn9886424w049secdqrddsgqx60qacs8yw6wl3xtul7kaqu0v0hd;71376;1;71376;0
5899;bc1p98pzdcrfd930d6572w33fyezu720mxs8g456xc32gvz6ee5up98s8hxnft;73278;1;73278;0
5900;bc1pjm009h09y5nrx29u29xxnv8n8d6h5d6eva4ctnv35uzhakcayyysg4plv8;73278;1;73278;0
5901;bc1p0gaxcq4eyhq2efjzvfvqja5u2exz8eqfdngfqqenwzcjdxc6k8vqrl6cyy;707041;21;14616126;13909085
5902;bc1p9a4mfyvrgs6maaxvpzafd4htk88xx4zwfwlanxce6z2kmjmqmxnsy43udd;71076;1;71076;0
5903;bc1pwjna8h2epv73aa4atmqfztm9mj25f957vdemprn7ezukygwcrz3sm5xk49;10377968;286;10377968;0
5904;bc1puqvfp8ett5wjzs4zy8ek6rlqufj85ne0hzrf0ds02esmnjcq4drskvszku;1093748;5;3297391;2203643
5905;bc1q202rwadss5k6phxjazugjp87ncjmt62szj0ylk;205758900;561;650957729;445198829
5906;bc1p326esl8rflpum0edcpntsgyqj80q9h755pnwyzrns0aydpcqyg9qvjedhy;330;1;330;0
5907;bc1pyeuzurx47f04e7d2ws8nv7e3ng42yup7hncx2f396mve6zsunqvqgu0s26;0;2;56000;56000
5908;34KWvHGe6uSZw4NknCghssaQELREvNeFNg;37955840;111;786592693;748636853
5909;bc1p5shes3jxh2cnx3aq8l0e0x6jq3z2su0f4yn99fqjx53c0dtmujdqtqwetu;248684;250;526390;277706
5910;bc1pdktxz3jj9d6yhdjfyjyxk4m83x0a0len5j5j8nruu4ruqz2lph5stj80vw;524521;390;1797183;1272662
5911;bc1p97tzhadxh5ns7k3jldk5lq7auuhlxnp90rrt84xqwcq2qyal3s7sfjy2uc;14435496;284;14435496;0
5912;bc1q9twyw4tz32nzvcpg5m3myc4yjyn2zvexe6nv8u;108196;1;108196;0
5913;bc1pj0l23hgzeqk0uygrw4k7eql8g9dndqkhlw8cup9psm83aumkmpqsz8jkqc;6182244;1780;923278861;917096617
5914;bc1pvd5ardwjhnk0vzmwrlvq5n9c87fd4ccl4qs7mn5ch06205pt2njsy3tm7x;318467;25;1769193;1450726
5915;bc1pf6qnyeucnevg3h6fy4fj5m5ema492ffpac2fwz7jpdq3eu2w8cwsmp230n;0;2;106000;106000
5916;bc1pvznqxj4xt0jdjks4jqd34jr6zg3505pvay0lj02j88dh5n9rcdsqecse8n;0;2;64000;64000
5917;bc1pc794a2w7ghgu4wyvqtgphjmmtahvjp9wuxas4acp8tnyxcnepslspeexlh;70164;1;70164;0
5918;bc1pzcu7c5pxg9ttfqvp5fah5dy5rzkq846v9zvjcpwtez36tnln49vqtguyrc;67402;140;105212;37810
5919;bc1pvcg6znk70zqfhaz8slk6e4fz2fjd5np4j0ywaa57n2rgn2dqd94qgfqqhv;73749;1;73749;0
5920;bc1p7en40zu9hmf9d3luh8evmfyg655pu5k2gtna6j7zr623f9tz7z0stfnwav;73196389;202848;2865737188;2792540799
5921;37RTM5ggdfC7dZZWWmKUnEE3uHhuPBowB1;1172403;2;2501103;1328700
5922;bc1p7g5h3v9ew4xtfkv9hyda4kz5252n03ej4cjwsdehlym08sa92kaqqwauy4;64600;2;174600;110000
5923;bc1pq2zl3t9k88t88zp8zrrr9wytt0jv52054mua3szkkyn7y6dtmgeqes23pt;71031;1;71031;0
5924;bc1pe86k9yea6x95mkl2rsfy7amjgqnvfnnn3wnc3r27n42wdx6g6g7sguwm3z;57017;1;57017;0
5925;bc1quh9jm6p06nqnvgvvv733pl0g0y6ycxl0aas2t4;8595579;7546;695630627;687035048
5926;3J4eAnnY94FR5L7Ub7WTJBHLb68qvkTFQ3;9200697;527;962277912;953077215
5927;bc1ph67gth4xhly7y74fd23mvtnkp3j8nmgmygg4xgp7tl0v7v7w5gnqh6jswh;2625640;1;2625640;0
5928;bc1pd785vmh0aqx6h03pf0v5ztl0mxa5lvr66wjc5r9rhg0tp52algzqw7m474;73464;1;73464;0
5929;364XkpETDGqhpCFaL9oFVCbrL6HVvs8X6u;32625;48;110113254;110080629
5930;bc1p2plqltvtfd20uzhc22f4gp36k8x5tupz69m6q0xdpxw3lnc73zuskghx50;0;2;39246;39246
5931;bc1pr4d86gflrf5qdy0xuck7r3p5969xjnzjux5qgwydr525uva5dwkqlgcrzl;390645958;7854;1026312733;635666775
5932;bc1p5l3exqfck863jwvvcvh2nzuknrlmayctvr8rkvenuxkn4gwtkfqsgh2mx5;62994;1;62994;0
5933;bc1pn6992qxjfsgrd434zanl8dxkrqkzcygdhfen3nyxvef4z5c0fxlshazgxx;63714;1;63714;0
5934;bc1pypr2vq7t7g7xrm7k5ujqg29ftyvz899n2zwfy3m7j5dxmedgzhuqgsxaua;86802;1;86802;0
5935;bc1ppjv4g7d4ac0tkjxljzn277lavhkppeuj253pmpq6hh54h5ntrjrqw3mlus;546;1;546;0
5936;3KqtezTv6WVioVCswnXwfnR5guXNcmJThB;1000000;1;1000000;0
5937;bc1p0ha9e65a6hfdq048jwq5ctguzxyq0rmzn0nhqtdsxw74r3alpczsmj3hml;64554;1;64554;0
5938;bc1ppkt2jnhgqkfx4kc7k72z69t0tr45cfpl7re0ss6gqxlykvs49gmsk0lx9p;63294;1;63294;0
5939;bc1pqvtv9y66yl2h03kdzv4e3e6xgrll0gk2wd8skakwxur2mkufhd9qyxftly;1092;2;1092;0
5940;3KBAuKJzvwWGw55AJZNohqkZigtTiEvWQy;8939059;1;8939059;0
5941;bc1p5agja5zkss682wf7a46z4ysq9g5au87xjer37v5ueaf6fxu7qc5qjdyxle;71331;1;71331;0
5942;36wSBovCfh7uxfcdKBRsPbhunRPiyMR122;638179;284;46376518;45738339
5943;bc1prt6033f42techptqm6nw5l0rftksxlnqjjyk2nkh966wrpz3rskqzmdyyk;213306;108;4542944;4329638
5944;bc1qs8026stn83ut8cyx8lr3jwahf6kqpf4aeqctd2;2276536;9;5930969;3654433
5945;bc1ptrukwku6njnwvljyfu4gnkf7k4lwjup4vs0qdv9937alsmwndw5s3hwj7z;0;2;49903;49903
5946;bc1pt44fqqmtsn0rjsvyzg0zu05v0wws4ta5jkvkqyzmhg5e73pr7zjqct6jzr;71034;1;71034;0
5947;bc1puur7ysmpgmdmatl2h33gxeuyly43hlv8legexlq7evrg75ku2utqj84r97;71742;1;71742;0
5948;bc1pw0ksc3jq8t6a6sxlk3uvpkwq6xu4ptzvxq2yk8x7r6y3j5sra3es572hh9;2184;2;2184;0
5949;bc1pgdruw9p7h3k0se5pgfcyw0srw5cjy4n0esm5xygmtszxadpcc9pszhsld7;177542;1;177542;0
5950;bc1pug3lx2usgr0cfhak28w9f5gyq476e6neew877emxjlgsvyh3w8xswzv9ul;71049;1;71049;0
5951;bc1p8wh35rpzv3d85ga7hepflqq5spczdsutk3055vmhmdd70raf0ltsf820m9;76878;1;76878;0
5952;bc1q58wkzuhraqhk6vecrxd5yqs6s8uey5d39xresn;1000000;1;1000000;0
5953;bc1p37956sggtjclreke3y4a2z57dk6scl5929nu83qkrk2e6lqd5q0qf5uv9c;11184829;508;134536321;123351492
5954;bc1q739tf9rw2ss2duvheah9qsr53g88uercdca5kp;1005282;3;2643282;1638000
5955;bc1pv0fjyku2r2pwz958qvz3apc75lmssk4s82p3zcmwlw0jdvjzgpuq0uz8ya;72018;1;72018;0
5956;bc1p26uvjha9y7qxj339q9uf029ep34kzl4hzwtaz0hz6j0m2jatvk7swaerkr;1753751;211;24150469;22396718
5957;bc1pnwrarjprwrxxgd2xelv7ysf2myxr0g2nvaa3cna8hh6evafs69as8s5mhm;1762566;162;19719713;17957147
5958;bc1qa9k0ywdk705y2v4tx4xrf2ew96nn3x03hj2wa0;998053;1;998053;0
5959;bc1p53j7st4628drwv3mv6vj8mvvwsnx5t08f9mt0ehse2qjm6z2fjlq2tafgf;68349;1;68349;0
5960;bc1pc3yyzx77wpnragwaa7p0wkekue8klg657t673hnh0xvgwg5xpxeqkvnezv;2840913;127;69645610;66804697
5961;bc1pdaq0a49e23jplru579238px8m058mdehu8v89jejw5yhjzrktrgq94e4sg;70134;1;70134;0
5962;bc1p683y2y08yylfl5gqqnr4xdj59scfqwx85y7e7htk9uu6t5p3cu4qw97ned;25324622;37;190771510;165446888
5963;bc1qcr3p7598kf5xjk3vnpwxhq3qqawnvyrym0jj6z;23502;7;176754;153252
5964;bc1p74nxpclscykte8yechjrju0lk3vh3tnxnxdz9pmldm2gx5szwyrs3mf3tm;79878;1;79878;0
5965;bc1pf3ml8drl9rvdth9knjhun57665n0v9scpu8my4xsmfml2mhzx8jsr9z28q;70374;1;70374;0
5966;bc1pfsy250vm88pqj5se0u9jnr4gjhxxmvcf6y63r6q85p2vq6kyg40s656un9;2812292;1;2812292;0
5967;3F8ruJcKjrxhdUTLGmX8JNTbHT6EUd7LE4;300000;1;300000;0
5968;bc1p9srxdqx7u4u48ahj4s5gd3x5m932zm4fc4a4ds5ncm580nh864jqm37k26;117423721;7880;409857819;292434098
5969;bc1p047guyd7jl3nx944vaa35p0z5exjjrw9nkxjkkqcjj4f5w46c0jsu50fna;1092;1;1092;0
5970;bc1pvqp6agzlnp36prrpu3627qwz847twe6007perr6xhy9m6k39cczqvyf4c8;546;1;546;0
5971;bc1peax5xqqgmqn2sjpl7rj7klhk3we7f0sywqg3ksgq7jvl8ufcekts4dnvhz;0;2;45246;45246
5972;1A8xTdusrAaQGjAT215v4MTHnPLu2keAWe;598862;28;3008444079;3007845217
5973;bc1pp49uc2hlaa9a5rslkf73w7qmu7cvztpx2dglldg2tcn3r4w6ealqy45et0;172142;1;172142;0
5974;bc1p4456rp747565ktrru3rmfamppjew7ftdypnupj0ugx9ght5kv7ns0fmgxn;678875;647;135782411;135103536
5975;bc1pq2c26yq2upd4au5wk8ukt4829jdck5q34q7nhnrk46x6w3k4hp7qnptup6;74049;1;74049;0
5976;bc1pscz044rg2rhlq5t33x25n3jqnu8xaygd5f2lqa8vht4vveprhdqscdvumd;320231;1;320231;0
5977;bc1pas3wcnk2jcpt06hyy4dzlrgldh9qf30wj5nv7kawc94j9xw30dmqtnv5d0;170642;1;170642;0
5978;bc1p0n8qmnlffn88ktqwd6c7w8l9ey888sjpxzucvx3jj4vq4fqlvwdqqw4rct;72036;1;72036;0
5979;bc1qrak7q66pux72nm6jqus0h7dkkr9cl9099csn6f;5435;1;5435;0
5980;bc1pdkfvqdv9lnyrruq027ahdnp8djja5h0ct4687qf9wmsq82ygrpfs9jtykd;21606;1;21606;0
5981;3ErgnfdoKRLuRoEUdBCuP1ZfBoYTTubZqr;3139524;196;429196190;426056666
5982;bc1pw27cw6n7gjgjsajt7uaq6c4t9vzvc72zteqej02jwgnww8rs2ynq2pzpcu;69534;1;69534;0
5983;bc1pvhtkfxtz8krtxdtqj9am7ck2mz335u2pph4khgzczw4dukakxerscz7vaa;71049;1;71049;0
5984;bc1psss9v7jjpu7r0fpdf6s39ytu6885dfsvwhg9j5a50p3v7e7amnvsulxnyw;71364;1;71364;0
5985;bc1qem8t0n2h5feqvzee25pn8lkl2v3cv88km2trj4;547;2;46943;46396
5986;bc1pvqefs49ducnnxpvc9cwsutz3wkzjqcay8enwpffj7w9g4yysfxyq0k7uh3;2210892;1;2210892;0
5987;bc1pvulllme3sqqg6mmprkxhw3hr3radu9mfxfx5yhqrr3xg5l7xuejq6vnsuc;9667034;12;58263042;48596008
5988;bc1pwayx3j9ctr5y5tkkh2ang6lq7dzd60sy9s59ejpea9uvy663nwksz6j54q;0;2;293527;293527
5989;bc1prrealccskyaa3tm4nlchwyrcqddwjnwdkgnlcsw72xv09wc8luaqj3m0wd;3398407;5974;1622303625;1618905218
5990;bc1pjl4nxm7ge78qeeytl5y6fvh3fvu3leqypnq7qw6270sa5lf809cq9hqm08;71331;1;71331;0
5991;bc1p2xd5ketwe3sym6lkchmxcd58udm7ta8ytadffvsfyvyftzxqevds6ylyy0;959041;73;21456469;20497428
5992;bc1pqwruuxufm7wc9zjlur4yertuacdtc73uxnj9j8rf7nqmj8ktq38qhjztsa;0;2;39246;39246
5993;bc1pjrlavkacdpx690va46tnqrettyas7mjahsr3qh4elkhk8777xs9shk8f5a;10000;1;10000;0
5994;3HSibRXj2KQZrFUv4ad3XPFPDVZ4wjvzie;8696620;246;465255011;456558391
5995;bc1p2d3fkwwad2uu7a9njawxpmllw8f7pdf28pkjcfmlah4xls88fcgs2lpgj7;175142;1;175142;0
5996;bc1pv9tfd3hsr4542qrnmt96uf75y288t35ekxsjs5r60xzav7zgatkse2zp46;9007100;345;1815310189;1806303089
5997;3NTtDkWmcJmef7LT7BjfJrdSXLrQTskBvV;6684410;5;20684410;14000000
5998;bc1psv64h3zyukfvmglk76mqrt975xvcmzdvp82estyvu6tlpy2eq2cqvrswka;87349;143;41989368;41902019
5999;bc1q80zu7zsdecd07sacv3nhfuv0rxjewjvv5erf3l;1000000;1;1000000;0
6000;bc1p8xrkqjmat9tg5u9nuqured5fmv3gryjwnl3zdvzncpt8k7eq8kvqx6r5g4;71349;1;71349;0
6001;bc1qschfcda64ky4mr80fheptj50axekhyacak9kqn;47638198;9593;106805316;59167118
6002;bc1pwf4fkcldne5l4n9ssz2c5ld43sqc5xf8u8c3ekc3ss382vvzcyyq674jqg;10000;1;10000;0
6003;1NfBTRU14XJSdHN9ggTWUTo6dsaEsAxhwQ;3000;3;3000;0
6004;bc1qx4vujklzw24qz68dl3pcc5mdxfywm6df37s3ft;12544;14;4403856;4391312
6005;bc1pr9ykkry6celpwdusaskqsgcz9z684kvyy6wyfqtd9gptwfr9hg3qg8z79u;73149;1;73149;0
6006;bc1pp25emjt40gcmj2m7ye5s0zthl4yjl5vhrgtcswtjdk8ujrnuy73sk2z8c2;173342;1;173342;0
6007;bc1pxf6lxukjdnva6ehryp7gjtrun4ljlzdsrpg0366vtvs3g9px879s457r7z;64854;1;64854;0
6008;bc1qwrtry4d3fatr44l4qxjvs6rh4j8ehumzg8cp0q;51946431;9421;116822654;64876223
6009;bc1p32nktsuffprllv0j93a2d3q33s0l6rlh598hynkgrt60lf6upqmqasw00d;155416647;8028;623437772;468021125
6010;bc1q3rla540c8jm3hstsk0rrx9sd4rrwhxh4lpfcjaalyks5rna4tjassgtrsa;38548;1;38548;0
6011;bc1pscr7sgq924vq3zuvjkgesf2cxdknd5cdv2lpkn90drt5vflt9jzqrk6z5h;2466905;11;5124353;2657448
6012;bc1pufukfrxwn9ae6sgm5l5lja4xupcdd9dse9chqh3hu9rms42rc53qw9yx6x;70134;1;70134;0
6013;bc1p0z4ruzck67anwmmgagzelmf5vr53nssvr0tzuzpkmh08f3nf0tgsg8f5tu;4890823;223;32747771;27856948
6014;bc1p97evxqxcp33pplrsgg9z93yzae3la53j5y9rrar36z43jk493dysjvyk7p;10000;1;10000;0
6015;bc1p36wxqgxqw60p3l5kgx35ve03pq4nqhfx7rq9pjf52afdaf2ugszq0u0ua7;176042;1;176042;0
6016;bc1psulfe8297kzfjn3zej2u9cgch285uchs7k8hv42s0jwlthgplr5quct0m5;121452;1;121452;0
6017;14kqJWcAQo9WYYJ71Xj7CECgitMNzxUBRj;638836;427;260080923;259442087
6018;bc1pmfy8m9ytzfu05peuqwenhrmxum8u7dwmha79tg25v8pwqged03psjme7tn;69804;1;69804;0
6019;3MDtMEHaE5riAm1p8ocTrMV8nTm43ZZHvE;3154524;25;12406886;9252362
6020;bc1pnr4j8qsu5s69u25nz5gft0sxt3dm49hzjqyv5685mw05nhgvnxjst2wc97;0;20;7944261;7944261
6021;bc1pv844wl4yf4hh67n2ax7q4m5v82xtl4xmfqsh0xmz6paz9pm5w56qmaj3w3;5434;1;5434;0
6022;bc1puk9nsufm9lxprprz87n0m5necycaq9lzmyqxca927fqsw8kls4xq967hew;0;2;78000;78000
6023;bc1pnr6pt0a7cn0jfd5cqx9raexvz6zzlj2krhxakln03jxgwc8lw2us3xd4tq;366868;537;111595500;111228632
6024;bc1qxa6hm2rdgupe0n8ks65lu2gxywspczjktyhcjd;1268388;1;1268388;0
6025;bc1pcqms2fr4ytkjda0svyrn56h0glpzq64mflerae9ku38rjluxusxqa954sh;9684400;292;9684400;0
6026;3B2yutH7SRRcLpwJzmScTiEC2pqjgEJzuc;9694946;142;152985641;143290695
6027;bc1q4lm5xnzfcd5sgz3vntdwzujyfxvrxxztzhqu30;88494;21;88494;0
6028;bc1qw3640pmymzzugzr89n943gma4xwtsn9vnqzzhm;17429;1;17429;0
6029;bc1pcpmjwpjqdsmxyzhda9k6xv5humgaxghnwq8a03yefej43ra94ufsv5g8zn;174542;1;174542;0
6030;bc1p7cd7q0s8kdl82lvvrravp4j2tyvhpx7qw3z5ms9yc7ferurqq6xshdv3np;74049;1;74049;0
6031;bc1pl35wn7k578zg55exz799m6v6pnu563wg34t7yg7jsnmxpmvw5fdscdsmvu;10964696;269;10964696;0
6032;bc1p7pnf760rx46nt0m2ufp8wmejm69tpw3a230e2ecyeskm5vmzp3lswcasr8;1092;2;1092;0
6033;bc1pmkjdzszl9zu7nrw2929ujefcslfx9sk6nz75uvt3f3tg29f2kxwqsud8vq;1327937;229;42722224;41394287
6034;bc1pxkfs7npd6tdh0knfuhk0wt8092xalvce8xrga93dy3z703wj4vzqa5a4x2;71049;1;71049;0
6035;bc1pkfhpw9ggjjeapfkar6t5t8fzhuphg4lfs58agttw336c23nslluqagxkut;5089848;1783;1269680408;1264590560
6036;bc1pv6vnut56fjef6g332ylhc62t6esc0kgg63nxcut0dx8k7n7u3cus30m8j2;67749;1;67749;0
6037;3EwoxqM4yDzNQJ5LYqKFMJZ6qKFpxymzzA;110000;1;110000;0
6038;bc1qzrcvuf2kpdwfzm3ewr5zxrl50erdxhvjeuxcxl;1565471;1;1565471;0
6039;bc1pu59650sfpy7yaa3rh7ty59an3kyrmlvx68w566sv7ndmk4umtfks8w2jm0;1630450;1;1630450;0
6040;bc1ptmj8a7yncq9kesr9ah56qzr4tgk6dxc0mam5a2tzx8ucc7cm9qgsmv3wuu;0;20;9569274;9569274
6041;bc1p90y0mmgh84v09aa08npg3grqwrnkd074dnen6tuumegf4rt446aqxg58cs;63174;1;63174;0
6042;bc1qq7ep35rvwen3xsew5xnzgdxae52d7ln2unfus4;1559981;48;13353611;11793630
6043;bc1pm4qqvf9ltrjlkll48fleqxagnrjdvh5uujdpck66prygw5s6xkeqyspw6a;69743;4;242743;173000
6044;bc1p5p7y4u7q4cve5n4wa9u35fml8aguv0gf289k994kd88artg9s5nqlq9a7n;218450;1;218450;0
6045;bc1puccmruj9vssseueyaa9pf49sz8l3lq029ncyq3s7k5w3l36t24tqulnu6w;0;2;62350;62350
6046;bc1pe7kuf305hv5pu29pkgpg3aw0p6sgthhrp9dy68u8ms37s2zvgunshawve6;0;2;169000;169000
6047;bc1p6wa9ef6jmwx2mppdu87ldrp9xv63e6q9k2y6v82265hyl6sdfs0qzlrktd;9954608;274;9954608;0
6048;1AquabyteWasHerePoggers7777ArgRWw;547;1;547;0
6049;bc1qxj8a4906xe70fj7jzhy668zjw87nshtk4gallj;20000;1;20000;0
6050;bc1phjszart5gwvj33sgwsns9khcn5k02usq2stkwq7e07j4m5vxj8js5psaas;71742;1;71742;0
6051;bc1phwv2dx28medh7lrcgukkm8r55r00mrgc22uj2eshyrs72nexq9cqzxp4y7;11940744;307;11940744;0
6052;bc1pfcyus5g9l7qmgsm22792c3euckuug5z57x0gcd6sg47jxnfgja2q2354s3;71592;1;71592;0
6053;bc1pdjlxt7v4572fqkrlzdsx986l6zjtvl9s7ymazc4cv3rpxgqz3wlqhc76uz;115349395;7902;412337889;296988494
6054;bc1p52t705nfmdumpd69s967tpyeaszwamscp6xcqd40jc48war2laaqhdu7cc;184142;1;184142;0
6055;3DAZHeqP58ZqPMFfQ8KxutmVTfGJzDoVPs;287186;1;287186;0
6056;bc1pkmqcqqnusqk6q099352uuhtla9fgzz54v2ntreg9hp3evdsw9wyqlruxql;73749;1;73749;0
6057;bc1q02p0p3hlysdxmmekppk5whhevzvul3c3ppnvnv;551961478;56170;999480194;447518716
6058;bc1paa4t9q9gyv2rw5jfygk6jqkpm4jj7tmp9gn4jan5fcx956k24ywqgez3kj;66174;1;66174;0
6059;36rT2dDEYuAUJWWYWL8kt8f9CCXFky1zoH;242654;2;402654;160000
6060;bc1pxx5fzry0wsqgalat3lzccate6uxesnuq2qccrw7u3rjw9t9r6j2q5ntgq4;69804;1;69804;0
6061;bc1p2pwex4kgg3n6hd3vvwkrmq468p6f033d965y2qvevhtvvc82ttcqqa4y95;71931;1;71931;0
6062;bc1pjp7n428xpazy277qqwpdvvc2kn2myymtkaafqqk5nguxdnmwpmes5jw0m7;74049;1;74049;0
6063;bc1q7v8k2jzamlkcul9uc9nxrq3n9f8zhtmkuzuj2c;1143142;1;1143142;0
6064;37h41579Vxb72fxQQt4V4mzE2qsmL4Jf31;100738;1;100738;0
6065;3KEPRGuskvMJKrp2AyjTGD3z1oH7ado8D6;6448682;1;6448682;0
6066;bc1py2c84c9plg3awtahw7wmtuxenyw7m74c7207vga30r94l52uew7qe0c3d3;58910;1;58910;0
6067;bc1prjsaryq5nhegaf4m9hfmksp5wh0ag6tt2gyz2j70ntnh6qlerepsyd3w7v;69534;1;69534;0
6068;bc1pj4srse78avy4ulza5ep525r5cq5gyy33wtydwhmzg07jgfy9u8hqxew5ak;0;3;130092;130092
6069;bc1p0hu879lhvaapt0ak8zwjgtkpru98q42cpm592ydpmu80f3wc6vjshm4u05;4837895;5;10837895;6000000
6070;bc1pes6dtxpcnf3uh8gzzgaw4378vry8lplmr8yzll45ef5zdg775u5s9f7qe7;0;20;6337374;6337374
6071;bc1pl7wz645v7qz7e2nlt3r9rrvrcrg78l35l63u7kajtt7wdshsxs4qxnsulu;71742;1;71742;0
6072;3MGTegg5oqFY2shtQX4fV25SiRxmuHjhyh;41316;26;367265239;367223923
6073;bc1p6dqnerwk5mn6lpeez5y6rs8awd6fxenyf0s7ysrm7cwsh43sgg3q7gn4ca;0;20;6337374;6337374
6074;bc1p3n734sy876s88tuyjnl8qxj27lez7vc8rq25f76yq6r82c0vnx0qgam5fu;70431;1;70431;0
6075;bc1pkjq2ymdnc5m3rlpfwqlmd0y322mrq6s88lgagjvp9amxlkw2a20sfqvmke;2069033;175;47081128;45012095
6076;1LW3ECWiz2tSxi1TWGPofqqBmshjH2Q458;3873512;104;518880919;515007407
6077;1EjAj15pR4md1jpRqtmbqHdqKfx8j2SFvq;9629654;41;13644359;4014705
6078;bc1pc7hvwtlnpz53pjpffkya39sztxmdee63euld69q2zxgf8hs65ynq8zq34d;67854;1;67854;0
6079;bc1qnf0cwwkndgujv46kc8qyxt88zq36f5dx8nz66l;122938;1;122938;0
6080;bc1puhdr7l7vp3alkrfgqa29hassq5qty50tsmztw8u2uwttn3gy08eqhu5zv7;152474;88;11330648;11178174
6081;bc1pyk90mtvrpag5847p020fdxpc2rmva63d8rkwggx69eve2rdwu0cs7flmlm;360658;410;1638921;1278263
6082;bc1q0mw52pspmzdm543qs9z4k422cyqlnkrn7dqy8n;10867;1;10867;0
6083;bc1qm850zesjyl9r3xr0u2ccjdkrp2pm2af5pp453a;798756;8;24968289;24169533
6084;bc1pmprhf2lrsxzfxetklqmkvt6m72angjfnnz4s4zkr7rysm63jm9eqhde5rn;67836;1;67836;0
6085;bc1pnxfn4tu0vp9ue2f37htctkukm7mkp2erl0wvvd9pt8r6zefn2pxqhup2lv;1967976;7;7362308;5394332
6086;bc1ptmlxzv8tuqd2a9u2wkauc4e7cmgjcu82j4tahx2ykseq2u6l55wswja2fh;73578;1;73578;0
6087;bc1p38kr7j0sepsxx9l0vkx5h0lc6k2v5qzmq0k45lc9zd9n0267hl9su4pg8e;0;2;43004;43004
6088;bc1p27jt43x6f20hnfcln0gtrw8c3jnhw7dnsvtz3lluaa45lzzayqksm5lzuk;9894154;1;9894154;0
6089;bc1ppqe327nsc72v0ywt92f8z3m4qfrmacfpwncuhuvacf7p5l94zzvse45y2v;195861;632;35364757;35168896
6090;1CgvwwET55pQ4ABxUuDenHXiqMtVu4ytb1;3023983;23;3023983;0
6091;bc1q4xptxdgey8epf33y733ldw6s4pdgsrdlyr0xer;144382;1;144382;0
6092;bc1qay7lljr2g3zew5snwqx9ngjtspylml4hge8p8y;1393690;1175;274486439;273092749
6093;bc1pkgs00jund2s57eymvlpnq94aqvav63ze2590ms2n9pw3w396r4sqrchdgv;600883;1230;87303257;86702374
6094;bc1plkpkfqkpwswaejx7jtlh63j07m5rf88aj6tsge0rpzcxn6gutxfsgnfuau;72342;1;72342;0
6095;bc1pwrcxqrvu978g7xjsx26qhxrejjtya48edy3q37hulg3s25sjqzqqgyet9a;69534;1;69534;0
6096;1HUPWg4BoLcydZ6tkP1NhnXE8XCQi49upn;707947;8;13617232;12909285
6097;bc1pnrgx06qa6926jexqm7tcxry89gl8ltkmz9tm0vmxnzndcp4t0gqsgstkny;546;1;546;0
6098;bc1qw0kqz4p26hdsvdtvcktgplsyucptysgx4l4wrl;0;515;3896190704;3896190704
6099;bc1pjeg523u8gqnj4yc6csjsl7jcjp26vx9y06pwnsnudg293un0hauq0ap6he;73878;1;73878;0
6100;bc1pnvqr4ymna0qag85lpqg8t5m4fweg43yvmhysn7a60fx6npy50r8qsh5j0x;1638;3;1638;0
6101;bc1q96wm8420w6ja283zkxp6rlmwmhac6g07jggf0k;91085;31;91085;0
6102;bc1p8atr3a2707343d80sv2z4afflggaru2xsy0sk8z7ahwg6466pvhsshwzqa;0;2;34935;34935
6103;bc1quh9jm6p06nqnvgvvv733pl0g0y6ycxl0aas2t4;8589435;7543;695624483;687035048
6104;bc1pfw59fcv5rf53pgqkwmpqxgvay5evzmmwhekyqwjm3y9yjaqd9x4s7e93qd;70404;1;70404;0
6105;bc1pr4d86gflrf5qdy0xuck7r3p5969xjnzjux5qgwydr525uva5dwkqlgcrzl;390645958;7854;1026312733;635666775
6106;bc1p8md785kkr5vrvfd29tueg2yve995a5uvxpn0alma4z0usy0rktws8unv48;69234;1;69234;0
6107;bc1q8hn7z76l9qthaykf6eqm83j0mlq6yk30f7jnvm;4684894;1;4684894;0
6108;3MNHadPcshfx3CCSB1zd9zsCnyWkPyCrtM;712382;4;4704858;3992476
6109;bc1pfnjklw0rsydnx3ft2eqnmd36v5gz67urv8kdddru4dhhzr6arzlsctsx2t;163100;1;163100;0
6110;bc1q5ktfzyn2k3d5pgxpaslu4jy3td3zmdu7jqd0jg;809840;777;297832915;297023075
6111;bc1qc3500j7qdel3svr06z5lg05ucz89jhftp59v89;100000;1;100000;0
6112;bc1py82h6qkrcdd044wtqxtdxwap5vf8spry9tjt86devhrxvcrzfzfscddkwl;68631;1;68631;0
6113;bc1perlryc20y575p342ucf8t2xeys0y5v6wcgw3cz3eh3r090ts024s0c8zsl;6969;1;6969;0
6114;bc1p98wak4gnsdhznvayuqde8r822rhdu0mfuyz3efeu32fyrhza3zaqauhmyr;70431;1;70431;0
6115;3CQgARuhZ6tXMPmNcRC43hsriaxoDcT8NY;2134689;94;34483780;32349091
6116;bc1ppcqddwu6rw9jjg7z3pf0xnxrs3smfnfuatdjkc3avyzh79w0a7yq29lsh5;125695;1;125695;0
6117;bc1qprdf80adfz7aekh5nejjfrp3jksc8r929svpxk;28927734438;82289;887469028264294;887440100529856
6118;18UPmHnnmb1Ufak4AcqAXq6ixih4V82qcM;156175;27;889319;733144
6119;bc1p92yg2343fanvzfydsreydufph6welytc5hmqdwnhgw3efgmvhcxs76gcu9;71649;1;71649;0
6120;bc1qcfrj0dzqem6zeh7uk3vg5gr3c4v6y2ehyt6txw;91462;25;91462;0
6121;bc1pt8nqp3tv05pwafchethz46gpz9af2h4zz67f6qd5v58n8yufxxhqfx0wsd;11466;21;11466;0
6122;bc1pywy6zfdpasflfszzhykd9r67x2hzyerjpxlwen4j2wu8ttdpszkq92hddq;76578;1;76578;0
6123;35RSCsUTfwd82X5uCRpsn5Gi2SgKdt6kFR;3100629;12;20634151;17533522
6124;bc1pj668n0aqwg5kl75ntp7mxrudes2qfzpdj9wk8lfcpdvjrrzefkkselgm4g;188945;6;1986238;1797293
6125;bc1pdwpm04a752l9gl5mecyphuj0myyxukt2gwaclu3l3e3phkect4zq5uftd7;71931;1;71931;0
6126;bc1qpfxd4al49r9gu4ufpz66synvt9vhgtc8m2xcyf;133590;28;133590;0
6127;bc1pjc25l87hyqn0a4ucs98pxzk25cynulgfq9gshcjr46xu24deez4qkfw39f;70242;1;70242;0
6128;bc1p2jtmlvtnpj4y9q4jjk204chguxgm4mt89dwc04gtp75xjwzjkvxs4kucva;75138;1;75138;0
6129;bc1q7gxytu8pp5wsas0vthl6hx9tmhr3ly9a60kdtp;170920;1;170920;0
6130;bc1pug0r9uuydm28s5kackscm4pjs57vnjc3c4e0kvwn23jxjg8rd0ysfuu4z8;5247;8;5247;0
6131;bc1pmyv8aaytgjq8llk26vq232rcp50308x4me72sjkcmmgfufttq8hqrkxcvx;70449;1;70449;0
6132;bc1qcxqvpplmswyh8w55yekr0qkvtsf55557wyan4f;110102;1;110102;0
6133;bc1pgqyzm0hh702sht0v0xtd8vvm5geezkvvm8k77f7crcg0jn86gt8s3z9upt;77898;1;77898;0
6134;bc1prvz4k6jkmufydxn72tqz5v3gqhrh2xa8405cngxjskfcg6fd6q8qdmcw6h;73338;1;73338;0
6135;36VYseBQ5Dhx6iD36tsLgHrDGArbvDTT2K;81941;1;81941;0
6136;bc1p6cnrhm83vllhh5yc4xwh9r4dmsq442elmwm8qtj7q078hhajm00qhg0yas;0;5;389184;389184
6137;bc1pfrnahlte7nhytmrkl8td89xjwwdeznhyaflfqekxnv33l89clcfsnlmqsa;10000;1;10000;0
6138;bc1pf6u7q0suk49ncmk9gj6qm4taufcsvfpnfnnmguqct8fqn3ll2xqs82xzsl;71742;1;71742;0
6139;bc1ptdh90cn3stcteum8zeede7cha72qmlnr4n2wzuvh7yxpvc5lr4aqwqsnlj;71742;1;71742;0
6140;bc1qcg3pjw23l7q8da9hqjk5mzk7q3g82xttgu8g0y;188223;1;188223;0
6141;bc1pwj4zlqacshgp29m0qz50rdxr70hkkwth4sy0ymqwvafk0a0qxscqmsu5vn;71601;12;1633207;1561606
6142;bc1qam8c8ce7wkfs8ndt6vx69urlpp75yr0nsg9hlp;381012304;4840;2310219214562;2309838202258
6143;156WKVKJgBMy5eu93q1x1twMeWUKJYKtSb;932215;6;3591324;2659109
6144;bc1p45fs6xv6la5ymqpumffre7ca03k4qjph079fml62u27ykvhp8uvq7jmd7k;0;6;410643;410643
6145;bc1p85urx9v0crfswf0r2u44dwlt2zsa8wfw742k358608rn8x8eylcq5wdel5;0;2;57000;57000
6146;bc1pfqzdackwdkar7d6akm525sc0zgdts6g5a3agu8qy8l0p2yww9kks5fj655;25570;1;25570;0
6147;bc1pmz8vcx72px8c74xdx0e7n2j0t4x34xgx5gaxtftzp5j92v2umv6ssw6tw3;71064;1;71064;0
6148;368mCrYpqjBZjRu5RBcLcX2NEiH1p73t8N;70007455;11;222446352;152438897
6149;bc1qf77kzuzg8vsdqhjjrya8cj4jn6uu7ty93hu94x;251735;26;251735;0
6150;bc1p46des8kwsnzq86m6zhxxtcs7tdj38vtu20hf5jum20p22xw045wqem6wcf;4202;33;1769546;1765344
6151;bc1pp3j5v65xj2f8qeuyuk90qatmv0xryd78370eq7zx86gmnw76w0ds9kq4wu;0;2;39246;39246
6152;bc1pflpxsvu89390zm9k0vr80fxp0hxvhemnzx3rgfnl97mhxkrddh2sr5nfm2;69834;1;69834;0
6153;bc1ptgxfcxu3aass9t397frqw9php7yahawdf8utzrvhtuuhe8w3hs2szwp22n;173642;1;173642;0
6154;bc1pmvcvkt9ueynq2q3wte83xsnm9qlttcg35nklhgzfmjx54yy00rvqw47ltv;0;16;4007190;4007190
6155;bc1pdk382dxsfp4pdv4pe9jk7drmhctfr7h88tw8zf970q03f7650afs4nsnvz;70794;1;70794;0
6156;bc1p45fstzfz9t9y47axrxg6n2aze2w0dcka4rj8ls6tq9jvvjugngesya0mg4;4838240;5;10838240;6000000
6157;bc1pys255du8442jlswt8kwjjldmauc4mt54hcrlgdn77kj50ruwy39qlgn7y4;171242;1;171242;0
6158;bc1qfggf87typkxrawtdfr8qjcnv9phdatvjgdj7e5;518119;3;2267824;1749705
6159;bc1pfh3fpkrfxrcg620zkdw5eulluup7u8zkw5zw069su0c59v94kh9s8gla6j;73449;1;73449;0
6160;bc1p6vhe2fc7hf7527mmtmcsetwl5mssjzqn8f6qukt23cz92l2jh02shzkc9k;2184;2;2184;0
6161;bc1prp57ad5tphnk0jv8qs0wes0hs5uf8sk2w5u0ujhf2f5522q8xw8q7h73l9;1473934;9;5470642;3996708
6162;bc1p9gmukars028dlreyg8qegnue0za3emldv8p8j8lhk3w4dzkfg5asx47m00;2184;2;2184;0
6163;38mG3VD5vQXcSG7EP8Zi2w6V1im1Kb1jH1;2297804;301;19852464;17554660
6164;bc1p6g20f3ghk3z96l5pjcjl0w0rwlcss5c0nsqng2xyew94xffdzw7qr3hard;172742;1;172742;0
6165;bc1pdrvghg52mmx5tsqspqqqtqk2rlpdnwy87442zg7l4w7a37u5wxgqz3624k;174542;1;174542;0
6166;bc1p8ywclxza2pavr2p57s37sv6yc9cv4dr2j825m6zgju549hsv4pkqjewnf5;162107;61;24191755;24029648
6167;31kznxgmdXxWyfG5o66HSWW59oL9cK4vbB;948358;6;1217358;269000
6168;bc1pflpc4pgkc5fxm3g5zaa0vx0es9fp7rc34lsdese5g3mf8a3htppsju9gna;78198;1;78198;0
6169;bc1psdca736ewgmpdldnclfff5gydzg76553zu4g6xhf7mc5n7rpdcmq8ywd4u;174842;1;174842;0
6170;3QKUN1nKqwJ5SzrW637oSpR1CuXsySLivr;360000;2;360000;0
6171;bc1pwrfll9t35sz4pk863ct364jg8e5qt5sv302tlhsglywaullvp38q0g3ak7;175142;1;175142;0
6172;bc1qsscx7qhgf9gwksje0zltgyrw3ztvfl9x6zj6m2;49861609;9702;111108497;61246888
6173;bc1qrfl3k6aax7v5ggtn76qw5fk4dycfz5na4g09nt;49281814;42;103659556;54377742
6174;bc1p9cgae4w704wtdflur83220x2r74c4zat78wpy8ygxqldg4yd9weq6a82cy;21638;5;21638;0
6175;bc1puuh7nw5dtnxm5gajjxxsvzg3u4fvqqqv720xdqhncu2a8avalp4q95gg72;0;2;52000;52000
6176;bc1qwrtry4d3fatr44l4qxjvs6rh4j8ehumzg8cp0q;51946431;9421;116822654;64876223
6177;bc1pjd22m5kns7eq80h52u8wdyvnv5urax8m6vqactwhps54987mhhdqnsv5xs;66654;1;66654;0
6178;bc1pnzfheuta3w78g2nq2zzf3nk2ez2qv40gj8mgejzc9ldg3nneukhswgl5vd;174242;1;174242;0
6179;bc1pmfxkaxrfvsuspcapyspkucn5p2ju70am5fv90spf4rxflww4f8lql6up9e;1092;2;1092;0
6180;bc1p0z4ruzck67anwmmgagzelmf5vr53nssvr0tzuzpkmh08f3nf0tgsg8f5tu;4890823;223;32747771;27856948
6181;bc1pq4kw95dcnke4lg3a4jewuutgdgvsgrp8h7cyqc03hxcqfj3chwgspsd89y;169142;1;169142;0
6182;bc1pvpjph6g82fxeclnvlsgr57nw5qlajf0pv5rtu4l59p8r2zdl43pq9f7xg8;71631;1;71631;0
6183;bc1pu5kmruzg0gvnz4qz2dtan8efz0p0x6d9dg25ud3pg6kywa9vazes7jfyu0;2735185;3;8648065;5912880
6184;bc1qj2hegr796ac3xzuynysv5r8tpmfqn5a509uv26;66134;63;2125225;2059091
6185;bc1qmn73nactlm3t479cj5hqm9wfyym5z75jlz9lnv;74438;1;74438;0
6186;bc1peevquj82u6d8yvyfjrd6dhtr8dfcv63aur5rxgsks473gms5qznqr0uc3k;78198;1;78198;0
6187;bc1pxckad644l7ly8xa0r7sqpqptt36lqkdhgfuq2h7sm3qwn6vvfa4scz4hfy;71004;1;71004;0
6188;bc1p0f6g5tve48tnah2fjtzkv5rz982try9jxwmr2val28tjn77sargqzakvnr;1800252;1037;154891971;153091719
6189;bc1pdu44f43palneyxqupdnqwxyrppwyma03crtahwcrewtw5rv89h9qyju5ww;71649;1;71649;0
6190;bc1pcqms2fr4ytkjda0svyrn56h0glpzq64mflerae9ku38rjluxusxqa954sh;9821184;292;9821184;0
6191;bc1ppgu70dg6t86xs8n2s5t98h937da8pmy9ft2lnwg5mn8dejllw37qffhyfk;9896240;270;9896240;0
6192;bc1papsfxdan5vanxv24xjl6cmqdrmak2vma3fafr73kkn46xkr2kc2s8mfmft;0;16;4007190;4007190
6193;bc1pcwdkusufs0t7pp4n2wfh8y2kkar8tcpp60zs8t02p05uxc5lypqsdggmgp;68514;1;68514;0
6194;bc1pmstzrex4syyrtq9axvmlllvau80uc9rugwx0dnz88physurnyfqqeml3gm;69849;1;69849;0
6195;bc1pt4ewfdw45ewjj5dn8x6pc68lw2e2gkjkxylycjlf9saj0sn5lc2sfjmt3z;66894;1;66894;0
6196;bc1p6wa9ef6jmwx2mppdu87ldrp9xv63e6q9k2y6v82265hyl6sdfs0qzlrktd;9984104;278;9984104;0
6197;bc1pm8hf7h9tdqq3nc6g0vgxycpgsp3ksk3dzkq667q35m6ye4wfe2ms7rsvlf;66817;1;66817;0
6198;bc1pd3c6c6purcyztxetfcuws8t7qnvnn2csqzyv64ydtrcue9asjg0qxk77gp;12069856;279;12069856;0
6199;bc1psqp5g784lydn3lj4tk47ckjlgsyl7ph0t7h87acqdu0ud4zr22uq3lnaye;179042;1;179042;0
6200;bc1phwv2dx28medh7lrcgukkm8r55r00mrgc22uj2eshyrs72nexq9cqzxp4y7;11340312;300;11340312;0
6201;bc1qdjqns38red8q9wjzg9nhth64n8hwr52rvvan89;1267213;1;1267213;0
6202;bc1pj29rfayj3xwfvj0fqpx2nzdzjxm9d2zx2az53rjfltmwwt7kvqpssvd4qy;70731;1;70731;0
6203;bc1ph77lxfpfnfs3qfrk4frd40lzam3cef0tlnw3w668vt6x4xm66exqckpu5v;0;20;6351111;6351111
6204;13BPKchRG958U4HEZB5whgLis6VogNxv3H;119173;7;395308;276135
6205;bc1p48g83mlhhuk0gxyy56jvmt6mau9qrznnuwfg32gtmnkqdh69g3nsrh8829;177842;1;177842;0
6206;bc1p7gevkc0pszl9avv5gumr3a4yvgnaywc6qmnj22hmwm48mfql70rqhahdrg;166851;42;387662;220811
6207;bc1ph62ak3uajchuqks5dq0x4pvyn6hlllwxt3w5h7wqsej6cp4jjfqq5j7hp8;0;2;53296;53296
6208;3NbEpMwj32NKUAojJiDx66yMqWaa2N9hLh;37878418;4;79378418;41500000
6209;bc1pqgv9x3afvu9djptt4wumaj3yp80r40kg928z2993w0xjynw7t3fqc4gr73;0;2;53296;53296
6210;bc1ptk0pq5luh0u75d0n92xjrv8c4jetsq5thqvney5nqfa78zwmfr2q6ztj0j;0;2;53296;53296
6211;bc1ph6p02yqg923n4grck5zmmztuwpmuss3zj0qt6gcmzrwkd3d87kxqqfye5f;0;10;1468161;1468161
6212;bc1pr97zkce538rlndv04ztu37chredugg3nc95xka3kyrlg8g4h0ngqc04hvy;67743;97;270546;202803
6213;bc1pumpt6uplc5xlz23f5d7r4yzd60wxhc8gkvlme8f0z8zy5aedw5dq9ghfxv;1638;3;1638;0
6214;bc1py4dp4cj9g45tfyecjxnkmvflp25dylv2a0zmk9s4grckktnv6t4qgf89de;0;2;53296;53296
6215;bc1ptxpzc979g7u6s2l5dx4t9r7wv6ls4jvtxtfacr37gzatrjgcr5ps27gqw4;814137;231;1003681;189544
6216;35Pwtd6KjonAQ72haQzyrAirjcdyWND4uA;158678;5;783678;625000
6217;bc1pzz2tp4c7jc42dq66atcunc650smxzt9s4z2zw80dapcj7awkg8tqqvzz88;0;2;53296;53296
6218;bc1pwjna8h2epv73aa4atmqfztm9mj25f957vdemprn7ezukygwcrz3sm5xk49;10239560;283;10239560;0
6219;bc1pyu6axa07smcuhyp4zzseljhfeuxuulfcfchannfsxh7tvs8w7m5sv8fv09;1654746;217;1654746;0
6220;3JtdaoV5SaCvEkQXfMrxS9UdNJgZd3gq94;288729;238;98405300;98116571
6221;bc1p6l6kh36mwal955kf2mcfu69l9wm8zl8gthhrp62wr9jr92dgenuqzw0kvw;0;2;53296;53296
6222;bc1p97tzhadxh5ns7k3jldk5lq7auuhlxnp90rrt84xqwcq2qyal3s7sfjy2uc;12405416;298;12405416;0
6223;bc1pc905fksgr62chrlwq24yrvrqeemxnf6nyr5tqwy7m3n05z58h3ysjx4sex;0;3;108592;108592
6224;35gcd2UYpUKtV1hQTjjHFRiy426Wnxo65e;106046;38;7375138;7269092
6225;bc1pdhs20zh06gwusyza8n4eplhm25xag9qv7c522rkuuufcwjnp0kesjnc77k;0;2;53296;53296
6226;3PSb7zwnno3a93zpHdfwhPH74JD8GgBmjt;76064;34;20078855;20002791
6227;bc1pc2f987p2kkym4uvhleg46y35kmpgd3k9ulhu0g6c66s6avsvzpdsvd3dd9;0;2;53296;53296
6228;bc1pgrgjyvtp0nwx76zky0prthh3evfc6qcvxudakwhncxx84cccv4kszg89l5;458970;441;180494152;180035182
6229;bc1p9z0gfnuzdd0nlg2nr3fff49x84vdzmmp4hlj9u3x3m27y0peuersg3yn2v;3276;4;3276;0
6230;bc1quzx23l29prh7dcvtse98zx53ntk9lmhsqgqr86;236112;21;236112;0
6231;bc1pjkk0x3j3kclp00pj3wrtlf9mkg3fdy87rla962c0m0tjcxp6j6ys25dhvq;1584383;347;70976031;69391648
6232;bc1pksnt6ukdnt7snsfqs6xuflw55cdks455ytgc5y97pj3rwsg3l4rs7gq3kp;0;2;36046;36046
6233;bc1pjfm5d7hapzz2yprdec04fze0wnfmkv5p800d0hvj3j6flvwunc5q8tvaqj;0;2;1727000;1727000
6234;bc1psp4fyjd0ezkfy3k98ut996pqeqprxl3h6q4q99mgjhv6emjxru5q6ndget;0;2;98000;98000
6235;bc1qzrqd700a77wp97p27am4st2p33klfjnjupzm48;27796679;49;202302803;174506124
6236;bc1p0jwes5wjuucwreccql93c0x8ytjlxj0f76le5378kz9rlfscay3qezqpxf;0;2;53296;53296
6237;bc1pse8ugn3ns6f2t2w0dls8at7fymdmtnnj0x0mcesfv7j8csm98mfs5tv8dr;588853;241;730549;141696
6238;bc1pz8rmhptj4nyk76q6cxmwem5qqr504xm4hxvsw73a7xm3pe0ytrys3lg59z;0;2;53296;53296
6239;bc1prpmdtdjyu3ul6k2nsfc52ee9frk72z8f7jcfelkpsx34xt2rtc6q8rqc8h;0;2;53296;53296
6240;bc1pt8nqp3tv05pwafchethz46gpz9af2h4zz67f6qd5v58n8yufxxhqfx0wsd;11466;21;11466;0
6241;bc1pgxpxlmwydcef0g8p2nerzdp234xsr27x94d7axthxtryx8y8n3qs7pcq5t;49052;13;23610481;23561429
6242;bc1pq5cdelywqzfq09dqkzt0dlgkfg8y9cxu738aylzrjhv07afkyyks58925r;0;10;1475514;1475514
6243;bc1prjf5zdu7ngenj4nykqf97l5xl5epwqv3kz79eynphs9sprvu69aslzjr5p;0;2;53296;53296
6244;35RSCsUTfwd82X5uCRpsn5Gi2SgKdt6kFR;3220163;12;20793488;17573325
6245;bc1pwdnevwga4s5e3yz5vgfka0sxk64me7l9u9fqgj4scdkapjenv76splawuq;0;2;53296;53296
6246;bc1pj668n0aqwg5kl75ntp7mxrudes2qfzpdj9wk8lfcpdvjrrzefkkselgm4g;188945;6;1986238;1797293
6247;bc1q6tdsmwpejd3wanjv00ukhr228z500x33kfnpnhahcc83h9ughpeqsg09nz;19381415;1;19381415;0
6248;3LoJQBWAtujfbkMNqwNqGX2Csp5iuVdaku;36408;2;186408;150000
6249;bc1pwky326kl4j0tujydr7r6rpqdrd5p6sraktk50628ye6nlgu3ck2sdktzns;0;2;53296;53296
6250;bc1p8gt6ut3x2y4yxun3u3lvmwx7c2lt5ysr036lkjthsskwp437g8mqu07ta3;1092;2;1092;0
6251;bc1p5xaza5flspe6scya5tkdd4ucyy8llgmf6h8apqk8p03nemcvfc6qcyvqge;664642;904;51138017;50473375
6252;bc1pzt9j0nmhsuwn3dufpzh0lptqz9pyquardu0ku9jh90e575d02gmswkn4n5;0;2;53296;53296
6253;bc1q4f7vt394hugt7d8jmfl64cvftjkplzqafq8sc0lc56xgzz82qqysqsyynv;1901738;1;1901738;0
6254;bc1p8r06k36e8eyd4edw0gpyhv7rfvxetwn6gescezggr00wkzgppjuqjqc7qe;0;2;53296;53296
6255;bc1p0lyc3n8jvdzm7395wjzkctjjpfv9uvpx27zghn3l34d35ym36x2q9eq6g3;0;16;4007190;4007190
6256;bc1q2qcms0l2r5nsrwk83mz7e22hswkpnllwpwfte7;4335499;39;353407847;349072348
6257;bc1pv2t9qzpumv4tgzrgvfd5llyh38wpn648xhv52wts63dm2lzjkvrs637zz6;0;2;53296;53296
6258;3FVx5mW56TuBVvuXeZzWYRxPLmbLZowpCv;28792813;348;1532944173;1504151360
6259;bc1pmvcvkt9ueynq2q3wte83xsnm9qlttcg35nklhgzfmjx54yy00rvqw47ltv;0;16;4007190;4007190
6260;bc1p6vhe2fc7hf7527mmtmcsetwl5mssjzqn8f6qukt23cz92l2jh02shzkc9k;2184;2;2184;0
6261;bc1pu9neqm6ytp2at42k60urwkxg2l8f7muytwzujn0nfn6xkyvw7ljq7z764g;0;2;117000;117000
6262;bc1pymr2nrtmpz2lkatyw5za75ulx3vpdnayugaxjx2nuz20ef7gfznssyje72;11601488;300;11601488;0
6263;bc1pxdvskku529ddlml2accq6m36xtu7ruzm6c0xu6zz3quk2wgrmwxqlj0dq7;0;2;53296;53296
6264;bc1pv3y2gz47c6fe62zx0jref4fjtae3xhygrwn5zxftxvlvvc9uvrlspqazwe;327500;1;327500;0
6265;bc1pnj7a88gw7z5d6ju7l3vts0qwxkuqxfjcnjx7qwyhj5vuej9djg3qcqhv63;0;2;53296;53296
6266;bc1p9269xk3udxfwh5e4zqgxvvj2cdwflxvlemc06tk4777lw4mmceusspvgev;3013213;3;6622076;3608863
6267;bc1pxey2ddu6rwz8k632g698rmrpsqzf4z294jse0q50wxap6zs0welqvq0xkn;31998;64;50242;18244
6268;bc1pemf3d95q3hygzj35hnjvyv922sltnjawjhpw88d4p8d9vy8wwntsvz0g99;1594205;612;172623790;171029585
6269;bc1p8hk92ye9efx9nkek0se8k59vjyre0lukwyzeghu7kc08pxu3y48qm8q28v;0;16;4007190;4007190
6270;bc1pcdqck47p3npt86yjw27pxe8n9dz4pfw6hftwwnjj0trw5u2av97sdxmm9n;2909540;43;6409540;3500000
6271;bc1q80g8wsrtmxaerzrt4dulqtrvecncjnk7adl8l8;91053;29;91053;0
6272;bc1qj2hegr796ac3xzuynysv5r8tpmfqn5a509uv26;68318;65;2127409;2059091
6273;bc1pljjj84xsa0y4uryvp09qmzjr785hcee0tekm3xcnv382dzqnh3es32ys5j;0;2;53296;53296
6274;37TnEiwhB1TMuBH7CTTytarW8iuuKzF98V;251435;280;201233243;200981808
6275;bc1pjn5u6whlt8kleh5dwz3jg487kkytwjesep4htuj8h6yf6vu68hfq62etqs;1626182;8;6574182;4948000
6276;bc1pn9exvrz4kw7jdr6vtqehwt3pktgfqyqyfdxwy6jcc95rh7tfvrys2026e5;229073;12;4095084;3866011
6277;bc1pl35wn7k578zg55exz799m6v6pnu563wg34t7yg7jsnmxpmvw5fdscdsmvu;11083312;270;11083312;0
6278;bc1pvl5h8ruff3g0qn3fv6j0dwvswejchk3w7qewmg9fhx6xau5tc2qszdr3dh;0;2;53296;53296
6279;bc1pu7r3ewsc9n4zqhejy75sycnlvf8qx840stxx9cw8ks3pajz3ae2s7zpduw;19500;1;19500;0
6280;bc1p6wa9ef6jmwx2mppdu87ldrp9xv63e6q9k2y6v82265hyl6sdfs0qzlrktd;10049592;282;10049592;0
6281;bc1qgq4xwka6ma3gtyg6qutnvth9u3pxh2lggvqdjx;113662;1;113662;0
6282;bc1pn2qdnppxwpma0u0qpcra2wjut0792hvrhqrjfngsqvc4jsxnttfs5ff4kk;0;2;32796;32796
6283;bc1pkq9scu83zs2szf7t0c2ch3f6ydzwhfkysjh5hrrvmt8h4rc9u4nqexckec;0;2;53296;53296
6284;bc1pfykaamezgcc89kj938r8u35atpx4as52r7s2mwu5mqkr0q37ljjsrtzez3;0;2;53296;53296
6285;bc1qgspp9du5exj39q9qqt2r0ll7khcg6ge9l8kuf09xwsamxrqd35hsj7f9zp;1565801;1;1565801;0
6286;bc1pqgmp5pfq4gzrlskkg68605d44lunpf5kq9mjzrhytjegedygdttqkxlmqp;0;2;53296;53296
6287;bc1q2czwty72f6wqc2h5a9c0k9mhas5rdn9x4g5m08;98721;33;98721;0
6288;bc1passchjsmnynvw9jx4fckqmnaqwq44wjnkusmhg84lpgy5mlmdc5suf4dpy;0;8;906822;906822
6289;bc1q0fffz65r7ydax97umxc7vtx7kc9a2t3cexn0cj;102368;1;102368;0
6290;bc1qckn4crm58se9mhct7ed3l2s7dvav0ww5dk6786;118560;1;118560;0
6291;bc1q7cyrfmck2ffu2ud3rn5l5a8yv6f0chkp0zpemf;116858595928;1816735;1702516430425043;1702399571829115
6292;bc1pezj5ll34r0pngukmlknsmw08w4k93mdeuj8t372vru9c320mc78s72us3j;1092;2;1092;0
6293;bc1pyt3h0sx8p88n3dkt5w9pfra256wkv7j3c0j4nkvsgpw9yhf3hp7spc0z2p;13512;1;13512;0
6294;bc1qrtw6uwn5dgyypz6ytncf4ya4azlrrvrtawpay3;30000000;1;30000000;0
6295;bc1pgy2uvvrm6z27czsef3gu23254fx6u8edt6p2l36u86fa06k70knqc4qr5q;1435880;3;4463274;3027394
6296;34u1tMHZtUdTHyreWzxCZBxWRK8pryEwjB;13632849;578;494439058;480806209
6297;bc1ql9uwxfv5s7hqfdpqg4ep4y7kd0d2n250a29k3d;1293010;1;1293010;0
6298;bc1pjfwprqgr429xy0jgzm36wuz3m3z4jy0k9rgw3yhthva70sulgccsa0rkh4;1953960;75;1953960;0
6299;bc1ptxpzc979g7u6s2l5dx4t9r7wv6ls4jvtxtfacr37gzatrjgcr5ps27gqw4;814137;231;1003681;189544
6300;3PtrHnC8kGFscNejhtzT4LHsx1wqS2deD2;177848;10;3014593;2836745
6301;bc1pvprh8xf9emm56qs962wqsyg03v4ymajwsemkt9r3eda3u4jm8f0qmjyeyy;6612017;199;112588313;105976296
6302;bc1pnxfn4tu0vp9ue2f37htctkukm7mkp2erl0wvvd9pt8r6zefn2pxqhup2lv;1924466;8;7536878;5612412
6303;bc1p3m9vcmavpg6dce44uu2hef249en55fq4vk9udrfrv45lavs6yfvqja334w;10000;1;10000;0
6304;bc1pwjna8h2epv73aa4atmqfztm9mj25f957vdemprn7ezukygwcrz3sm5xk49;2481704;71;2481704;0
6305;bc1pchuythg9ssq0m0ky6yl97r560np6c8gmkpvrmhtd09r9f5y20flq345jt4;341973;10;5511763;5169790
6306;bc1pu5e7w2jy8pf0zgs6dhd27q6r4znrje3ewhgp9ug2uarqvm2asvzqsat5mx;0;2;135000;135000
6307;bc1p6huz7s38tve2mcagt8kq84zjawvgg32w59ncwvjpzwclz5wk9qrq2g7awc;0;5;310236;310236
6308;bc1qlzdswzqyhu0zgh3d3k8mtw7cxyzju6nc40t53f;17200;10;17200;0
6309;3HUSyoz1fwdZLAf7ZWzjHdycLYqExi9f6f;329179;4;894830;565651
6310;bc1p63gqwpyrwh74w4avnrmfltrjug02kltrqf4m4hchmm3gmxtvz0rqmpljcs;694503;156;78996143;78301640
6311;bc1pv25sdgrutfalxtstwh7ez5tsaepzaycejwrmhpaaq3gh923tvn4sm3jhpq;317145;10;5143776;4826631
6312;bc1quh9jm6p06nqnvgvvv733pl0g0y6ycxl0aas2t4;8505467;7502;695540515;687035048
6313;39xxV4Q3PXLaSkjFkT1CPboQmkn5ayqA1y;1107145;25;10745465;9638320
6314;bc1pm4ghddckx7d4cqm228nksn43xy8wjngfm44qrjrrsrd49e46mlwqcc87n3;0;2;79000;79000
6315;bc1pr4d86gflrf5qdy0xuck7r3p5969xjnzjux5qgwydr525uva5dwkqlgcrzl;390536690;7850;1026203465;635666775
6316;3KQTjX6CnxW3fkUbcoWMTH67gHScFGxRmP;1187297;5;2511348;1324051
6317;bc1pm66lhhjmnzlhahtc9jcgeuuj8xegqm4s6j296zzhuwhcfe45wznsfprm2d;793118;1;793118;0
6318;1EJeUVkpRJLD2J5JCFcf12TeUPXAPMVSHc;111670200;1;111670200;0
6319;bc1pv8nn0kvzh8cpcz30yrxns77r504xe9fyqnmtes2p7hjcdxq5jv0q3lr9l4;1638;3;1638;0
6320;bc1qvs2hts5u0mk06ayecd3m85ps5w5emuxtlxeg9x;46004819;9566;104437167;58432348
6321;3P6Sd9aMez8LJM41mCz3nd7frdWBHQRosU;9342318;6;40862792;31520474
6322;bc1qnh3wuxlz0mzunqlse9dhpwlumf3rh2g3rrxz3d;850473;9;3391058;2540585
6323;bc1pklxlryuznxt6g6z3pd6sknutn3vjuzawu2x7zd3rwzxz868af98qa0tul9;546;1;546;0
6324;bc1pk757kv72ep42c24lf7qapcx6ff49m55cg8plwg3jnk36q7h7zlqqah56ya;60437111;225;605188628;544751517
6325;3JezBRyF2fQKSDY3QjkKaXGYaxjnyEugvd;86088;3;401346;315258
6326;bc1pdfz0fs7hjn0rlwj6well6sq8a20368vj4l4cq0vz7udp6cz6ntxql3037p;760392;1;760392;0
6327;bc1p5dsrfx4kkergwl9q5phvt2a5srsqdqk5yk4qx7vsk2n6y6j3j2kq60kfef;1422;4;1752;330
6328;bc1pcsp7e3lfp5k9a5cexy25s5eu9660my9g8m3ucvy8u4ukc94d88cskadkam;1448201;551;127628794;126180593
6329;bc1prt7496v8z5ughflrl44gnudfscydeys2r24zv8q6jvu2gusrjwaqmy3vk3;14245827;170;100317816;86071989
6330;35WSU7q9uRRpZ5gyZzAEekmJJYNevdqfx5;584640;42;48540542;47955902
6331;3QXRfzCPruHxBPfJBjuztjUSmoLcHVJzks;469529;10;19743263;19273734
6332;bc1pmmt4ydtdh45wucheywc5twyxxwg0ugke92x8000pgw4g9s3d9f9s8jectd;551501;1;551501;0
6333;bc1pkyjzkru5w60mm0jv8xy03p426tg2eq0jgrwpe36wqv7h7fuexjxqvpjk7v;0;20;5427084;5427084
6334;167FqoNpd4P939RNYLvXfAU1t8XvgEjWLV;10000000;1;10000000;0
6335;bc1qz735zj4ry6usazdtqknqufs2r6tnze6d3t7qus;817555;9;3338347;2520792
6336;bc1q2qmm3l58wn2k5fl5u5phk0mphl8ntrhgh7j5jh;218268;5;2245610;2027342
6337;bc1qv7q4k8hffjqk8xxw2fy3cnth7n2c9txw0vug579hk3tru64xf0nqn7g3h3;840000;1;840000;0
6338;bc1pzmspqs3qspnp5cpxlqrxzv64gsu9tduznnf26kukje8sfuuuxfusrh0u7s;0;2;32425;32425
6339;bc1qvt8vqv4jnh7yuxh6ksvj67sj2v9upgdxusd4g8;50000;1;50000;0
6340;bc1pwfjra6vkyd509e370kdfqcd8jhze4cpt47pxlcqwv3wyhvmgldaqadrq7g;2184;2;2184;0
6341;bc1pmcj6va6g324dhkgsmzy6xgzzrc8y5rc7ydz7k4eywch5leuqck2ql0sy7q;0;2;28926;28926
6342;bc1ppl3crucs0endw6ur3cfaaw7tdscr4m3zjmpc027w2nezcupd4wks8tqrjk;279992;282;690757;410765
6343;bc1ph8lwwz2m0eh2jg7ry4092ntdhatsj7u5hkc8pntdgaz4qdnuee0qq8g2f8;0;10;1372572;1372572
6344;bc1pyx26x92ty4dfw25pnckm0xq7hsqxx69yrpx9jqjeshza6l4ph2jsu7hlmn;81358;80;155705;74347
6345;bc1qz2u5n9wner8f8clg6lalztev8uzkq890df9t08;3033;3;3033;0
6346;bc1qpygjveuvywr78gdl7u6fmqxry3qcy2esehwcqh;69865460;1;69865460;0
6347;bc1qe0tljjny8nysh2rrw04n90j3ezh67hju6xzl4f;323434;4;2469972;2146538
6348;13JDD9J9C41kyhN5XyW3Lu6dzrihtfgMKe;2716685;1;2716685;0
6349;bc1p2qut9qe22xg20sr0x6t8cnf2n07ala9g54mhlcnqn8hgvgshtwasf4vswk;1092;2;1092;0
6350;bc1p3rn7l3hkyjdhp2htwc8f4ns65d6ls4erjphu2s4asmuuqhgx4q2q7un4nr;0;2;28281;28281
6351;bc1qfswj94yecaskhk7894dpt7tujnykr70rcldm64;68594;29;68594;0
6352;bc1pu0t2npvqfcedxr6mzgqvpygxa9gd8jdwyqag3pqeudkrxrvvpzesj4ryvz;1092;2;1092;0
6353;bc1p2cqnpz6sjt7yqknwh2d8tjlm0mumnvs0k0zm0azzpu9ywvycpdaqd0x3hf;509922;192;678098;168176
6354;bc1qp08tq73cge20vrnk9cydhlgcwuuaalm6dsjdcg;1124010;4;5378608;4254598
6355;bc1p8vqkc3a3wgldsch4z0p92we0yu7lhaya6htcjaynfh9dgt0palvqqxgv5e;0;10;1269630;1269630
6356;bc1p5tzk87ffwe2pr5tedq5lddtcjqp3789xzx6gzq53l3spfj8w30cqvqney4;0;2;189000;189000
6357;bc1pek5dcf3ptrkcm6fauaql5nrvkv2he8aa8u2flej6hu6y7f6jpe9skj89u5;0;2;28281;28281
6358;bc1phpprua9v6sucaru4dfwd4gey4aspml9vsns5r6m2pg4qurgmk8jqs0czjk;3276;6;3276;0
6359;bc1p5tvnkqgga89s7jz0pgqy2stnvgg3lqrhct3v4dx28cxm9rjx9f2scf5cdz;1638;25;66006;64368
6360;3KKmJ2SkruaM5eo3spKHoJpnu8o29p41gM;1472294;3;3800794;2328500
6361;3PMXXY6EcwfJTJp9np8whwQZsFsDR3WxeF;5059376;1;5059376;0
6362;bc1p8epdphk2ywk4ax7qnwq7zvtvauh8lx85v479jqgum23ds2tn3nkse4ptue;0;4;195783;195783
6363;39C71LTX8BhHT3yGCXKjzvosnkwqi4Lj1u;824040;99;3198403843;3197579803
6364;bc1pg0p8fqmpzpalyhz49sswqpekqztxvxn02j3v6nlcwd29dwk5lsxqwytttu;1876782;10;11169175;9292393
6365;bc1pkcy88m9xsxjqjml0wwypcnqsfqtfkf6u59z629m6lj4l03g0guxqmc05j5;5460;5;5460;0
6366;bc1pcqms2fr4ytkjda0svyrn56h0glpzq64mflerae9ku38rjluxusxqa954sh;2354872;81;2354872;0
6367;bc1pnagrdssrej2s29zxgd7peue43aszvl4kms82gvtqmz4l5h0qv5fqwqg6pd;6552;6;6552;0
6368;bc1ppgu70dg6t86xs8n2s5t98h937da8pmy9ft2lnwg5mn8dejllw37qffhyfk;1881656;61;1881656;0
6369;bc1p40jhhf0rfdx8w00kx64093wg3hh650qhn8tky2htl9lr44vma0xsguml5f;10000;1;10000;0
6370;bc1pl35wn7k578zg55exz799m6v6pnu563wg34t7yg7jsnmxpmvw5fdscdsmvu;1350240;64;1350240;0
6371;bc1p0h4y875mnxpqm5vntq0uj3wlmypvqrfn73ulf2w8fjd973lwm27s9u35xm;1122923;163;89863562;88740639
6372;bc1pp9n09sttzf9wqedycq0wpu5625c5rl3wavx5t9vvfm43377hwc9ss6dggs;0;5;345840;345840
6373;bc1p0ck5ltswsmznjy6fh5av7s3kw0f53z67799cpvgar57qxyflazjq3z0pu5;0;5;310236;310236
6374;bc1qn6adp9j6kq2sssvgtpc68y3ml840hs9rhqmkj4;15664;1;15664;0
6375;bc1p2jyvn99xmd0vmtn6n902napu9k6n0663yl25e36g8fyjnmstjvaqam62nf;1606527;244;56001350;54394823
6376;bc1phrnqhz0nrqla9r5wx0s5vytktdsp7x63zhvdwanfk0lgdud8y3ss64gshx;0;20;5427084;5427084
6377;bc1p493gfwaapvch6k6u8t8p88r2xfergk5mq48fk7j6ter8vk6m7qlsvv49q8;0;4;385127;385127
6378;bc1pd3c6c6purcyztxetfcuws8t7qnvnn2csqzyv64ydtrcue9asjg0qxk77gp;1450200;55;1450200;0
6379;bc1pfe2e482ugzwm3vzfz2mchnntu20adgcpf3m8l8rltadqyspnp00sf5a05h;21926;163;276204;254278
6380;bc1phwv2dx28medh7lrcgukkm8r55r00mrgc22uj2eshyrs72nexq9cqzxp4y7;3364968;78;3364968;0
6381;3L9K6XYP2QnsSz9GocmGUkv41YEietCUsg;1470879;3;3797766;2326887
6382;bc1p0jtlem9g3wan4l3enawmypr332vskxuqkvv44mxja34x62s9evnqed7dpk;420543;53;47298581;46878038
6383;bc1qh9qke6lkr30wypk5aq8p2njd4f5ve66rwrkpyg;118560;1;118560;0
6384;bc1phkw60c76mz77mya6am8mshv5xkar7n2q2sv73eydte5k0gtm6pnq5pvmts;0;2;32425;32425
6385;bc1pvwar22nnnys3e0stq9hztufzjfxzcrg0qhxc7s7a0es7al6sa8mqv6ukuh;41945326;35946;4462742313;4420796987
6386;bc1passchjsmnynvw9jx4fckqmnaqwq44wjnkusmhg84lpgy5mlmdc5suf4dpy;0;8;906822;906822
6387;3AAdqw1QHz5BPBY17V3EnLxRhTkvQbYhV5;1185726;263;94680438;93494712
6388;bc1pgg9hyt2dmture3tge33me5z4du5h7qwamq2rpp0ej83gx5wh5a6sem6kzj;0;8;771372;771372
6389;bc1pxpe34097g7pl38ruw3n0fj987rrhjvm5ulz3ltfs3vn5cd7z7s9q3epte0;128654;2;292654;164000
6390;bc1pqasxrv3g4w3xanc8xnss974n0rhl949twjn56tgufkdgq7f069uqp9wvsx;134654;2;304654;170000
6391;bc1pmpqj5rjzpyke7w79ayqxfm270vvx69awwdzyx8q0gdjhyyze2jxsdpang3;134654;2;304654;170000
6392;bc1pw6g4wa68jmydkpcdcxql99r4re070tnsgd4v2yq52y85t3mheaaq4kv9yq;128654;2;292654;164000
6393;bc1pclle3as30y97leczr956m2zkywc069j7cgfzvgcm02y43afmhq0q4ay2lm;134654;2;304654;170000
6394;bc1p0cngj94jpjqw4858ee25n6kjdesd7sv8v53yvxemch84jyvlayas7u06sg;134654;2;304654;170000
6395;bc1pyk8arpkh368hfk48s34q6wg0cguzmqnefp4tj76z98deqksdycfs59gej2;128654;2;292654;164000
6396;bc1paa7ywz5l9an5usl5uhyqdtu35gxnpt95yuqkkj4cc0369e0ezxqs8fxerw;55310;169;184897;129587
6397;bc1p97pvmm2p7muhxf2umcpqncm4lf87eyawvm0990zkxttuv0jdzs7qvwtm3x;128654;2;292654;164000
6398;bc1pquq7s35anzs6aftp4qyke6cxqszn3r7wr297sq35msu60nz90n0qd3cex0;128654;2;292654;164000
6399;bc1p5sksuup9zrgxgs80fp8v5je5jtyglch585u327mwtvs3ayyk958qlv9eyg;134654;2;304654;170000
6400;bc1pwww563a30hyfs0j5hkj206jp0w3d69lw0m7hg8xhky4r2a79e7nssuqfrr;128654;2;292654;164000
6401;bc1paraug9adp20zycc6qmawtclzmufk6tvxw4z9ufv0scmescrm7yrqc992q9;128654;2;292654;164000
6402;bc1pf3xetz8h2n8qtet43q9ld5xh94at0s23jaa506fal9vyshenxq7s2j07wh;134654;2;304654;170000
6403;bc1pau3cj84y9e0ehgf84wqd3p8rduhwsjwhxvftdddaxf5h4zn6xffsss29x4;0;2;1218000;1218000
6404;bc1pphhvzfytstfus00kzmx5u5nfu9n5l7aye8afxukgrgv5v32k8rwq4qukq0;0;2;39000;39000
6405;3MWFXKUWGdSJEfQJSGmg2J9Jrk28RnUaqJ;7286037;185;350361892;343075855
6406;bc1p3grvtjsnspenqz6w8fzxtlqx9hxay6r96p6zh9kp63464fywgpgssg73dc;130654;2;296654;166000
6407;bc1psny36un9en3sjkkz6f638t27sl3tpw6rfsk0h7e3yewquq7am0wsdez2zf;128654;2;292654;164000
6408;bc1p6k0pxtvs3sumjm34e58seyzvgthvflcanfvfjmeghna46p7vg4wqmt3myv;134654;2;304654;170000
6409;bc1qlzdswzqyhu0zgh3d3k8mtw7cxyzju6nc40t53f;31200;17;31200;0
6410;bc1php5694e6r8kx9detk2h6d9j4vgy33u8ypdey7l2dtw5qs6h6e2qq3z5u43;134654;2;304654;170000
6411;bc1p97tzhadxh5ns7k3jldk5lq7auuhlxnp90rrt84xqwcq2qyal3s7sfjy2uc;12444296;299;12444296;0
6412;bc1quv2akhmsl6ye9khqk8j08as3vc4h0t35l4yx56;290627;38;290627;0
6413;bc1p5thl80kpa9kssdsupjte2tj2cqdl57nh5mzra8rt9f232vap2tysmh6fpd;124958;25;124958;0
6414;bc1p504qhnzgp6xhgn4zetgpn3azcgy4kw887sg6ajqtsfeey243vy2qjf47h9;128654;2;292654;164000
6415;bc1qw8s8py943fm26h4ddeh0dnhg52ump5ral7am04;3430310;5748;650309655;646879345
6416;bc1pfays0qxjnk7dpew72z3qmq3sauk9ty943c6mmpx00wraqw4yftvs3ul0rc;134654;2;304654;170000
6417;bc1pv6v7ch744zua2zv7w94lyh2qhu4naftnyfjq2f8h3t36tr0v6trq5kzft4;128654;2;292654;164000
6418;bc1q0s472fhuavjzv7t7v0s088h9u4mwrlxuy069wa;232890;25;232890;0
6419;bc1pt35m2czfh8w408r7z7naye09law2tanrdsj7pfnt8csw99usxlps0kjtqd;128654;2;292654;164000
6420;bc1ppe2emgtw9qkvhwhk27s05hzf7dvnalgv6vck5p4nvkfuylvdcx5s2qxy3p;134654;2;304654;170000
6421;bc1p3kruhksgld403nws57j42y657q50f8aqjnppe7gd60fvqhq63m9qsns03t;128654;2;292654;164000
6422;bc1p5lwq8qryy9hawpml267ns0zedsy8xxd5utn77k5l8klnp68ereeq79l026;128654;2;292654;164000
6423;bc1quh9jm6p06nqnvgvvv733pl0g0y6ycxl0aas2t4;8601723;7549;695636771;687035048
6424;bc1pe7h8uw5drgd794y4wyaum879tgtlh68uuep3muv50luvjl38p53sla89nc;134654;2;304654;170000
6425;bc1pt7yxrqp7qe8l9yswe2hfsqprmsvp3lwqk4jn0my5emx9n57m7llsxk3nmr;134654;2;304654;170000
6426;bc1px0hhnwxhuk8s7htxy73vzsayl9fuj49tjjzwrxmqwrwhddcplcpss2ej6d;177055926;265;2998102783;2821046857
6427;bc1p3y79kmh5alzalp58gd246eg5t8hcyszm2u0xn6jv8kglp5sx7u5qazegcs;134654;2;304654;170000
6428;bc1pww7vwcae2439y464jhjw6kw0un8sjgswh4dnty4886mhe9yvkkzssftshv;134654;2;304654;170000
6429;bc1qvs2hts5u0mk06ayecd3m85ps5w5emuxtlxeg9x;46055947;9580;104488295;58432348
6430;bc1pzammut6pnxc8eay4g8vjp7yqgcqfctyt2wfp7rj3tfmfw7ysjtxqa0a8hc;128654;2;292654;164000
6431;bc1p0h5h54geft3smz7hszyd8fx97dtzwqspm688sal4xke86g8swmwqka2592;130654;2;296654;166000
6432;bc1ps8z08nkj69qaqqjfzr5gr0sd5ty3n3w8cytwv6f4kuy3c96k9h7s8t9rwn;0;2;176320;176320
6433;bc1p8vgukm0wcu66kv4v6hul7ve8vvhxjph7589fs7twmfmqhr55xmtqsd7py9;1121087;88;61369170;60248083
6434;bc1pz399rtzss3cdwg9hfmuylrhsuvxgz3ucefxqcfq0e4rjexzvpqrsj23tah;128654;2;292654;164000
6435;bc1p8kle4jg4gz094qn32mwgm2gshey5xdc6cwhgk8qr6vqky36u9h8qu6l8yg;134654;2;304654;170000
6436;bc1pl00z8r7575lkw59w452tmk0fkzdsd9n3j4qf72cu6wd68zl639wsecknp4;128654;2;292654;164000
6437;bc1pz04ykf056jn0wyva886w98u5gk33482zy4rvru3fa7y03mww0l0qwxmvhm;134654;2;304654;170000
6438;bc1py6lluka939lrcgc3ycx3v5h45uyemhdgfmvk3eazs5us2atp7ges2wel64;134654;2;304654;170000
6439;bc1p46sqf5v93cmxktrkensvwp0ew8f9n97vglnh07tmjfjcskvjaufsnf5x9f;134654;2;304654;170000
6440;bc1paeh7552ezr6ye635wlg4skzxndg4jvnhuat8z0ju8l2hmj0k2tcqfv52n5;134654;2;304654;170000
6441;bc1pwg253xzer3j5cekvgvdyjw8gn058gmn4uwmzh2xk6ryej2a33ekqjas798;706612;4;1898024;1191412
6442;bc1ptvvg0rgcw9akeaax95e08c54n7xk8s5364an8h8046vap5d742vqplt64g;134654;2;304654;170000
6443;bc1pjvn9wrqgd0gj56p7psmywkmn8ynzt52djj2fy55wag4uzqtt39fqm9sxhr;128654;2;292654;164000
6444;bc1pvsx40vt6cz98uzh7g4wwdgquaf33n04nsk0yueehgmq08zvju2jq2gh06j;128654;2;292654;164000
6445;bc1pm62ls6axqq0me9ks7a3dk9sx75adkhz4jpqrj0acla4696jggq9qhaj79k;128654;2;292654;164000
6446;bc1pwhfhcmv9f9pk7hyarmgjqeeruc3m60n3xcu2nse32yfysz3jl6lschxjeh;134654;2;304654;170000
6447;bc1p5eg0wenp2pn6z7jpulv7e035dc8kkytn97k4j8gwgknp2mcvh87qhfjm4a;134654;2;304654;170000
6448;bc1pc48rgjqlzrwqq74pvlkap8td7xc5d9289paxxwap7s4vyzvn9wjqtx8nvz;128654;2;292654;164000
6449;bc1pwj4zlqacshgp29m0qz50rdxr70hkkwth4sy0ymqwvafk0a0qxscqmsu5vn;71601;12;1633207;1561606
6450;bc1pfqmdfnpgn55u4hwdygqfczdrumnyr9kzvte033m0avhlj9kkeewqtjj9n7;120431;172;207143;86712
6451;bc1phcugew249pf3unkz66najemrwremq8r2dhhg06fx5hxqkuaer9dq58ql9l;128654;2;292654;164000
6452;bc1puh8zgu3t9hpwd3spsradwsuu9nnw3xhvc66xp79938570ywl5ajs56x9vs;128654;2;292654;164000
6453;bc1pk67xx60p4ww4405eucwd2yesvfkzhsenqv682mr8qvyreavn328qa4968t;134654;2;304654;170000
6454;bc1pdtaycqtxyv2fm4ye477jdq9wmqeeguatfgy4a5avvk37qyk4wq3s0p3v84;134654;2;304654;170000
6455;bc1pen7y54llt603snlu7uarezrylvrn9dprym230r0jtpn6rxknj4jqq8e4dj;128654;2;292654;164000
6456;bc1p9zulwu8u95dmcmmnm3le4l0tnwj9ldktcva3k23xfd73eg7m4kcspy7uf3;2909052;211;327591235;324682183
6457;bc1p6laj07y845ry4p6nl2ru2asj2deg3e9enp9524tnu8l2e078p2xs2sefyp;134654;2;304654;170000
6458;bc1pr2kvx2dmhe8zp22tfcljmd8t2w45dse09crczhjrrv2uv5jn9heq8jj5ae;134654;2;304654;170000
6459;bc1qw38ddz97wyzp9lqm6p93yne4ehr7xcs8qhur09;1247496;1;1247496;0
6460;bc1pkekyadwwf0cmz2kt80qhrqkfa8p39r05m7swrkv4u0yuy5hlrz6qccrykv;128654;2;292654;164000
6461;bc1prd4zrud95razm73zl9jgz6h58avxpkumf00cpaafws60wvsc426q7hxtj2;134654;2;304654;170000
6462;bc1peeesd5uyj4m3tlqpq5sg865mzfl3exvn43wuhaz4djcxzhzkm89qd8srx8;128654;2;292654;164000
6463;bc1p9hz2wdgy6wsnk5jq2jacndtu6khp69ecd8mykpfav0hdh7jt7r4qs2ynzd;134654;2;304654;170000
6464;bc1pa93z67whn06jt8tn7hxvsr3uwa007mjpm7yjyk86f7auw7z5lacq5hywnu;0;2;27378;27378
6465;bc1pjp3f2jm56ws24773h0gjtqld74utshdlfwvhw5grddw6sshcg75qjrdyw2;128654;2;292654;164000
6466;bc1p6cey7778gtqqwsy2qz3fc8nr06ayjg5cj8dcahqymyml84pjjphqsr70jq;134654;2;304654;170000
6467;bc1pv6zdk6q67068tskcwx6lg8a7qhpdlcpdxm95epy9qpm39tvthx7s09ks4a;128654;2;292654;164000
6468;bc1p8hux85vlgl8qaa9zrk7u430suavcurzzpw7wtjnarv9yr933sh7s339mfl;128654;2;292654;164000
6469;bc1puxqask8fsex4mr6tr9vgprupnl3qn805svd30crzg8k03rsjq33s5fwrma;134654;2;304654;170000
6470;bc1p0xvlvrsqqrcj8u9492z8wpwkprtlf5e9zv7zklt6s44zxtrrhh5sdrzcgm;25110;12;30670;5560
6471;35dh7kGbAVPfd4ZcrARnDrs7ZuNZpjJJoc;177269;53;59730155;59552886
6472;bc1p58gyl68u9kzqpweawezrm34jz68632f0aqy4ptuvr9xxxn82g0ms4qjy62;134654;2;304654;170000
6473;bc1qsscx7qhgf9gwksje0zltgyrw3ztvfl9x6zj6m2;49864246;9703;111111134;61246888
6474;bc1pkhtgg0qlu746n3ec5fvpqfdsuu5a9jq6myhakkzyr5y2azs5jtdqvwzdr9;534763;9;2907760;2372997
6475;bc1q7uy5ps8ty8wdzdeh6gn4lw3957l800yjv2acy6;137230;33;137230;0
6476;bc1qwrtry4d3fatr44l4qxjvs6rh4j8ehumzg8cp0q;51960766;9423;116836989;64876223
6477;bc1psjeefsjryqjyjaevvehfnglrxx6gsrjaevalrqzk3av6frmdpwhsnqv2u6;128654;2;292654;164000
6478;bc1pnzqg8q5vhhk5r5aekwnalrysq49ajkm8zqgudsqtk4syacvxamzqfz7cv6;0;3;117706;117706
6479;bc1psv5nz6v4v0apmh9p74u5txkr2uwc8wyx4z04fu75fgg6sc7l4ppqsq87v6;72901;194;1475323;1402422
6480;bc1pp60lu98sjhdl2sdtazsgh4uzchn04ttvvd6d2axjd6gr692kcw6sp08wc5;1804777;1528;692964726;691159949
6481;bc1ptfjnj8cjf3sgnqm7ktmtk5jlrrhlp5nd5urs57yeyhflge2yl72q6wn45x;0;2;39000;39000
6482;bc1p20z2p5cz8vkqm0vptyakysdtrv8d76qxkh9ddwmr9leqvw53qf9sztsjd5;134654;2;304654;170000
6483;bc1pv8ygafva9zczsz54v3c9eyqx70p8jm0ssl584h95yywf4rrqdh6s6hx6qh;128654;2;292654;164000
6484;bc1psykedqszunltggx5pl9jpkfcachkv5e9ps6afes67gl57800nkjsvx8wdu;128654;2;292654;164000
6485;bc1p5jdla935jcsw0muc4dssgfagfl2ush3mkyckxx2sllhdf9ukz22qtkyjs0;128654;2;292654;164000
6486;bc1pr7ugcmacpf9thp86zdalyt6pghrpns3mvscaa2ja66625jpq6vuqkwgzpw;134654;2;304654;170000
6487;bc1pg0p8fqmpzpalyhz49sswqpekqztxvxn02j3v6nlcwd29dwk5lsxqwytttu;1876782;10;11169175;9292393
6488;bc1q94uzkzy34uwql4tcg7zx457jj8cjwepk2eu6tr;31536;1;31536;0
6489;3PKpuT2B7vve7LN7aNF88tS5C3LnJhQ4FT;284091;160;69984593;69700502
6490;bc1p9ql4hp2uc5pe03ryrst2heza6jt6rj9q4kk6vpzgltat7feeekcq80jsys;128654;2;292654;164000
6491;bc1ppz8ech4j8rje95q7jf43pvyn7rfpenf2jwaqy3v9wsewwnx8ta8qlj3lka;134654;2;304654;170000
6492;bc1pygyhw5xaj9ypjjv6py5gux64rwtk7x3602rpgey96dsd592ptjjsu2x063;134654;2;304654;170000
6493;bc1pkskuc5q5wypl8xaneplm4pretk58ddd4w04umjug5uffh4p7qhcq0pf4mm;128654;2;292654;164000
6494;bc1p5p395xlh68hucg6jqujc366tu73zvhyxzztwyyjgvfgm9yyl233qcnzc6m;134654;2;304654;170000
6495;bc1pl35wn7k578zg55exz799m6v6pnu563wg34t7yg7jsnmxpmvw5fdscdsmvu;11202112;277;11202112;0
6496;bc1p9g3r0gy32wv9wxa6z4xpszy53lw5z0qpns6cz2ess4ltw79e0mmqj27qsu;134654;2;304654;170000
6497;bc1pgtq6sqqrcz7yfh0g75s4a5teuauclu44n8tjufswje3rwrpf3gesj27t60;134654;2;304654;170000
6498;bc1puzhq3flrt9zdy2k2xdrmszhwyy3fxkev76tdrjx0x8cff7v9fkjsd2jvnj;128654;2;292654;164000
6499;bc1p569ca48apj466uplxpq8768y0qw0vw70ugjfwc336h6fm7cg3nrqm8p26e;128654;2;292654;164000
6500;bc1plslqsn5cewrjdzl958th8ryrg6np6gz05tqgn0nsyhryr6rm5z0s35x6yt;134654;2;304654;170000
6501;bc1ph9rugcmm3zhvcvdr44gj57d6z6ktl72fkjcyudf3cs8m23u44kcq52eys5;128654;2;292654;164000
6502;bc1p2jyvn99xmd0vmtn6n902napu9k6n0663yl25e36g8fyjnmstjvaqam62nf;1606527;244;56001350;54394823
6503;bc1pryxdxy7322v0uwnp40s2q2f9um8aca57c6crrxf8wyh5jngeh5xsxaykwf;128654;2;292654;164000
6504;bc1pneh6eq9f5hpqm2vrdzp6q4spsrhjhwykfm6vk9xtf9sxd8w4f9ns8x5097;956490;4;3306949;2350459
6505;bc1pvkn685use697whgw9zqkyk3p2f4wqkfuyz4vmmjd0yc86l94dwfsxxlpxc;128654;2;292654;164000
6506;bc1ppdw7tze2lel4xp6z9ssp3aeq7nllf84u3jk6d6msysp3y8rshm5slqj3mh;128654;2;292654;164000
6507;bc1pt5hcajt97l75j9lrs293kycd3g30lewgujde2ylrcetg052am9aqhrg85l;134654;2;304654;170000
6508;bc1p9dtg45kd3sjf4rq4tsvp8q6q0q3j2xyyn9vzsuje5ctpedx4funqv7jeya;128654;2;292654;164000
6509;bc1puz8gd6dr87lpathtcuju3xeklr38mcl0aapdnlj2mwpc7ukmy4uqv05z60;976490;2;1996490;1020000
6510;bc1py5dl9myxkjqpkk89x8yuty0v5ylfqfel95m4mvhdzulwr7wlsy7qycwuqn;0;2;63225;63225
6511;bc1p6xzrafgl6ux97peg3t9sm4hu6n530hg9zd595w7ve63l7jpd0vcquk2xa7;128654;2;292654;164000
6512;bc1p6amjdwdpt583xamkzyelpk90pmvkhstve3zn2kccyge3hp9vexnq4lvg84;134654;2;304654;170000
6513;bc1pfczz8p7gy2dylh6qywhkwqkyw5d5njgqxft8spq7t585wgrtv7vq269ptx;128654;2;292654;164000
6514;bc1p40382zw7aqnvexmnmjqgj9ccv7hnhgm3mmhry62m93aukkt93vhqyhvnq5;128654;2;292654;164000
6515;bc1pyg8ehg6acu4a87p5nhyt9ptaqdn2lcc4dlkw49udeexc2j20g3vqd2n03c;134654;2;304654;170000
6516;bc1pdqyqp292z0kc77atdu0gvtts8w39qu6c5vvutuv9z676fz35uwlslyp9sw;263910;1;263910;0
6517;bc1qguzk63exy7h5uygg8m2tcenca094a8t464jfyvrmr0s6wkt74wls3zr5m3;285145689;898;454459689;169314000
6518;bc1prxrkn36j423tt6yqt0zq7nxf8rjp7st8l6rs32l3y69ttmph7zas0pdeen;0;7;573456;573456
6519;bc1pgg9hyt2dmture3tge33me5z4du5h7qwamq2rpp0ej83gx5wh5a6sem6kzj;0;8;771372;771372
6520;bc1pjun0hc4lw553vxmx9fnnht03udq836c8d04hrgdlcjp3lsqzg0gsjxdaxz;128654;2;292654;164000
6521;bc1presuef72crlurm26dstf8s767hw4sxjrxfhpj9wnk9gl9nlvltfqprkfjr;134654;2;304654;170000
6522;bc1ps9szmc9gdg5mjjsv4vyr5pdr8j97ws5k9rcgq6sdxyhvwqm70vwqx2takm;128654;2;292654;164000
6523;bc1pqc9k6rrlsnq6eap95dgl47x59n5d4ns64raspx3v7flvvnxszm7qtsun7d;134654;2;304654;170000
6524;bc1puf4r5qkxvywvyscd2xw8nfx7nefg42etndaysve5l6yzmcsx84lq5dntc9;128654;2;292654;164000
6525;bc1p28g3gqd8rg588adq8zvgjwe4pd0t0s74qxa454qr8vr6xp2l44usga839d;134654;2;304654;170000
6526;bc1pzv30sns80wnk2zsnfaahscvjpuegzsk4sm69c3jntc3m5npjy9jq82ylq7;128654;2;292654;164000
6527;bc1pgy6z5wmpq7kw472z2s3vwczr5ejapcyqrzwqtekgw386hfusqp2sq8c69j;128654;2;292654;164000
6528;bc1p0jv0nm23qft0fvvg0yz6yveq08asfz7sew5khruzxfz0a0e9uumsput2mk;134654;2;304654;170000
6529;bc1p60uvq0seemwklzmyjj22jxqr2hyu7qksp8t8mxqac6zn7xymk8ns7fgutx;134654;2;304654;170000
6530;bc1pea27956vtucnstcu2mdlvd7ywumk5f6l6f596a7ws4e7tr7v4yfs2kjlzw;134654;2;304654;170000
6531;bc1pjfwprqgr429xy0jgzm36wuz3m3z4jy0k9rgw3yhthva70sulgccsa0rkh4;15953456;296;15953456;0
6532;bc1p259jktps2zlpry8qmefc966v6u9mjh6mf6jknlhsf7arhuv74wzslzd9ff;134654;2;304654;170000
6533;bc1ppd7r57te7tqkxt9pm9wuhl4qc6wd90fycz58zrjpw23gkmctkmtqmqev3a;128654;2;292654;164000
6534;bc1pxfm5z9qyau38za87034wftmretqhxa8czsa2lgcj068dm9vq6phqwhavk6;128654;2;292654;164000
6535;bc1pa75mhr7mhfm4nmzhjv6244l8rervu68u6ckdzspqd5qnwkdnsrgsr7ptfe;128654;2;292654;164000
6536;bc1p6z93dyvlz8gfczfkn48npykzmfutkwpw80cp0ac2w86kr0atfz9qj83u3h;134654;2;304654;170000
6537;bc1pxul4gdskwderstxpw8gsll7jy42w3drtdzqj2wjg9csezxrxnuws9v36gd;134654;2;304654;170000
6538;bc1puccq5vudwyfxkls6jzc8hmdel2dthe5x2zuy2sgmr5wau62v7p5s2mff4l;134654;2;304654;170000
6539;bc1ptdznwvgk5u8l3tffml7y6qa44sapqsy9g5w24ghyagmx7r8lzmts3fqgre;128654;2;292654;164000
6540;bc1phhwpea5e4dsw6d78058lgplsdg0gm2wwkht2el7le9xspr4gh6xsld6g5z;128654;2;292654;164000
6541;bc1pm4tgzaxn8qhwxkutqegfr426v3ngujy24yuaqht06yyvhjzw5e6s57pj45;128654;2;292654;164000
6542;bc1pjf0e52ye3w5f4kdmgya69n96nhgfzn2wjfw5qd3uezz8tpv0exeq47rx4w;128654;2;292654;164000
6543;bc1pwzhwhvx9yavdkex3ysspqwt3l45m37h4dxqejr5dqx9rk4s3mqsqplfjx3;752109;21;10408549;9656440
6544;bc1pj0ea0u05rs34ggauhcyzyj2ndfpadaukhevg8huap7jh4umtchrq594ys2;128654;2;292654;164000
6545;bc1pcgan2m55wa0r0avn0f7j4tma40qshq2jclj6am4hnkssl6xl6pcq4l0e03;134654;2;304654;170000
6546;bc1pdvthtvsj6dd54cpfxtztkwgftl72nq69gczayjatk7ttazju9ltq70j243;128654;2;292654;164000
6547;bc1p8uw5hzfuznd4rf30w7a3820fp756jgvp5vrkfzc97y53283rpvjqah4njk;134654;2;304654;170000
6548;bc1px0hhnwxhuk8s7htxy73vzsayl9fuj49tjjzwrxmqwrwhddcplcpss2ej6d;177055926;265;2998102783;2821046857
6549;bc1p744sd6x4pdjc7ns5t6ms6dvssm9f0q3n844cq9j396uju6368vssm94chr;128654;2;292654;164000
6550;bc1pur8c79k9gc7d9meu0ncnrqte6337vha57nttwlgnfhgakfzx8vwsn0d00m;134654;2;304654;170000
6551;bc1pjeaz50kgegrszwq2eeyc56gdmrmew0t72sgtk4k2mzjhwpmgfe8qqheayt;134654;2;304654;170000
6552;bc1p8dlr8vejytj6fpprhyg65g86f69u0ejpj76tlwrqcutj4gw5r3fqdhj553;128654;2;292654;164000
6553;bc1p5tlaa6lq6sklwww5jqeczxx3e3m4y3vu7hkmg58mpp6z0zdkq90s0d47qr;134654;2;304654;170000
6554;bc1pzmg3ggdmtz0ek8fxg74hc036xup8a0cqkmmzsemwa78ufa3rhkgqef4fcl;134654;2;304654;170000
6555;bc1p3jqgcksa66du6yfkhx9r7hfr043tcq0r26jhm9pr37xhvrlayahqqnxf3v;134654;2;304654;170000
6556;bc1phnuu4ueyl9csyu9ahhmq85u3cmr6pq9nd5pn5wpy9k677jaq259q4e6rjr;134654;2;304654;170000
6557;bc1p7xytzswnep9c0jk6wy4pxyzhcrau7fgwrp6ctc04zf69mqe8kn4sx7c7lc;128654;2;292654;164000
6558;bc1pqlmv4xv08mykzjzdjjt5rd5dk5cqukun0dz7v4ja90pclf9lgw8q5tqcd5;134654;2;304654;170000
6559;bc1p4334ce2rvw9434c8ynq2nlxdk53prwv25qpzgcdrfqhejjg2hz2qs39mwf;134654;2;304654;170000
6560;bc1pjv256qjfclnz24tyfq79nuskyun9w9kun7cldgy35mzaws8m8c0smnr6d3;128654;2;292654;164000
6561;bc1p7cf67ddsj4g0x9wuz37p09w8fvd7mqfznmnrmdt7w6637fqdzwfqwryqp2;134654;2;304654;170000
6562;bc1pkhf0xcyts6mgwn3gdps0ud0avslpnts3kf334p8ssqz93q2tprzqj2ujnc;128654;2;292654;164000
6563;bc1pptskc9ndt2zae40xm0vdf6pnnhmuad684sfalt0qqxv6wsp3h6ds5leynd;134654;2;304654;170000
6564;bc1ptgxedty869ya8nxxgsg2hntpjk8jkc5nns7w0wvn3f47c6uhlsaqx0adct;134654;2;304654;170000
6565;bc1prn33vz9nd8hawsl8lee7wdl9ca3wypmkh3hp4ky2k2xfx6c22k8qtt367l;128654;2;292654;164000
6566;bc1p3xgupgv9y0vaezllwnejl2k303pk2yhwphygvq2287522t2ytj3ql8hlty;134654;2;304654;170000
6567;bc1p22rhd8de0kaltea29r6a0accawlhkydx0tgfh4flmqu9t544khnq0rm0u5;134654;2;304654;170000
6568;bc1pn5rz70xfqew7q8mrqkg75efzdl7fpsjrh7n2h7kux3mfnqrzj3xsa04hc9;134654;2;304654;170000
6569;bc1pfvuj5a8540vq4e4g56hjhq4aua5px83hacau456yvacc4dcwt7zqd0jl9y;128654;2;292654;164000
6570;bc1pu09phhx47pmuvexc5kd2zq7c49v2zvwhgkw5w3cyvqrd6cykttqsf4gqea;128654;2;292654;164000
6571;bc1pqnqyjetdp2ggt99phc75ywcsfnnye35sm2eywfauu2p0jfqlnhtstcf8h0;128654;2;292654;164000
6572;bc1pc0qanzsysvaxqvexzs5w6q66ttq2r8pe5xk5z3hnaf0kte0u4fyqezej37;134654;2;304654;170000
6573;bc1pc0l7ajq7qwt7gqwh08943d2exvx373crwhmkgyf6ajwjcayy6ffss2rhw9;128654;2;292654;164000
6574;bc1p97wtzltz6u0mqkekwprnvs5vxlsjah6d2990xelae7pkfkm450kqurp3k6;134654;2;304654;170000
6575;bc1pcujvval6ze2w580trmslljucqfgpej4jjpddnpcdy97axmlt064syaj89n;134654;2;304654;170000
6576;bc1pheqpu7yemkaauh2p8n4n7zq8tqnerduzkng770tg55hpe5mjg4aszswaaa;128654;2;292654;164000
6577;bc1pcn5ynv2mlhfhaetfgdw0a2h6hlrtwe9p9rw8kpncahpl8dums4jsvtfsjr;0;20;5012865;5012865
6578;bc1pc643ly2qhkveyjk6gwgt2vkckngzz38f4xe27qx9ypg2hyr2mjxq3f4pcf;128654;2;292654;164000
6579;bc1pht7g84cj2z3gevya078whd0ashcxfnjvxrp63689m9a3qvlyy5wq9cwxte;128654;2;292654;164000
6580;bc1pwfcxw6rh6g5xu66lxpktlu2vsappprrx2ggfspgplrw9gqvc475szxsgrm;134654;2;304654;170000
6581;bc1ptvfekf3kd8c2qxttv5uhfh9268l30pd6ccqttkpudfy8x4mrnz9q2xd9mm;134654;2;304654;170000
6582;bc1pzvcfsvcxjkq87g8svn7ttm8ejtr42p8uar0fl6dyrcjghtw64yqqnzlvve;128654;2;292654;164000
6583;bc1pn4fq4yle6cl035urme8x2l8lelhy3aumzks8tvghs90cnn43c8uq8gn286;134654;2;304654;170000
6584;bc1pa39s587ly3kfpcnc7rhymwx66equual2nz5aay2lhxlj9zuz889qwr8w08;134654;2;304654;170000
6585;bc1p58eveztuuyfm9u8suzghehurslqx9t5wlvpljqza90hxmar5v5lsrzm7zr;134654;2;304654;170000
6586;bc1pvt3c7s3ades44t3rtcfe5e45duy38ngsua3lk5pfey5wsdr9t4pszq5qkr;128654;2;292654;164000
6587;bc1pu6ahg2p9t7e7aqsrz3ldw9c5dke9fdptnvn8afpgdtz8f3hxjz8qcfcw0f;128654;2;292654;164000
6588;bc1p34ss6t4t0s7msf30xp8f9hpa2cvam6ujx68f4r4e7ey2sejtn4gs26c6gx;128654;2;292654;164000
6589;bc1pwrr5zeth55tjd3fl7a6k66tawkppj86uyra9qnk4ws3xuu2f6xush2k3yn;134654;2;304654;170000
6590;bc1pya89hcmtnr5vnxhtl5va9n72ltqyka6rh0hypgkrqak3tjde7ewqvh37c9;128654;2;292654;164000
6591;bc1p7gfvxwcx46v9r7a07cn8fm2mkd6mrgs6qxzz8z8xeyds4x6zlfgq38684z;128654;2;292654;164000
6592;bc1pmhwy44v5xssya9cz5wdxg36c5e8948jaxw5zvx59wfst03cejvdqrxeewe;134654;2;304654;170000
6593;bc1pwd383x20ke3d2h3983jewy7nyufxpksgsqa2fhkpqwesem03an8snpl8yv;134654;2;304654;170000
6594;bc1p948n8p08acejmmqqtwhyu7hpqw7lmazr5rqhqnz7p8033uas8nms26etrj;128654;2;292654;164000
6595;bc1p79r7x24unnd737fxc5yfuteykcm46vanjs9gcjuv88amw9j4jd6s4qdmm8;134654;2;304654;170000
6596;bc1phhcup7hdwcj0jkmhlrntn7cfrualjjcmg5hg5dhqq4s06jyw2q8svcn43y;134654;2;304654;170000
6597;bc1pazdkp8rumcda4vpqe9kky5s5mpl65kyjre07mvrrkc49wagvt29scrgzqx;128654;2;292654;164000
6598;bc1ps0zdyt06zpd3qscmz6f9l2c58aeh068tus72tmp4p53vxphd9essmkk5g2;128654;2;292654;164000
6599;bc1pl2w9nzxzty9qmk54z8n3m6hhjz954xqymn2f8uw7drcyhnu0cagq5sqr97;128654;2;292654;164000
6600;bc1pjwn920vt8e5yf3fe42gx9tqqcw3xhx5lvgkx4l6mury5w7yjxscqj8ccmu;134654;2;304654;170000
6601;bc1pvu0spnd85e4z9wwatdkntglxnx64xz4krvcefcce2w2snmuzup2qa3ddp2;134654;2;304654;170000
6602;bc1pkt5f5n0s38s0lpcppktmux549tsg5tth2mgqcf233yk5dtt5nnasflp6aj;134654;2;304654;170000
6603;bc1pjmxkqw7kky3xx0lfwr477y0j3y03494knu4q2xetfg6zgn6wsv0s56phcu;134654;2;304654;170000
6604;bc1pkv4mu5dueerpclv8jv502vjms0yujngwty3vkslxwwvhc3pxaj0sc094k5;128654;2;292654;164000
6605;bc1pqtghhw5l0u6j33gyxyuuwuwn2awu26uv0yn6n2z9fw7hrhrxt4ksp0pnfk;128654;2;292654;164000
6606;bc1phj3pjc3nfljt4dwr3zu2pr45lc7swq3aj42shavd3g38usx7ucmsw92yle;134654;2;304654;170000
6607;bc1puar3xknknhc3tlstdwsu8en7xyg53j2vj05mzhxvdf6yh0jnkntqe2n7uj;134654;2;304654;170000
6608;bc1ph0m66585j8txtvja3t0ppzsj68d43e853kf858qf3ms3ltqdh7fsqrwttl;128654;2;292654;164000
6609;bc1pf8qz9qn2vj2zdmjxgzsa2aalfp2mgyfaqxwgrxv7f7fh2y7drhuqedwp79;134654;2;304654;170000
6610;bc1pzfsvqr7wp205c3luzj9w6hn5xkutqmd357fvvc7x7lmm3jscj32qvp7608;128654;2;292654;164000
6611;bc1p3vra48xgh59gx7jj3g00u0jhdaf62a9vkjxu6aydt0czgc4gcxuqhyjkjy;0;20;5012865;5012865
6612;bc1pwxvtex5laa9p2nduxhxwqnvwpa0gts90s2s4xevyqn4e3c7lz67q6yuswp;134654;2;304654;170000
6613;bc1pl35wn7k578zg55exz799m6v6pnu563wg34t7yg7jsnmxpmvw5fdscdsmvu;11073248;266;11073248;0
6614;bc1pf5wwx64xgeef52he3tcss5jfn602plxdszuaz72g66dunk8nzkrsp349fp;128654;2;292654;164000
6615;bc1p85dycgxu7wek7s5vduhckcppuex90vzem9t9yyj4ccf2e4cal0fs5q0qzz;134654;2;304654;170000
6616;bc1pyge7vsyg2exehl8tazz3mdksw9d6dp63uw2kwrnwuad6j3yq0vys6ndtrg;134654;2;304654;170000
6617;bc1p809gj0unrg6vxevzyzn3qg8j9z2klu4sz6ldav5qye3226gtexgq4f2upe;134654;2;304654;170000
6618;bc1pq0tg7347nqy9qqskpwczx4genxwdx6yg4wyvs4ds5936dqcrgfhsvfs6qa;134654;2;304654;170000
6619;bc1pu0upwqjffvrfrsqvvs0j5lvhues3c7jrxfenwz50z9fqx9e7pexs8qldqh;128654;2;292654;164000
6620;bc1p267tpw0zvmzzzd4dx300gpmj5gsj6htd5z78ecfgv8k7armp35ysuz670l;134654;2;304654;170000
6621;bc1pgv7ruqx362vxj6za7a7p7tlgp3z6j4uzwppc7s3alct6n5eduf5qzmnqhv;128654;2;292654;164000
6622;bc1pmhkhxjf5r5kw60q68gjj4t6nhqgjrn7aw63r58hcy8t29ny84urqjllhxt;134654;2;304654;170000
6623;bc1pnv28afmfnjf8j443ge2v84rqg3qgmsj6qa5nsgj5xz80f47zgneqsprx3f;134654;2;304654;170000
6624;bc1pytrumckgc2gcf40mr2ulx542kj98mx8k3hfjghs2y39hyrjzd8fsja3qp5;134654;2;304654;170000
6625;bc1ppekrcqp7fry8wm0r230hhqcw25z7sggjlvffjdmauj04hw8h079qhlkmff;128654;2;292654;164000
6626;bc1p9gwcut3wu6xkj9mqhr26knf7vz427f8dg7armunk8qmq5uyt483qt9j5lq;128654;2;292654;164000
6627;bc1ppck8mfr7jn673p67gj82lau6g3ear9lhhf78r36haq6577ny767s0qmryt;128654;2;292654;164000
6628;bc1p2c3lwxhg5efwt0vs9f50500ucypen8fyhuwen5pvxxr60fk836ssdjuv2s;134654;2;304654;170000
6629;bc1pvpsvc7lj5fzyzn0ppuujplayp5xlydv8y60hew272xld7tctsdfsggwye2;128654;2;292654;164000
6630;bc1ppdlm8vpd56pkz2lfq3ys88xt75clt68xcajtj7rkl7zfrn0ffk8scejavl;128654;2;292654;164000
6631;bc1pzwvjn2efwlkj9gtethw6nzu4p8ytl2mswxkgl536fnukctpux9ss4nh4ax;128654;2;292654;164000
6632;bc1pgn8ddz2j7slnm8777frvm47yjge9kh4tuhjqxd3z7zzkcr3p8vrsshwtkp;128654;2;292654;164000
6633;bc1pqpma68rkf3aan2su66d798ee86glu4qmua9d2y45ll6yyl27x56s2kqc95;134654;2;304654;170000
6634;bc1pq8c2kskflcrqksteqg90aus9h4kqluhvwertfxxwhqudgvr44s5snnhrfw;128654;2;292654;164000
6635;bc1p9zd9y929zxfk29dzu38l4vh9wrerhgq4lzkl9vkwmyzjm69pv4nsgcxkst;134654;2;304654;170000
6636;bc1p3863tkta53uw7wpcpf4aex3lpcj8jgvl4efhdnu00hd9q80rwfdqy70tk4;128654;2;292654;164000
6637;bc1phzppklf276pytrc8gdtyfgeprhj9hc7cxqhm8ksytf2mnzdv2eqsuzf7p2;128654;2;292654;164000
6638;bc1pltman9ytg7yum0aje46plvc7rxzmfsaug07x2jth9z5exvyjdwjqe0wp43;6000000;2;6000000;0
6639;bc1qm9ve5ugrdplmmv4y4lv7la3sw0emq9d8lu7f74;524103;496;233530703;233006600
6640;bc1p5ft6xp5zc3r04vxcwwastuwn7mf2ecjzsz8g4c052hy98sfyc2aql6r3fx;459719;88;41533028;41073309
6641;bc1qt04zjxguycpydffg6pmm6gnx3s6jv46zn0nn7h;97285;24;97285;0
6642;bc1pc6wfyhxmnefjhrc5ycxrdp8ql50ekqy2lpz85zycp55qz92q64rq7n74f9;370901;109;28221628;27850727
6643;bc1p5p3u3ugp9ymzt6hxw7z6r9zmm0t26xwegm4p3rhgezw5ms57m03sl4t3j6;0;2;34145;34145
6644;3Qg9RHKBJvr46EJpY4WeWz4o6dfYP9XDbP;3158219;397;1134527951;1131369732
6645;bc1p5fl4uq265sn47usdg823qp3wh9yyw6t9xmnfmglu50yfgj738jaq2gp4da;6969;1;6969;0
6646;bc1pcqn5fyd3l9z3tcuxag4zga9ql8q75hhe0at8nm4tpmkmzhe8jc9s4wy0qf;2090;22;3654131;3652041
6647;bc1pjfwprqgr429xy0jgzm36wuz3m3z4jy0k9rgw3yhthva70sulgccsa0rkh4;19685128;400;19685128;0
6648;3JDDBB986tgUZTjk3xSGmVdZ7nF4Kzy5BN;103911;176;96394724;96290813
6649;bc1pcwsfasdzmtejz222dwqfqf7nkcn5tq5u9p2wjkm5q5uepr3j5vxqe76sau;0;2;28946;28946
6650;3DbmKPj8ZgPohWjuxhDwmetzdGpsGqprvm;10000000;1;10000000;0
6651;bc1qkqscfxrtdg4ts94gv2tq5fsvdlcnxpcq3ggfph;3934889;12;10147203;6212314
6652;bc1pt4zkc4m2ammtyg649nz0nc4nxfudenens7pcnjae5ylju8pe4k6qha7qlq;47692;1;47692;0
6653;bc1qxf29f8lppvvak7x0l25vpffktgj32tmfg83ryz;2000;15;3673505;3671505
6654;3QcL3kqf3ynYDDq9bkTMS74pskW969RXZR;9452629;3;23868809;14416180
6655;bc1p9tc4xv2l0zhjzk2q7nw7rq5n5vp4rsnz43k3003f9h8dq6tjg9estaqqnw;10000;1;10000;0
6656;bc1p8n45s93p2dp7kd9m9zjwuaudq22nmxtm55uuvwalt7ge4ylfjssqjpwexe;5842663;19;44968304;39125641
6657;bc1q6lly8nnrqz9kckx6k9p4v5ghdj2s50yyahk546;1271850;1;1271850;0
6658;bc1pjkk0x3j3kclp00pj3wrtlf9mkg3fdy87rla962c0m0tjcxp6j6ys25dhvq;1584383;347;70976031;69391648
6659;bc1pr4d86gflrf5qdy0xuck7r3p5969xjnzjux5qgwydr525uva5dwkqlgcrzl;390702602;7857;1026369377;635666775
6660;16JYgssvbeRhR4hqMm5YkfV1E9NNwmypWt;2950000;2;5950000;3000000
6661;bc1p87z84qulhw9wfxzu69mxskt8hepr6feycwwkh9aa2zywf58jx4cs8r2tl2;546;3;18546;18000
6662;bc1qvs2hts5u0mk06ayecd3m85ps5w5emuxtlxeg9x;46059945;9582;104492293;58432348
6663;bc1p642z0vzqps5f6d0qm65dk4zcsnrd24r6gfhp3av6nwksalxfytksjccapu;39287524;276;78183727;38896203
6664;bc1plazw3mzfpyy98vezn3h7kvaqmlsev8jdgalnwdtctxepxgjs9a9sdwv7zv;4914;6;4914;0
6665;3LbcCc7UVdq4UEYmnEhaCy9XbWWe9yb74b;18840801;1;18840801;0
6666;bc1qfnmynfsce7hq87esy2rt8l3k7c7hrk28s9zshq;33427;1;33427;0
6667;3PV5JsnoiAWrgvhF3eFGCCMwoeFKDczpYr;75027;184;107864083;107789056
6668;bc1pfrnljmmh4tfgruvnzn4yar47p9sdn5mr48suc5uucvm9439ulrusvffuqc;206284;265;33671593;33465309
6669;bc1qkzk8mj0aentuufs4x46qlxq4m7l4v78emmh58m;1532419;187;266651150;265118731
6670;bc1pafcx867ke9heu0y54n228rs4g9aekp4wahpq7nqueuyj4cqydl0qutamw3;10000;1;10000;0
6671;bc1pwt8gpyf0yrj8qcap7fd0sedal798updwxm4fatlj0s4nh9x92r9q7sxjaj;457594;10;1941884;1484290
6672;bc1pt8nqp3tv05pwafchethz46gpz9af2h4zz67f6qd5v58n8yufxxhqfx0wsd;12012;22;12012;0
6673;bc1pkytd2pnt9xhwna3dcu7aaa8kjxnjcqfn67ln2q6y90r86czge9mqnadgas;47292;1;47292;0
6674;bc1pdgrawjy0uszxejjhq97h5jgxhep3uldgljzvvf33npes0wt8xq8s7f6pl6;936240;17;3640658;2704418
6675;bc1p0t0htg7g8rvwx8vr5jq49vclnvudk7t5e7za4hedlxtlvcvcvdss7qe8d5;269954;1;269954;0
6676;bc1pep37vx89c5dse0varwn2dfru5wgd5rw9fdjync3c63s59j90x3ms0vk6f9;2397340;1;2397340;0
6677;344eHFhuDrZhsMej18J72qzQqgCW4dtYn7;1231298;22;39691517;38460219
6678;bc1qgsxudtepp2tlk00qzrxvvv7cnhs9crvcjg2p5u;59195;21;59195;0
6679;bc1p0ykx0dru9337d4lqlj2fwlqllttfzph9q84pzaule2a7z9s0c54qj7u7l7;0;2;282746;282746
6680;bc1ps5hnzq2d25nddp22c5xlpgxeszlv2s4czswjhetx39y3dshesxpq0keg7t;2001700;317;76215843;74214143
6681;bc1puctcy4swxvmf6x9ellv73fene279qckqsyll458nuqz9z3czm90qf73emv;357286;40;6225916;5868630
6682;bc1p3p5setr82uprwc69u4esydh6rjs5mmalr0wwlhpeju3l7u7wy9psuqkcr8;363551;320;109769386;109405835
6683;bc1q5n4n3av63keguser40cyvlayn93waq5w3p6ptp;2060719;24;15765051;13704332
6684;bc1phr63umf3xzqq6rpcyu9fe0qx2a0dd22xhgl8mh09lqgfgtrcj9wq8se9ql;8543833;18;32067428;23523595
6685;3LmsfCKeDQVak5n89cvg3y74Mk8wk8Y3NY;792848;17;19310660;18517812
6686;bc1q7yy20nukdzks3085lj2gzeync5rkfvnjvwavva;82758974;199;14453102704;14370343730
6687;bc1pyeempw875cmd3dcdsa0jkh9jjv4cud4m904tzn06922h8r5yc6zqemtvvs;538993;11;2275122;1736129
6688;bc1pxzuc39v9qgkjevezca4c092598rpfdvpfrwh9mgpr830m6hslswswfgfa5;624972;512;62688102;62063130
6689;bc1pn2qw7ewglj2kr3x7rdpjnnsc7ureluwqc4lr6646nlk0dk77qnxs6x8dxv;546;3;18546;18000
6690;bc1pcn5ynv2mlhfhaetfgdw0a2h6hlrtwe9p9rw8kpncahpl8dums4jsvtfsjr;0;20;5012865;5012865
6691;bc1pz0xl75qx7gt2wwd6sdffaymqaudwynzhpuatjterqzy4k6vt7rtqqc7d2a;0;2;39000;39000
6692;bc1q2j7qjma3h9ykyhvmkvt8mtdmpkrqqeqqjzl5pl;244356;19;1372301;1127945
6693;bc1p79zt68lwexgaewdwl6rz7qljxscdrgx3hl2u625v624x8y3evdysgt62x4;934725;17;3637628;2702903
6694;38vJ5XLP3dp8h2c5y5msT2BW8Sy1djEjVE;907700;7;907700;0
6695;bc1qam8c8ce7wkfs8ndt6vx69urlpp75yr0nsg9hlp;381012304;4840;2310219214562;2309838202258
6696;bc1p4zu2wve9a952qrr47q3j57wu79gdkj6y3yjlvhlsd0xklxzek92qljgamv;0;2;39000;39000
6697;bc1py4d4j8ltz2cyq4vgw7ym68hf23nckt02qtg6aue4qy78vtmqy5vs8ssvjq;0;2;26346;26346
6698;bc1p7n0qzv5w0hwhjk6vvl3sjx8a79wmatwtqf9tsna894yfl6gdlaesjj7r4x;93005;159;26206738;26113733
6699;bc1plpludwl8r946qfthxx7dnme6xp2797jlummmnzavw4zy0fusptsqfj8ttw;0;2;36000;36000
6700;bc1p7ksuly86z8yt5xxz2hj0csw569uqrjpwn7qdsqkdtkf3xwp6a9vq80udd0;6343292;5;31186576;24843284
6701;bc1pr27guvgj053a8zz405dty0efw52fl737fmdyz0n7rjzquhm7v02segfdhd;3276;4;3276;0
6702;bc1p8p4cs3hlz2azjnpucrt67nna6nlzfwgd33w60ryxdv2y0nhv08hsappv9f;388467;338;9357281;8968814
6703;bc1pa38urhkks9t540h4hv97latjw2tx2640ta58u6jr5gkpk57zq0jq4jx3mf;9935601;3;10935601;1000000
6704;bc1p5lny37wygvrn5xrc7xryq83gmcmrffjnj04nqkxqhxd3cjsgd42s4uq0z3;47292;1;47292;0
6705;bc1qmm2ya2vp99zl6xdjelrdykvs5ghg7trrg4ftfs;5241214;1;5241214;0
6706;bc1putjut89zsky9mjrfqzengcs2m0fv0plw6l2g208qul2jx4kat5ts8334ju;48692;1;48692;0
6707;bc1pyyqps37hhu3vq950vmsu5v28fa8t4pmh9skf73h2lstvuhq8t4ts7wjw9t;10000;1;10000;0
6708;bc1pxfr3paeaq40wwlnr0759u4hs6kugm0aky5fg7jngu09lxxur5n9s3u0d6l;1092;2;1092;0
6709;bc1p24s3wkhkmf6kfvhl05erhtxqua5qzvk06p0agh5f8rvuxm94cjnsgtj4e0;4690;14;16443;11753
6710;bc1pv9tfd3hsr4542qrnmt96uf75y288t35ekxsjs5r60xzav7zgatkse2zp46;9007100;345;1815310189;1806303089
6711;bc1plecv57pg4q5say6pz9gym9jt5ya0g37zrugr7ygp798huxqvjzmq8uzlfr;143166;32;1813843;1670677
6712;bc1qx4vujklzw24qz68dl3pcc5mdxfywm6df37s3ft;12544;14;4403856;4391312
6713;bc1pjdh3uuhvzf58pynt5g3s5n62z7wryfs2cvljcqqaqdj350mdjmfqttt8da;4078258;8;18168247;14089989
6714;bc1p6fa820fh5wkwrt2cym09r3a8rzywjsw8m9n7qcp0qay0wz43lfjqm55zz3;208182;168;19265242;19057060
6715;bc1p32nktsuffprllv0j93a2d3q33s0l6rlh598hynkgrt60lf6upqmqasw00d;155500319;8032;623521444;468021125
6716;bc1pznwxm4k8wwteq6zmej5nyymy23qemswfc2uc4qa329jfaqp7etqs3lgm5p;1092;4;19092;18000
6717;bc1ptskqautl2cv5fp5wh82qp2yc50xe6lzuzhxzwzdcd4yd3s0a3wtqelwvkx;197135;477;522225;325090
6718;bc1pen8er3fjzujs68ndev64mrqnv7mnyh50grltadqhu3ttly8w534q6y3na9;12121;1;12121;0
6719;bc1p7ud4qtdd5fyt8ckh4pehmt47g58jpcl5lhym25dg7tqcmp3jzkxq9m22k8;9245;31;17273;8028
6720;bc1pv43t7nalc7jnkx9cdenljswej95tcuu475kgj8h6h06lhlhcuykshndp0z;1270631;26;11717265;10446634
6721;bc1qlte3r0arm5j8xay68wdmsfkpt6msrvdkj5zs5u;840000;30;24876844;24036844
6722;bc1pev8kx05w9rz2230g6wmwqp5yv85ggtt6gmyhjdclawpfcqe0mg7qrnr3x4;2730;3;2730;0
6723;bc1pvvx9qxfldm0laxqg2ckvhl0rrejks058x2ptdcp2wslufv4ju5hq6hxlmt;1092;1;1092;0
6724;bc1p8jn7uydusuu3gsp2kckgwnt2d6qwx9wzaztvqkg4z96zuhsv0kmsufgmup;1092;3;11092;10000
6725;bc1qv7rv2u9tu5934qvdvqjpna5wypczv48vkhzzx7;1089522;24;10363077;9273555
6726;bc1pwsdnk4rgmk05d4mr0zd0fy8v3qpkzwk3pmgdrjeym33jcyqrhx5qxhv69p;0;2;41146;41146
6727;bc1pjn5u6whlt8kleh5dwz3jg487kkytwjesep4htuj8h6yf6vu68hfq62etqs;1626182;8;6574182;4948000
6728;bc1ptv479aznu6rhxna2qw336m5qc874jy772qy3xzk63q823ka6qwvs5786vs;8495086;6;48569989;40074903
6729;bc1ppqd3p52ngss0plhpq2mgr0ew4xr6u0z2vk6tqh6ytmr69j2h3kjqf6sfh3;14300724;93;524248161;509947437
6730;bc1qdsq9jau30l83tg6lwvw0altcf29spqw6khym2t;156286;1;156286;0
6731;bc1pw569pfkjukh4q749rreyhw5tk2gncn8pyaetlfe5x80z4ksrr9esgggj4r;10000;1;10000;0
6732;bc1pcqms2fr4ytkjda0svyrn56h0glpzq64mflerae9ku38rjluxusxqa954sh;13048888;392;13048888;0
6733;bc1pnagrdssrej2s29zxgd7peue43aszvl4kms82gvtqmz4l5h0qv5fqwqg6pd;6552;6;6552;0
6734;bc1qmpmcp48hff4gd06q7h39kg4l0txe0k8cljd6nf;17220;2;17220;0
6735;3CC1jMrVGY1dbvER45ufzQBm8ZJj7N74PG;621020;181;659906355;659285335
6736;3LGb6c9MU6nYbko98T43fAPQvNFoMuFkqU;121887;3;1709141;1587254
6737;bc1q6w5zpuy5yznlfced9m56w60tx2w69jkcvs7jt4;565023;1;565023;0
6738;bc1qfewzkmj2uryh2szjjdvtmqyedthy5pg5u7x6dk;3405142;11;5405142;2000000
6739;bc1p6wa9ef6jmwx2mppdu87ldrp9xv63e6q9k2y6v82265hyl6sdfs0qzlrktd;14784720;363;14784720;0
6740;bc1q8swfgc3m2lwwqh26dr0sp9322gzndcerrzf4u0;5277171;25;72718074;67440903
6741;bc1phwv2dx28medh7lrcgukkm8r55r00mrgc22uj2eshyrs72nexq9cqzxp4y7;14378288;391;14378288;0
6742;bc1ptq632r3p546h0eh2sadwfep4shv9gtlfmthd709yz03e3awlq37sdlgugw;10000;1;10000;0
6743;bc1pdjlxt7v4572fqkrlzdsx986l6zjtvl9s7ymazc4cv3rpxgqz3wlqhc76uz;115457673;7908;412446167;296988494
6744;bc1pvjt83qmg2mq3tj6nyxjk0pgu47fyrfny7f892kd390zxd53yngnqfa9kzq;1638;2;1638;0
6745;bc1pn3lwfnd29gdxyqlnse5p40xzzkkky9dw46232sd8xmp9lseh2ldssgnagf;169014;123;17561780;17392766
6746;bc1p3a00wrm3gumg9c04ud9kashhyutd635qjlcj2yhvcre04krsf5jsug3zfr;292223;1;292223;0
6747;bc1psttrekn895m7fv8qrcs9qps9u2um5ktdgsur94rxxklm3563fwcsp9dzkh;1279665;41;25006752;23727087
6748;bc1qjzqkvcqasgv49q35hgr6ymuaf36muv7m70hwvl;1840000;39;41758038;39918038
6749;341E7ZX3m9CN15Gh21jUWNrTpHUTj4c9Rh;462077;24;8741258;8279181
6750;bc1pq5z0hvxnewyz2kr40j4d32nx9tn0jx0vvdsvjnlckjekyhdm0j6qh7w6hf;15124913;2129;16275335;1150422
6751;bc1p60x5uvpkvpt0smufd3fjgj9f7lzjt7smu6jymkwlh0xn6yyx9alswy4ht7;5965454;4;7183454;1218000
6752;bc1pcvmqqxh9drhcn5rdlwna7zzvz6vpqqumnzjave8ln2fxyvsf7pqqqd5lqj;5965454;4;7183454;1218000
6753;351QWc5sWvCHp9My7Mv48oRFVWcoDwp1Wq;7272864;286;901712709;894439845
6754;3P4WqXDbSLRhzo2H6MT6YFbvBKBDPLbVtQ;16624524149;955159;50009635188;33385111039
6755;bc1papqkupyq5rvkfpjzjklfm24c9lwvn379c0j3pjkpe0dw7lja8ueslz37vx;591492;1;591492;0
6756;bc1ptdwdwfgxxg5yyrzjuc6xegumg2syw4s8tfjmypyt9cjaast3zqxqxvdfll;1148138;933;186584073;185435935
6757;bc1p9h9gh2tdh3rg38sflfj5e267ew5z74r3kefnpq0rx9hanprcrtdq4dm9sf;298904;84;5037275;4738371
6758;bc1pzq3zy23qxckpc9a8yk94ph5atst8rugnku9y626m68hwtgrd7xnq2cr8p3;0;2;39000;39000
6759;bc1q7cyrfmck2ffu2ud3rn5l5a8yv6f0chkp0zpemf;116844924160;1816742;1702519866173394;1702403021249234
6760;bc1pnskzd7u2p8akhh8g90zrghz20t9uwudqqrrc7quhdf4gzqtxtm0qctre69;300000;1;300000;0
6761;3HMrn5nEKYgsu2hHavbT6FgCt2dEdME4Y2;11440109;6;16469850;5029741
6762;bc1q4kzlty9uwmchaa5acvhjllutwte6efvtjer9kc;34086;2;34086;0
6763;bc1qv3yljy5wg00sew8h7nywguzm4e6vtg5dpxva94;2883529;3118;1176706078;1173822549
6764;bc1p5ft6xp5zc3r04vxcwwastuwn7mf2ecjzsz8g4c052hy98sfyc2aql6r3fx;459719;88;41533028;41073309
6765;bc1qz7dvnhfsgsx5ccxs4jzsq84lanqym02sqvc4cc;163400;1;163400;0
6766;32mxbFXiN84SqatstQBMghkDsyNQQzerf5;11061370;10;327303190;316241820
6767;bc1pxa2aejmttsqnww4etlwela79pkjgq533ecrtfqgffvjux54lz03q0x3p55;3137825;4;7431520;4293695
6768;bc1qttg889x8cwtekfsvca6ufchj9zvv69qj686jam;1106206;17;10853803;9747597
6769;3AXb5Daqvm5VHjvXNidL9k4hFwGkZX3vHK;258371;6;2709186;2450815
6770;bc1pgh6xj3yae4vpcvxjfrekalvwcesguzpkas9u3t8c472mhtlw377qmssk4z;4144480;5;5358926;1214446
6771;bc1pjfwprqgr429xy0jgzm36wuz3m3z4jy0k9rgw3yhthva70sulgccsa0rkh4;19685128;400;19685128;0
6772;1CjsXQuwoGRdr3L4U8WX37thweNce8chCS;30856790;16;436135030;405278240
6773;bc1qnl3xh8tv696yagz433y69nlazyzcxyvpph8nak;85840;23;85840;0
6774;bc1pg6vcurxyku4luyxq7lp9wrg6s3wu0sus5ejw53jedevcxhjy39vsycknrs;0;2;26217;26217
6775;bc1p2h6mpzreu5a9vfzh0zunhlvuty7mtnmv4hkrw83dw54m0rdm4plqefawns;460766;3;1562589;1101823
6776;bc1qmhlxl9fessk98scrrmylxmawky0v60e7u3a8sent5lle9uehdduqw7vhl8;21000;1;21000;0
6777;bc1p5v5mshx0eqwd792fwxpcp0yrazjd6dlm8mkwu8u9mgmt6e94a24shrp36q;2194174;1;2194174;0
6778;bc1pv2uny2qve9rpaek8sq5sezn0dumq84mg5cz6mwvvufn5m7nf84cqa4asq0;598532;3;1900609;1302077
6779;bc1qj8gw46p0u82d0eujsnmpj96ax0z3xx7unpc3mccf9pwt2pc0hn7qwgvju4;248983;1;248983;0
6780;bc1pymut28y9trrx7j02s4846nw02xtayyhw465jefu2eue2kx85t3vqpe6lsk;599201;3;1901947;1302746
6781;bc1p4gjfexxmry7ynv0u3px3d8zk4qway0wlms5nj6eedfdegmuxgp8qnf7wp8;298444;161;2729804469;2729506025
6782;bc1p0gaxcq4eyhq2efjzvfvqja5u2exz8eqfdngfqqenwzcjdxc6k8vqrl6cyy;707041;21;14616126;13909085
6783;bc1ppqe327nsc72v0ywt92f8z3m4qfrmacfpwncuhuvacf7p5l94zzvse45y2v;196407;633;35365303;35168896
6784;bc1pwjna8h2epv73aa4atmqfztm9mj25f957vdemprn7ezukygwcrz3sm5xk49;13218320;371;13218320;0
6785;bc1pj7znyqfn8y46muzn6hreezxdyw5497z5gu40lpnfujcr29dagxpqjrqp8g;75346;183;212162;136816
6786;bc1p97tzhadxh5ns7k3jldk5lq7auuhlxnp90rrt84xqwcq2qyal3s7sfjy2uc;18847616;401;18847616;0
6787;3JYxtSum8Cj2qK55p7H1AQ2UvCTLuUsGbL;1478985;3;3806964;2327979
6788;bc1psjalw5twr6ygeeqvh220rvxplhdclmjza5496ysuldpjw78q927qqer7mq;546;1;546;0
6789;bc1p63gqwpyrwh74w4avnrmfltrjug02kltrqf4m4hchmm3gmxtvz0rqmpljcs;236452;157;79164564;78928112
6790;31yTTDhvmAAharRu5WfpRBxNSGGSN265gB;10816053;5;39316053;28500000
6791;bc1pjth8dqc0z8a0jstumd0d5vna3yf9nzcfdcyjrhxlufadfrkg7j0q63558y;4044429;592;106150883;102106454
6792;bc1pesx4edkxhzscnver4eegtdfrp4fja4vqfkwrgrpgpmcn74v9pc7qc2g6up;437363;10;48640814;48203451
6793;bc1ptlye056e0pmy98v6u32cwewwhjujx37mkl2r9qp4ltj05z0m5daqu9zqae;1898985;94;13639837;11740852
6794;bc1qg3zj09mmwkaxs97tj54rfhry2cway86pguzczc;866024;9;3437807;2571783
6795;bc1pnvqr4ymna0qag85lpqg8t5m4fweg43yvmhysn7a60fx6npy50r8qsh5j0x;2184;4;2184;0
6796;bc1quh9jm6p06nqnvgvvv733pl0g0y6ycxl0aas2t4;8646779;7571;695681827;687035048
6797;bc1q3rwu6xvj4kt3en4ksyvjx7s84fwckgrngtcdfr;2073045;19;12562572;10489527
6798;36mS1y5FPmJoMWLzwB3xLE97abgBdH9ugr;300000;1;300000;0
6799;33fYeLYVhTfLwodAsBFVNYUPrFnJ3sriEQ;1093742;14;3850800;2757058
6800;bc1pr4d86gflrf5qdy0xuck7r3p5969xjnzjux5qgwydr525uva5dwkqlgcrzl;390702602;7857;1026369377;635666775
6801;bc1qsly7tuckwu88tayj79e845fh58ftxkwhlf83dc;244891;40;244891;0
6802;bc1p406u5xgfdgelf267e5w38884qzeenklku7t4akt34naq54nawqaqjnuasv;0;2;546;546
6803;bc1p642z0vzqps5f6d0qm65dk4zcsnrd24r6gfhp3av6nwksalxfytksjccapu;39287524;276;78183727;38896203
6804;bc1pl2v5vszg688v9sklpydgnkgy966jurnx9h0ezfyw2gwwnmzlqx0qfqm43u;132200;1;132200;0
6805;bc1qxxxxc50cs7tthu4t868gtmp2rk2jrr5chvvz7m;144690;4;898152;753462
6806;bc1qrg4w02ynuqv4uh0y3wfe4fqqvves72vecj97jz;36634;20;3515306;3478672
6807;bc1qtsq4ztz370nw0gvfxkllk3xur083rlmr5ey8t3;11949698;12;62273024;50323326
6808;bc1qu2zkpd06vnayksl75w8v4ecw807y4xxzjz4nkw;1672313;20;43624451;41952138
6809;bc1p9uxun8h0vgp5kz4ut29ltkuf239rzhcd9zyxnfd0vf42zkluc5js7p0xv0;5965454;4;7183454;1218000
6810;bc1pe5twm7wa4k4960d38cp9xffkzvcf0t0fj3pgtyvx36cwxwm3znzs8lftzk;69653;32;1094231;1024578
6811;35KLQQq8HuSJZaXWQiEwTT3fXeBcJVrvJP;668975;252;116693025;116024050
6812;bc1pdgrawjy0uszxejjhq97h5jgxhep3uldgljzvvf33npes0wt8xq8s7f6pl6;936240;17;3640658;2704418
6813;bc1pknpq67qsrcpccnlcm0j4ne4rxxk84drcyllp3lm2lg06z48ppr7s6delp3;307519;139;307519;0
6814;bc1pfntw2e4dpzt6j2ku8ceepfzlljsvuqxmdvgf7nqu3c2xfhprcreqhayduw;223605;27;385039;161434
6815;3HKpWeA4WDnQ447umkvg4N2NC4Ef1AUfJz;976218;49;42822118;41845900
6816;bc1puctcy4swxvmf6x9ellv73fene279qckqsyll458nuqz9z3czm90qf73emv;357286;40;6225916;5868630
6817;bc1pd2k9l9jnstr95me5rvq6lluq9s2fuwstmmv7qz7006lyelc40yssutf7er;0;2;28346;28346
6818;bc1pc3yyzx77wpnragwaa7p0wkekue8klg657t673hnh0xvgwg5xpxeqkvnezv;2840913;127;69645610;66804697
6819;3QytC7zA1qaBJGgpXFjaQPYHXgLoPKKfbg;294229;15;18956317;18662088
6820;bc1pp4fv7xwyc45p3spyaf932szqydsfkjc3ey3wxns6wusn9etylq5s2cnhsp;1556964;1192;308060193;306503229
6821;bc1p9srxdqx7u4u48ahj4s5gd3x5m932zm4fc4a4ds5ncm580nh864jqm37k26;117481962;7884;409916060;292434098
6822;bc1p9nsqg63wnmkmmgg07myhdwkhvhrt2g0rw0ty33g9tfa0p6hlqp8qlwtg4v;0;20;5012865;5012865
6823;bc1q2j7qjma3h9ykyhvmkvt8mtdmpkrqqeqqjzl5pl;244356;19;1372301;1127945
6824;bc1pgj4g3sqlpunyp6f6hrsv2cqq749hu7c7huh0ke3r2xeurr5rj7hqafwgwu;599201;3;1901947;1302746
6825;bc1p79zt68lwexgaewdwl6rz7qljxscdrgx3hl2u625v624x8y3evdysgt62x4;934725;17;3637628;2702903
6826;bc1p72qnrxmywwlmu5k7kl9zm4f07huqamaefprc44y3hhkvwghp74hsfyj8k5;5965454;4;7183454;1218000
6827;bc1qam8c8ce7wkfs8ndt6vx69urlpp75yr0nsg9hlp;381012304;4840;2310219214562;2309838202258
6828;bc1pt8rhn6dm6amwjr3tlyzllvy4gtr7uzdenwxa2q3mz54m2pzpevzqkcm58c;114048184;8073;413994556;299946372
6829;bc1pugg06yunhdu2plk6r08xawdyt50lzzzk55skc5fmlfsngemuxlgqwlz60e;566420;3;1868497;1302077
6830;bc1pqfha7hmuwcvfvdw75wnwpquyrl8q9pdwghy0pm8v2r5zhrgrczks27gpa6;0;4;155148;155148
6831;bc1pmlg27wz8sdgu3s5sef6axh8vjrghaghzetatpda29uc38lhkvs9sp083fk;96789;6;1226376;1129587
6832;bc1pu96wg8pnnyr888v4lqhe4t2rajhrhjnx9p4zff08t2wwfzhnhjgqymatsc;642306;249;51646261;51003955
6833;bc1pnddnh73kj4qkkmuztp8hkql968l8u38hq3qalgywfhqd6llsjwss5xmgpp;546;3;18546;18000
6834;bc1pqzf55mj9upv4mwhskwma8nnpdfaq4z7tqyruq9ga594c7ec40heqdefsj4;1971;4;1971;0
6835;bc1pl2p94fdpsl5qcnlzn77gxfnvm7a8yluqt2s6rc29jp758x7pz4mq25cmt4;36574;1;36574;0
6836;37TZKxnPDHnEcrgLh8D3H8qwiZMoAWtFog;957384;200;287621801;286664417
6837;bc1pymr2nrtmpz2lkatyw5za75ulx3vpdnayugaxjx2nuz20ef7gfznssyje72;15818632;389;15818632;0
6838;3JmBa4piWKiT66rnMLEZsCooYH5kXeY9DN;388109;7;4154651;3766542
6839;bc1plecv57pg4q5say6pz9gym9jt5ya0g37zrugr7ygp798huxqvjzmq8uzlfr;143166;32;1813843;1670677
6840;bc1pfsudqq5z9xvhtq3uzaksmcjgtxgk2rf3fcnl9h7rz73dtevdarmsmhwfam;546;1;546;0
6841;bc1pxm5c0jhfhfsrwmgxdngzxn8534dgazw0yj0m2luvehg32dhjuesqnk8mqx;0;20;4755624;4755624
6842;bc1qwrtry4d3fatr44l4qxjvs6rh4j8ehumzg8cp0q;51979205;9428;116855428;64876223
6843;bc1pmdrmrurpzzdkhrtt5rxezts702y30g2q9g09lt6ge39cur0rzwtq2da4uv;270004;1;270004;0
6844;33RV3LTVRpSjNaHGehziomC5K1UPiCXtCn;3650596;13;13463405;9812809
6845;bc1p0rg9l9p85q5lr8sfzl6n6ecs8n4dd65h4c870cxedvr0qkv3rggq72xvu2;546;1;546;0
6846;33y5RUfxyEALtrTzC5Q158jbe95yARAoAr;26756507;264;254450244;227693737
6847;bc1phpprua9v6sucaru4dfwd4gey4aspml9vsns5r6m2pg4qurgmk8jqs0czjk;3822;7;3822;0
6848;bc1qu5ct3tlej3k7u8lht9e924vevxhe3z37kk7csh;4863928;358;64984532;60120604
6849;bc1pv43t7nalc7jnkx9cdenljswej95tcuu475kgj8h6h06lhlhcuykshndp0z;1270631;26;11717265;10446634
6850;bc1q6v49uhrtflv8cfd380w9qp2v2ce348g0wp035x;0;2;232190535;232190535
6851;bc1pg0p8fqmpzpalyhz49sswqpekqztxvxn02j3v6nlcwd29dwk5lsxqwytttu;1877328;11;11169721;9292393
6852;bc1pa9upvrnp6qm57uc5sj8q75htepcd52xkgcl52utlttpae4uv7urqh8ycud;0;5;251412;251412
6853;bc1pcqms2fr4ytkjda0svyrn56h0glpzq64mflerae9ku38rjluxusxqa954sh;13048888;392;13048888;0
6854;bc1pgk6z9q583pzqdzrkaemfgpcrjvj69ukg5ldd6gdkghdqvppev4ssgjh8vy;1092;2;1092;0
6855;bc1pz6nwlmxwpejhfat82yrgeu2h0xh7p4jvddgzwezjnt7fctjnpx8qvd77lh;93253;184;141898;48645
6856;bc1p5meq8nd2xqjs638wy87rxa2deulw86p8zufecvuy03ptv4dtpsmsclfmrq;0;5;245220;245220
6857;bc1p0kwnyzfqfedw2hswyfakgmk38yuh2nfvp0lsje8kmp7seasupuvsl6cyx8;7577;11;7577;0
6858;bc1ppgu70dg6t86xs8n2s5t98h937da8pmy9ft2lnwg5mn8dejllw37qffhyfk;12205944;352;12205944;0
6859;bc1pv5vfpuyu3p94yzschp0npvzjhc8l279fre6dw2h4gk4y27ux45rq7vypkd;0;2;584000;584000
6860;bc1pl35wn7k578zg55exz799m6v6pnu563wg34t7yg7jsnmxpmvw5fdscdsmvu;13750144;357;13750144;0
6861;bc1pn5vnezcpsw8slcnjkwjmzkypkj2u8x45e9exy4lutvqtht7vlgxqezq2pr;546;3;18546;18000
6862;bc1ppz64fhjljc0ecrut5dpupmd5kylt0f2aje8y8yer7uycjea70dzqzqc96n;1065115;303;64571539;63506424
6863;3KdcHWc3u8YHcL9o7wnX1Ki8te1GQDtbW7;11152134;5;22378817;11226683
6864;bc1pyx4hj6h5njmwnrtfy8lmntyuwyxpe5psxsv8xn9rns2mag5vfafsd723gd;0;20;4755624;4755624
6865;bc1p6wa9ef6jmwx2mppdu87ldrp9xv63e6q9k2y6v82265hyl6sdfs0qzlrktd;14784720;363;14784720;0
6866;3JTGUtqj4xDoxKoke17EWDxcZG4zYEQzee;110000;1;110000;0
6867;bc1pd3c6c6purcyztxetfcuws8t7qnvnn2csqzyv64ydtrcue9asjg0qxk77gp;15210592;383;15210592;0
6868;bc1p5j7xghwt6c5y69agjhd0udlndp9fta4mnrnup7zrglukmvm26zss2n9vwd;505409;5;2869325;2363916
6869;bc1qc27nt4tczlpcgl8t0mhkr3nupq6w43dwd0c3jc;39000;1;39000;0
6870;bc1pkyjd4p9jnftyan4ta8sch57qej6e69u8mppac3u59kpkk6hkk3msm7e3zk;226770;217;482284;255514
6871;bc1phwv2dx28medh7lrcgukkm8r55r00mrgc22uj2eshyrs72nexq9cqzxp4y7;14378288;391;14378288;0
6872;bc1pjpay9563z3ql3ms5rnx98hj0dxkeup90tuj574vyxk90n7yy0f7s4h5lug;1437652;661;163246212;161808560
6873;33gtgWidULrodeCeRdVjs8pje3bp3DwWBJ;58411686;374;728406161;669994475
6874;bc1p0c0sm6qnxnsx40u8mgqdr8p8yqx08p24qdx2qw03cch5dfmjf6qqd57aqh;2730;5;2730;0
6875;bc1qzkan5fepl0fw2e3m4muexp2hvtllycrznlknwg;201620;32;201620;0
6876;bc1q43l3wzl6xepfzpasm7s26rympfu0j9t2s05n6l;107226;20;107226;0
6877;bc1p25myx0eu5sarn09pfa6qlcnl6fgvf9249w3f3l3dfu4htmfz0w6svshd3h;2184;4;2184;0
6878;bc1pnw69ukjddple7x5yq3mqh0rd5xnkq2rf5q2ufwenj062htq5qqfqd06cyz;82725;53;10316730;10234005
6879;34Q1w2ChoEdmHffdt8yaA3a9yS9wvAwT7u;2951856;8;61321936;58370080
6880;bc1p3pvyrjt2ylsfgkwvl4grmglwu9vkv60j4darqf6d9k3clhz77mhsytuv4s;37359;1;37359;0
6881;bc1qrdttazud7swa4hh0p0wc8t3y53rdw353s4dals;426014;256;64849883;64423869
6882;bc1qmhtkx22nqldpy83f2vwpfs8kn604zayrk6akkm;1200;34;38400;37200
6883;bc1p3t60f40vazuxf0nd9ev3rz2vnu38rwu3n60s3jecp6u4pnxec66sc6l6ku;253018;121;28456949;28203931
6884;bc1q7cyrfmck2ffu2ud3rn5l5a8yv6f0chkp0zpemf;116844924160;1816742;1702519866173394;1702403021249234
6885;bc1qts49weu63fqn96scsnstn5ftq3rs2r9xp5ejsx;9873;1;9873;0
6886;bc1p5s2usl3crdkmhp2g38l4y6fq4gltrmt8njdf2kwnp76yj54syl2qx5lkex;1092;2;1092;0
6887;bc1pxa2aejmttsqnww4etlwela79pkjgq533ecrtfqgffvjux54lz03q0x3p55;3137825;4;7431520;4293695
6888;bc1paa7ywz5l9an5usl5uhyqdtu35gxnpt95yuqkkj4cc0369e0ezxqs8fxerw;56402;171;185989;129587
6889;bc1p0wkhy50957ssfeexhad5ygmrzsggdl8my3wfr2z334phtuyqjcrqga99a7;351500;75;386972;35472
6890;bc1pmeqszx44zkr9lg6zqvmy0z2ts2xskxmeux8tfxvwkpldj4tu7ptqrcfzm0;5785914;125;442224011;436438097
6891;bc1pnpk60z9c5er304h8tetlyx0p5syut08r0y526nkkk6kd69s8vpcsj7032l;0;2;66000;66000
6892;bc1p759fxn9wn3sf99h9nldjpany0fvcj58pfdqkuh5we45dudn7w20sr354zz;0;2;22734;22734
6893;bc1pj8cuc99lvpzp9xekvgyw98f0nqwpn38cuxuw7ecj3vne0lsxfp0swsgw3t;600;1;600;0
6894;bc1p3q8tarh4vqczgt0uzvxhyhwjscy90e50tjsm5j7s8tqlh7c6zkfs9ku0ft;56962;91;113442;56480
6895;bc1p7wxfev0c7qp4vesmgsjyfeesx04ftx63kdpld8kc585gh5mydhvscyqxfl;0;2;38796;38796
6896;bc1qjzsqecffkaxg668qhh245w5wepw29hjcqcrucq;439150;12;11048693;10609543
6897;bc1psgguqrwvqvycq0ec3dwq6w7pm0hrafq77wtt83kjt86awkc4xlcs25hz6t;38520;1;38520;0
6898;bc1qn72ee70fjnu2ahu70dpzwk4quj9sn79h8ygzy3;949308;860;4674590;3725282
6899;bc1pr0tc54p7z8wsjjtlyrpctcllgaedvz2kt0ffukv2an8qjdwddx8q4ax27l;0;2;28615;28615
6900;33mBKvaCsxw2soDre1yY4dWzxhwwLSvPj5;94100;1;94100;0
6901;38zWEbsRJgQ6KXg5cLJcUKovJR6WAMHort;1433010;58;21118519;19685509
6902;bc1p97tzhadxh5ns7k3jldk5lq7auuhlxnp90rrt84xqwcq2qyal3s7sfjy2uc;18847616;401;18847616;0
6903;bc1qf2kkg7c0y6gx2xlape0ate9lcy98ywc05rfdz3;143212;19;143212;0
6904;bc1p63gqwpyrwh74w4avnrmfltrjug02kltrqf4m4hchmm3gmxtvz0rqmpljcs;236452;157;79164564;78928112
6905;bc1pymmg88m7j6uhcrnm8he6j8w7fhfherjdejhpcum4qmfqq24xmygq7s9tuu;1777267;182;59554374;57777107
6906;bc1pdefeeqt7x9tl2nsj77xdmfrugls4ffrkg6s7tp3shn76cupzjggqfmgna9;314173;1;314173;0
6907;bc1pzk9qrgjn4hytyxghsx2tjsp02c5qdtymmqphu94kyc2ywe37vsaqk7mtk3;67138674;88;1821855342;1754716668
6908;bc1quh3tenrctmd0lc6xx7k6ngwdnujfhxr9c6sthe;1058936;223;46298272;45239336
6909;bc1pl8g5rr7w3xp22unuvq5pdhxl90yedmvwls398cx7vgusrhj5ph0scxhghr;310332;1;310332;0
6910;bc1qn3npwlg3j5ws20x4mde0pqevprme7waujet88k;156462;1;156462;0
6911;bc1phgq2dr564qgg96xsd787kdhscwc3k6t9p8a95an37wr7rqy5r5rs2gpdaf;1016089;1425;300600981;299584892
6912;bc1pxfr2mdzp9hq0qehx34mcmklkm8x3vckyyewqehhxhlgyprr7jzcsqt7dw2;88288;423;299837;211549
6913;3N1VtUHuEydg1cTY9xBdoZF88ZQctrGmZv;1965635;97;23079973;21114338
6914;bc1quh9jm6p06nqnvgvvv733pl0g0y6ycxl0aas2t4;8646779;7571;695681827;687035048
6915;bc1pv2cc6y9unj2n0jgfay6gets0ydf2lg58ymkq9skt7wmn3d4wh96qwnxyky;316356;1;316356;0
6916;bc1qu24qs209fq6yv5f3dmmmjxre88tvyaa890ws5w;1712096;12;15291990;13579894
6917;bc1ppzypt2hd6w9kugzt4khn5vn46ppv8xjc9a75d6n5hw8439w8572sfgcfja;91288;9;1247056;1155768
6918;bc1pqak8xhc5j8gcz7wfs5dny4elqqeelqrd4gx322095emp5jqzxzfsfxaky2;1735371;2867;3721734;1986363
6919;bc1p3axlj6x4g9tte68a9jlysgdh4xyvq7xcw20xdv54u8r2lpscezjqlq3ax9;317489;1;317489;0
6920;bc1qzv66ljl3u7ecyxumk78j5fmeqpqldnf27apq5x;0;2;570925;570925
6921;bc1ptgmgc959490s79khw2t64n09g8f6pef4ptq503gxm23sy5fnkedq4mm85e;0;2;28387;28387
6922;3M6agUtAGKuJsnDr65nbsyavEuLCBVbeik;1286220;20;10445617;9159397
6923;bc1pg4jtdy89v03mkvxckaxn8jlx9juntfya9k77wfmyzslq8vvmutasystrc9;14529;28;15075;546
6924;bc1pe3tt85en3vscrlufe9xg9nq6xxj8smwsrfd5yym0fudnulc2me7scvk87d;546;1;546;0
6925;bc1qvs2hts5u0mk06ayecd3m85ps5w5emuxtlxeg9x;46059945;9582;104492293;58432348
6926;3H6sikATsqQEPkVeHgqxjryDbReQmfDTMe;67187;56;10986436;10919249
6927;bc1pqrlp9wlpryps58ts6tsq2f9ky6pvu8wh2njp890kpza60kpljy6s3q747c;58842;1;58842;0
6928;3JiCoqYP414gXE8dBH3diKRCZyZ3twyqDV;565504;36;15473438;14907934
6929;bc1qn5xzh3pjsdx83p0jjwtqxdclrffa25lr85ttu2;22257;42;3727123;3704866
6930;bc1p7jv0ecdaug4kmras3wkuckyjzll0sl9enuwsnz6z0urd40tv3cpqd0d626;242989;5;1895933;1652944
6931;bc1p5k9k0zsyuj64c9tkk0cz08vjk5nr68fdwv0nsy7j9fkannpdhsfqcmh6dt;324821;1;324821;0
6932;bc1pk757kv72ep42c24lf7qapcx6ff49m55cg8plwg3jnk36q7h7zlqqah56ya;60437111;225;605188628;544751517
6933;bc1q4p0dkrtryvs44vtsngvt8wl3nc0pql0mqv6f0c;168627;98;21210676;21042049
6934;bc1pv8ms225lkr26dmpq2tnjyfy86hzkt6xk6fpypwzjfx78ttcpd2gqw0htam;0;2;40000;40000
6935;bc1qt4qmj5vl4nsfxeynrg2vxlzamw8xmft0eshgw9;9853511;1;9853511;0
6936;bc1p5jxldgny27x7axllg0m3t7s8s7qfyvx6cuancjw3ts2fvzykgpnsegcdmh;841969;36;32826665;31984696
6937;bc1p92qpz8dlcqgyp2xduupyjlfcm935wgcwqfr4xrlchjwrf3k5hcus29j4en;549132;501;55970653;55421521
6938;bc1qdzhv4qxywl5nmxp2pukfx2tslesrpjwle59pwk;10882935;1;10882935;0
6939;3D6xh7rCGysWZTuxm5U3QWxTd52vivz7HK;52471254;404;2158545890;2106074636
6940;34xWJEoyRcXeKDfyQKEcx1FYkmhSjzZXPv;508200;24;2793630;2285430
6941;bc1qxrgktah2wr7slv8fwfmec3k80sez7864dcln77;545668;7;2859892;2314224
6942;bc1pdw7nlny5m4xx3qum4m4jtv0rxprmkxv5vzfwt79h5dnzr0scpdqsv5xmsy;3200919;1083;233286909;230085990
6943;bc1pfuu8ngcgeau3luewfu83v8dadmalfja8u6gz9uqaulzuaa3r8fzq0dzx5t;0;5;245220;245220
6944;bc1qk86j2c3g6tnqrq3scc4rwgp4620495e4c2cu9t;1349897;137;84330602;82980705
6945;bc1pfntw2e4dpzt6j2ku8ceepfzlljsvuqxmdvgf7nqu3c2xfhprcreqhayduw;223605;27;385039;161434
6946;bc1qlkeg7dvtfqe0m8fyd42477cldjnqh6wuhwya9z;75625704;1;75625704;0
6947;bc1pevuvu9597uuz0y9vqndf04442jv9kveardhth0qqqgd6wjzmyz9qu6l90w;314348;1;314348;0
6948;bc1pzmsc85nm4wmpdwx8kw285jdf39ydgtxgv92j6u2ktl08mjnqdhaqt3g9wt;47266;28;49450;2184
6949;bc1pu67zuktreys9nxc640r0u9uq7yfzlktnset6t8pvd6x6v53cr8xsnktpfe;546;1;546;0
6950;bc1qx7cqpysfu68ctyy37x97eqss0pkvm0ptnr5a6a;170238;28;170238;0
6951;bc1p2577ghwstkz0hw835tmyjuj8czf0hzsen2xfl8crcqc29cul5x6qa7qr8q;310682;1;310682;0
6952;bc1qgqjl4y5tt3llr7z0uqh2m0m6h20w7gm7v7ttk8;0;351;306235961;306235961
6953;bc1p6mlqe7wqkue7rl88ue5pw0yhq2zxg0yppg3950tplwa9jzpevpjq7sk232;0;3;137176;137176
6954;bc1pcsp7e3lfp5k9a5cexy25s5eu9660my9g8m3ucvy8u4ukc94d88cskadkam;954638;552;127858181;126903543
6955;3QytC7zA1qaBJGgpXFjaQPYHXgLoPKKfbg;294229;15;18956317;18662088
6956;bc1pqnkrzcs8jwztra57txay8lsmnsp3yyh40dx3yej52qecn3ktrgnsgvmspl;1670754;183;32111288;30440534
6957;bc1qxfwscupycf6wpekj2ufwvcpevje3ru75xqv4j4;62858;19;717399;654541
6958;bc1ph7g5drqx4jncz48qzppqgt9e4efjdu8frayw30zfxy30wchswsxqww3hyj;0;2;45000;45000
6959;bc1prt7496v8z5ughflrl44gnudfscydeys2r24zv8q6jvu2gusrjwaqmy3vk3;14203503;171;102573354;88369851
6960;bc1pjlwwn2uzykpsefwpa0f637440wmc0q5uc7araxz3t6yqdwhttmeq4q4gzf;21055;7;471701;450646
6961;bc1p0cqqqv5gt55lsyx7zg9x0x0ue5c8av0n5asgxwx4mhky0jl3whnsxecymt;311032;1;311032;0
6962;1AaoHFQvSi62BCUVqmdaBTDsdY5djgD16Y;89740;530;330017742;329928002
6963;bc1q9xys50pgrtnxaqqk8mshyskcqcnngzkx230tpj;32911;1;32911;0
6964;bc1pnp6vjdd2jdsdd723svpw52883dmara5822csy0fs8mqmewkyqcdsac4fh2;0;2;30195;30195
6965;bc1q6fmqp3ytm5nzqv00amknm63axjue2ueq3nj90k;59614871;11431;143240440;83625569
6966;bc1qdrp9hy4mk5037cnquxnhlutcqzacuvt3czl4u6;474170;2;474170;0
6967;1J85B3hTUBWL3tKHNAxBHDA6WaVC7SHHB2;7931;2;57931;50000
6968;bc1q7rv7x0r4942uphu5ssdv9mvcraflnr6ukaffky;0;2;1337;1337
6969;bc1p5q9hx49kt0v3vcdmwwqsalad52ezahnhcrxghptupcg8na5kq8dsedynv6;0;2;22734;22734
6970;bc1p4py8u3r50lljpfrpufzpdj8ujsp2j99aqh3h8necdkdfp3qwxzsq7p0tlu;770031;97;31976986;31206955
6971;bc1qpe2l9vdqd5tm59f4tdf2hx2lp4ymfyrla406jl;84000;1;84000;0
6972;bc1prvrfjz2guud4zvwhd5a3mp8q0u6kddspp689sghkv8x2syc3xfrqteqcft;2730;5;2730;0
6973;bc1p3z4mnc7n2272gufz6ec2xh67lmlqsv8zgsggmczzgqhkxcj64xcq0fpy98;80473;11;5990879;5910406
6974;3Nj4dqLhoFFdjmGcDnxHFb3keMaTQRbesB;4874936;473;1739106711;1734231775
6975;3MMHCCRFtSt4uoqnyBZJ5usME2wHxeGgyX;4373421;13;16570517;12197096
6976;bc1pw3p5xhyqh032lct4jp96pj64h3sh064qxzler84ntvepyt2racfs87wrms;572767;1;572767;0
6977;bc1p57z68r3l7yseekgxsh2gat3jlnrumn8ukuc09e6hyug0n9urdhxsjrsxsa;312690;1;312690;0
6978;bc1pt0h8gdxmnt67qvl49epr0nrlx8urdn8jlpsp3y5nl27r6d2duh7q5p269d;1968;10;8326825;8324857
6979;bc1pwc3at6867lfe54cfpa9s0wxp7ah0huy77pgahrcl5y7nst0nw86qtwuwxz;330;1;330;0
6980;bc1pymr2nrtmpz2lkatyw5za75ulx3vpdnayugaxjx2nuz20ef7gfznssyje72;15818632;389;15818632;0
6981;bc1pfkv7eh463ynafakfar9uwq0nf8uamm8cxyy5phfnwqj70sycee2qxf98w5;824750;48;66029021;65204271
6982;bc1q5w34h3m8v09h3hkrdjgkerds35d3h0s5wzy7u4;488100;1;488100;0
6983;bc1pmhsccltzktau4rageycnczxc09czha6g6ydjvzkd9lt3ha04zlgslltnx4;318014;1;318014;0
6984;bc1p5ud695ssl5lsarmvs5xszey7l0w6jr9l5enkk9g6e3f0lle7nu2qjyful5;2320240;13;6732078;4411838
6985;bc1pgclt4ernsa220tjuqueemggujzrdextcn3f6jck7l7egcfa2dfush759nw;3882200;35;64832751;60950551
6986;bc1qsscx7qhgf9gwksje0zltgyrw3ztvfl9x6zj6m2;49892184;9712;111139072;61246888
6987;bc1pssyj922t5zade34kpjdmpeeljr8p2xzscazcve2surtf06eauacsslmcyp;330;1;330;0
6988;3QXLfV7w34X4r2yyrCcckrmDmThApWS74Y;1484588;3;3806668;2322080
6989;36KszSVTR5xF7vDztJko5mj1XG6by6aGmd;189953158;2;379953158;190000000
6990;bc1qvezu7jqg6ceqpwlfvqzzz9pfc2xazyh36rnzwm;8135561;54;381108202;372972641
6991;32F6wCFfupQVwH8N2RuBSotYcjhPa44WYd;324880;8;1652511;1327631
6992;bc1pryrt7uctu400c2vpeyfasjtkjk9vs6qrvntg98zynz8gntw7kyrswyh05e;1227722;398;71187621;69959899
6993;3G8GbSMLCURnmvE3iqzS8j2cp8XTuniV6A;100000;3;387712;287712
6994;3EWCxe3ZD6HAP3eKs78a9WNKAWMAUT5KxM;1536870;2;3102790;1565920
6995;bc1qmzgljp33uvyegm3lp72jnekm4hfq96vvd36up5;127685;4;127685;0
6996;bc1pwsdu2jc3chtkv5ywzsearazs0djtevalvmm4t0m0acqp85knlzfqta595n;604792;2;6236534;5631742
6997;bc1purr7a3q3uhj9slwzz6rxfy7rqur42kfyyrywj67eswfzp7hdfahs4atlx5;694534;272;240923902;240229368
6998;bc1qvzw9mtptnlh5r2yd04f4y509hkrjzc09uhf0lg;122303;6;122303;0
6999;bc1p2ygny602e4t9a8lcgmtpgldc4d8wzmygyr3gwjc4u6pwcx465gfs7g9u5y;325171;1;325171;0
7000;bc1pxys4kk07zy622re02qyp8v25kfr207w2re5fj7399z53sngvm9nss6ta7p;13066;34;16946;3880
7001;bc1qjvuj5qehdwpgxlxe8rm5pplg3cuxuw6v5tvndl;1200;36;40800;39600
7002;bc1pkcy88m9xsxjqjml0wwypcnqsfqtfkf6u59z629m6lj4l03g0guxqmc05j5;6552;7;6552;0
7003;bc1pr60he5xpx7txnm46l6ku8e8uszr2lvakwhu4uals0a2fv35lmy4se5ks3k;31492;1;31492;0
7004;bc1pcqms2fr4ytkjda0svyrn56h0glpzq64mflerae9ku38rjluxusxqa954sh;13048888;392;13048888;0
7005;bc1pqgd39wlywa0tk6ftcdwel9t250ykuqm99vr6x0cfr9g8065a6evqanuh6g;19430638;5;24905638;5475000
7006;bc1pn9exvrz4kw7jdr6vtqehwt3pktgfqyqyfdxwy6jcc95rh7tfvrys2026e5;229073;12;4095084;3866011
7007;bc1pwyj743cs0zcaw6r70sqqjeqyywvqny9re0mxtlrs4q4cgn8kd3fqqzwr6h;29210;1;29210;0
7008;bc1ppgu70dg6t86xs8n2s5t98h937da8pmy9ft2lnwg5mn8dejllw37qffhyfk;12205944;352;12205944;0
7009;bc1p0h4y875mnxpqm5vntq0uj3wlmypvqrfn73ulf2w8fjd973lwm27s9u35xm;1122923;163;89863562;88740639
7010;bc1pghl3waru9w44qjhpd2tx74ucwh5yxfhzyz08wj48mawqsdphlekqvgakxg;46961;26;49199;2238
7011;bc1qffljq684yxplxwncygfu9zwwgzd5rs3c9lnss3;84000;1;84000;0
7012;bc1phcsyla7gd2jjgtkj5rz2e3j0m8xunppnx5ff8tqhmm92gy54u7dsu4h478;1221338;731;8748861;7527523
7013;bc1pn8fapurnrd7jx36zta58ke4pyzhj2ud8pn8tucv35at4zd47fvashl2709;307624;1;307624;0
7014;bc1p7jn0dww6g09tsz5z0ejpchx73um5ezuygc37e4hjskkf3lm4srlq82gtrj;272856;8;3076910;2804054
7015;bc1q7sr82w8upspku9yae5aztc5y79c6gy833ewhmk;248520;1;248520;0
7016;bc1pat65rzqdp4e0xrkut3pz0dzf9nuwg8l6tuupe4n55d5mulutgcdsjnwfxm;0;2;74000;74000
7017;bc1p54mrhjwyceh54n52lrg5jwhf0kmrm9dgh3wamjgpa48jzve4ws9s769xj6;314173;1;314173;0
7018;bc1p4lag8wpwpn0s4ka7v4my5ra96ptvszfw087g8geezgh3n7605urs4jgare;696951;76;21197263;20500312
7019;bc1p6wa9ef6jmwx2mppdu87ldrp9xv63e6q9k2y6v82265hyl6sdfs0qzlrktd;14784720;363;14784720;0
7020;bc1qwr322f75xqayphsws50m7fx59n8uwx56ahrdmu;454463;1;454463;0
7021;bc1qzav26qhe6pus229uh93qetmpzssry7nlwastvv;0;2;631929;631929
7022;bc1phrfykhe53z8pt35tqhks7kvfafjvnf3q59vkm933yxnc4f0un9xqzfsu3m;1500000;1;1500000;0
7023;bc1pd3c6c6purcyztxetfcuws8t7qnvnn2csqzyv64ydtrcue9asjg0qxk77gp;15210592;383;15210592;0
7024;bc1prs8rv69gzzexxklvyzkzvxfktst65cgsp9peye6aaugtvh6wtpqqjhetmv;2168;1;2168;0
7025;bc1phwv2dx28medh7lrcgukkm8r55r00mrgc22uj2eshyrs72nexq9cqzxp4y7;14378288;391;14378288;0
7026;bc1pdjlxt7v4572fqkrlzdsx986l6zjtvl9s7ymazc4cv3rpxgqz3wlqhc76uz;115457673;7908;412446167;296988494
7027;bc1pfppk06jywcf82fyly9e5cljswhlzuuhaftqce3pscv6a4nz9p8qq94yknv;312690;1;312690;0
7028;32YG6Lhv31p2b67oWigXwsZr1cPFhrUiVy;1404924;4;4483242;3078318
7029;bc1plg70hnmsv2v9y0zevcwqyj3k6k8qvqtels6urx0eptujn2zdrgls7efddr;63902;12;23205864;23141962
7030;bc1pc209zslan8kungcxqelgqhnywvpk7zpqfv38g7yt3sj7l2gzk68sg20nqx;1638;3;1638;0
7031;bc1q8k6zjstq3wyrhvjmqkr3qd6keuyzrrta5zd0s2;0;2;84000;84000
7032;3Qs79BEMajLy9EeUpaQwJAvCehp6yEAyX8;590270;38;39584828;38994558
7033;bc1pn3feyxha8ncpn9vsqdlrvral7wettrsvgax6x6yhqugcc2zqp3vqgym5ju;311290;1;311290;0
7034;bc1pvwar22nnnys3e0stq9hztufzjfxzcrg0qhxc7s7a0es7al6sa8mqv6ukuh;38579786;35949;4462975613;4424395827
7035;bc1p7sagl4rmmpusetpassyc8wez89jdxpazht7jd96d2tm99ewahwrs235u82;1500000;1;1500000;0
7036;bc1qx4x2mxjf3vreug62py9lyedyvysdaz5qsnxjmn;364486;2;364486;0
7037;bc1qrdttazud7swa4hh0p0wc8t3y53rdw353s4dals;426014;256;64849883;64423869
7038;1Mv94r9AgEFBpFGaiUNJChJD5UKwm3z7HB;31194885;152;118412380;87217495
7039;bc1qd7p47jxpcq4z4xne6ll6czgxaa0gyreraskye3;112166;1;112166;0
7040;bc1p208egmdjau69rqkr7r26l6redj7g2puca784skccm0wfvlrf9knqn7f0s3;9314;22;12098;2784
7041;bc1qzj29krhxfhq5scspmt73mhms8e40gwem0uxkk6;289875;1;289875;0
7042;bc1pe9hqmdke569tlsksvtk75y3gxzwh72hllmk7t86pxxn0mlrx4raqs8cd3l;127253;138;199741;72488
7043;19m4RDoniKqFC4GB5odj1CYpsnueQ39Wzc;242020;3;483352;241332
7044;bc1qjg4udz8lfvvnyr9mfe7h6du9aaz6tmwptt36au;446931;4;671794;224863
7045;17oH8r4uTzPS2oc2gwjJgp7u858vb9rUWn;503851;60;10470240;9966389
7046;3EEKcVGPFPU2AGLUE66BdB8jJtMPmUP5Aa;570000;105;39072811;38502811
7047;1JF3Mw3qGZ9AAEHXbsFSMKHCXo1ZQDgCw2;5117866;19;5117866;0
7048;34AYkFYixKUjo9Kvu2d5kMMqciydS8yL3N;1725605;140;28860022;27134417
7049;bc1ptgmptl9y7qphuel7sxjqck7jecyhunsq2kvyfpgk3vh28gmqg09svdmqwn;1015666;5;1115666;100000
7050;bc1qcjlmkn6t7h7a7rl8zmkqz559yclrm7fqmvdeu8;90000;2;90000;0
7051;bc1pzk9qrgjn4hytyxghsx2tjsp02c5qdtymmqphu94kyc2ywe37vsaqk7mtk3;67138674;88;1821855342;1754716668
7052;bc1pnw2ntn6lr8xa3cdlwhr0487kkujp2nkl265hjqux3zsyyt6mk5nq7jl8wy;386469024;1;386469024;0
7053;bc1qg3zj09mmwkaxs97tj54rfhry2cway86pguzczc;866024;9;3437807;2571783
7054;bc1qrn76zcyxdddsr9xpll4r27y8k7efqduz52233d;103862818;39;103862818;0
7055;bc1phx5s4aetwtd6zjfc2q772qrxah8etanyqvgtxx4h5zumx0twj35svcccnm;192728497;1;192728497;0
7056;bc1quh9jm6p06nqnvgvvv733pl0g0y6ycxl0aas2t4;8601723;7549;695636771;687035048
7057;bc1q0k46fhjxhtezl0m3hgnf3xzqdpqqy5hukxuux8;281590;20;4317124;4035534
7058;bc1q7hldfhdv30nvy70ru9px06qycvv6v796u4pqas;344253;1;344253;0
7059;bc1pk3dey23jrvkjz5k2lgxde9jcpcrr4jwvpmavk4huv355ccw27pqqjrt2yv;89746748;1;89746748;0
7060;bc1qdhfexchq43rm0swt0mfws3w33923s243efwc9s;251578;3;351578;100000
7061;bc1pj5qh8tscvep0cf798p6dc2ykrs5uuhyadtgp52vrqznpq3lgr8mq68c7px;0;2;134176;134176
7062;bc1qnh3wuxlz0mzunqlse9dhpwlumf3rh2g3rrxz3d;850473;9;3391058;2540585
7063;bc1p0yzlwjje55fqzw3zvru5fsgx0rmdwtuk7ecap6t48wl7rcy9l2as7dnkp0;100578;1;100578;0
7064;bc1qc9w7qwa74sfk2dercczhejasllsm9kzjyxm9gg;293662;116;114289481;113995819
7065;1FWYxKvcAqF6Nze4UEEdBuFjbyGyarxjji;161520;71;36882656;36721136
7066;bc1qqw9axm5ua8cqy69jar9ffvclvredmduzejmn66;350000;10;1000175;650175
7067;bc1qzshretf3pkyhpz2pf7pqgz0rwt487kk2l0zwsz;12887;1;12887;0
7068;bc1qk6sj0hf220xtha7zx8yynyxd09mul9f7agzrv3;100856;1;100856;0
7069;bc1pvd9zmqulkfttz3fw85laqjla09mu6xddsky330npr5guqwpp88hqjrmajk;84263042;1;84263042;0
7070;39KNTYAk5rovgM8xpSkRiUorA3RkEp54Mv;14928701;68;20149002;5220301
7071;bc1qgedx8lkj6xlkwrmq8muan2nlcy2dh7jm38f8n7;1019259;1;1019259;0
7072;3A4ysvZaTL2uXWNH96C9yWdn2YuFqFpWXG;1000000;1;1000000;0
7073;bc1q45agk6zd9ejh8xxszkegs7y9c8hkdj39jl7cjq;13678408;11;13778408;100000
7074;bc1p2gqvavxjfjurjc3qh0xhegcs3xr9tu8h833lmmf4cjdrgtz03pcstjglrd;1364709;2;2889158;1524449
7075;393qcwTGF6PA3YTZ4YShHbaYjaFunZioAu;578595;7;1607106;1028511
7076;bc1p3lgypmr7t6fkpnpa28vhe6kjqc6pwhvyesnqecu329ntg9qar69q4xrnk4;190975;140;252176;61201
7077;1AcKNZLtKLKanzWwfgRGbSjHwRf7QbGHFp;231061;1;231061;0
7078;1o11yeva1mugWWcWNZTxJjoSLygQJZWDe;247056;633;127763788;127516732
7079;bc1p2g09xgrakywgdduncralncsm06z6r5u052n5tsdhkalvtsc6npkqrpm8p7;0;4;137088;137088
7080;bc1qz735zj4ry6usazdtqknqufs2r6tnze6d3t7qus;817555;9;3338347;2520792
7081;bc1phe6ml68mpd3wtj6qe4y5kd9kxsz90hp7gdrqmpcdtd6m95y6jvwqvreu9q;4130898;1116;4130898;0
7082;3KfvcRzmdvqxHQAwwgNnD6ecrtQhGmgnuV;223986;39;4511701;4287715
7083;34vSvs7GVxQFGYjoC6qbuzAXxbfRc1h5Tj;2786556;29;14568596;11782040
7084;1AstDJ8BWdwJDPsxFLPs8pKtbD9A85evJ;48212;32;2064444;2016232
7085;38eaG73G1CfPJ7mUa9csyzPVqMBXR1WrXc;421820;5;2843502;2421682
7086;39ydYzqw2RjWUzRwMYTMqzD5nF4YEXf6xw;2000;44;12117159;12115159
7087;bc1qlj5q2fa47qjery9qmss085ngfsm50gqzgevsnu;179099;30;1986211;1807112
7088;bc1p3g9ejjq28h7vf7k7ksqav90hpe6vedt4aerc8jsvldwct32g5wus30582j;16310020;24;81523253;65213233
7089;3PG5t8Va3LYQYXoVjaArcPS5jjodK76mFq;2454938;251;57094859;54639921
7090;bc1q6edzyfu45sayuwz2g6x9jwxcn48xdq79keeahndt8gh24gh9hfqsn4rffg;4601612;1;4601612;0
7091;bc1qjju0j5n7qfq3w7zgsearrt663ghzrs3g5apssj;1130000;1;1130000;0
7092;bc1py0zlpghzhgw89nz2sw6z6vrl0c9jpkx340qrh2f87q32mt6fj7usxjt2mu;48143904;1;48143904;0
7093;bc1q9x9smvuzs3n0f9qk3pywdfvg8p04v4x4tgencm;35232;1;35232;0
7094;bc1p5ud695ssl5lsarmvs5xszey7l0w6jr9l5enkk9g6e3f0lle7nu2qjyful5;2320240;13;6732078;4411838
7095;bc1qcdxa4gl9qxr9smca3ljxys25grfsj706r6fnfu;560822;1;560822;0
7096;bc1q0z6cask0retnlkktverp3zm0f49ygyp4xu2e4t;352880;1;352880;0
7097;bc1ps9kemmazmvqe4fud2xpqqfr586dpltmp07dy0efeml4ap9h4hhsqsq6ct7;0;2;79858;79858
7098;bc1p3v3qptp8vrku8kqrdrtvd4uf05m79w48r8zmc0scph3y37r9zq8se663f5;0;2;87717;87717
7099;bc1q8dagr3q5wczc36dxh8tahx8aut8jz49jfahawfrxmldmsh7fwdas8ae24a;130000;1;130000;0
7100;3PtipZcP3TuFBY18wTxLCkomzNRfAevrjH;41172;143;51095759;51054587
7101;bc1q9npmvu8x7tv66avy56eu4tlxqf0f9gynl606hk;310000;1;310000;0
7102;37PDwp8YuzyCBNphsbZmAB5duH9aEA3oZP;1110655;1;1110655;0
7103;bc1q3kwnayx4nlm72r6cd9z3k8p7luvcqqhddj84jw;2000000;1;2000000;0
7104;bc1p8gy25l75luuh05l6zcqwkkgnyswaj9mce0tv80hfde0anck49wwqje5nrd;0;2;3418;3418
7105;bc1p4d9078cmwsx99lfgdpz70h2jsjkwrz5m9p8k4e24ttwr6y9uhfxq7z5efm;385171829;1;385171829;0
7106;bc1q8juttuh4znu2jkw7jaequ8duar7hxsq5sa79em;1120000;1;1120000;0
7107;bc1qx2dpmltcfeljxdjegtjyuqczhdvmywps0da0lz;1000000;1;1000000;0
7108;bc1pcqms2fr4ytkjda0svyrn56h0glpzq64mflerae9ku38rjluxusxqa954sh;9790040;294;9790040;0
7109;bc1q7f7tagcycqfqy42qtn4a4feqau9ss984k7402g;1130000;1;1130000;0
7110;bc1p9hjwe9ppk8vyls6s6g3v8g8v6shtf7dnzuq66rrxs4az35dt7cmspy5ser;138010268;1;138010268;0
7111;bc1p7mecrlyp4pgjyplnzhzm97wq44yvu4rc4c2twphaa9vg3s906y2qyt8dxk;46737;117;3211945;3165208
7112;bc1pwejgdsly8zv5vdwe5esyutcqunmk75zsh7q3a0jzmkk8nq8fugwqwp8cx3;0;2;76000;76000
7113;bc1ptgulvyz6elqsh6pt9lmxsce8ns0h0tnyjukvxtk6phxwz5nl40lqnr926m;139860609;1;139860609;0
7114;bc1qfd8j5w93drgdjwfru785g44x2qyzz8sy44c3z2;2878585;79;12046845;9168260
7115;bc1qk4hscznl0l3sh3j0dmakn52y0t4asm75sgqq3h4pw0hezcenphrq6dkn6n;54747412;6;54747412;0
7116;3GB4HF2drKSGhAHZrLr2ywP1b6vsNgq5Bn;224246;21;3088573;2864327
7117;bc1pudtn64qmar376474jlv2knka3k56hsx4fdk26axk3sv5y0xgtngspuhpwf;38140;38;39232;1092
7118;3DZEgB8ajzwt9PKZqcDqiTaQUCT1jrMAa5;212681;37;3351288;3138607
7119;bc1p4gd3yjqyy7xll0qfl4tcelswk5k0anzsjtsfnd2f8qggcdpr7s8st5tth7;10876;5;11537;661
7120;bc1pjvsw2th2n9lp03hq35r43rvc2rulp4sqmuk9dyhf8eda5mx8qu6q3uaxpl;6786882;16;41073882;34287000
7121;bc1qwdax6kkl2mrxcae2ah0ffj6xrtwqfqpurkhyl9;2793205;2;2793205;0
7122;bc1qpsceud3yphvhkjmgq7ahcqsrc0uadctcntgs5k;1130000;1;1130000;0
7123;bc1pq5z0hvxnewyz2kr40j4d32nx9tn0jx0vvdsvjnlckjekyhdm0j6qh7w6hf;15124911;2127;16274241;1149330
7124;bc1q284ut339a8ghkdxkqu5jsz85znfenrru229frp;1168050;1;1168050;0
7125;bc1qg83pyg47edqd4jdu6vyjjcq3dahv68hpnwzpmvj53y44sv9vc75qdf2vpp;1520878038;166236;21014779730245;21013258852207
7126;33CwJmoUo4CFBzrp3yo9god4MmwyUn5h7D;981275;1;981275;0
7127;33SbRJ5qw23XdSUW3Ub8Z8YyULDUJDBP8v;8806953;1;8806953;0
7128;bc1phuenfxrk3qyj7qkds6g4ammwwvw8wkzdd0vdy03sllypht9f0j2stjltm2;438466;15;7951726;7513260
7129;3P4WqXDbSLRhzo2H6MT6YFbvBKBDPLbVtQ;16615561909;955125;50000672948;33385111039
7130;bc1pzyc090nfyd6ulk0n05gt2zsv58977a5r0qc60dm0k2fqxlxumlnsngrfr4;3147288;186;150176214;147028926
7131;bc1qakd775qwpl98fagwd6xqhww6k2tazwtslj48vv;156639;1;156639;0
7132;bc1qznxlxxfsdxwm39ql05x6r08em06mng94paqmn5;2218189;133;269637282;267419093
7133;bc1pmeqszx44zkr9lg6zqvmy0z2ts2xskxmeux8tfxvwkpldj4tu7ptqrcfzm0;5785914;125;442224011;436438097
7134;bc1qqzdnw6qpr88yt04yh04dhy5c7sshsuv52k8gc3;600;2;33228;32628
7135;bc1p3q8tarh4vqczgt0uzvxhyhwjscy90e50tjsm5j7s8tqlh7c6zkfs9ku0ft;56962;91;113442;56480
7136;bc1pycx73u8jklc3t6quupplhscpzs8d567u6ms05q2whpmw3mnf0g2svqlf4u;0;2;217576;217576
7137;bc1q2hj9s6d748gekv5sf62pxr0l0ec5j2zs8cn8vp;7285;1;7285;0
7138;bc1p58f7z9djgdvwc86s7dmhtfzhsxzm4sljs5sk4szmkydsuxy7er8s9mwsxg;0;3;61292;61292
7139;bc1pwjna8h2epv73aa4atmqfztm9mj25f957vdemprn7ezukygwcrz3sm5xk49;10175088;280;10175088;0
7140;3KPVQSogfSNKfMbkGLXsGSUAWDGMd1xWnS;1010417;210;160487361;159476944
7141;bc1qf6hkc5apjpzprtqkfpv405swp5d4zk6yeekjmt;245252;1;245252;0
7142;bc1pwzhwhvx9yavdkex3ysspqwt3l45m37h4dxqejr5dqx9rk4s3mqsqplfjx3;752109;21;10408549;9656440
7143;34TXgwaaH81mV3dyri4Sxc4i5NkD5XNzKL;13566013;434;2663051021;2649485008
7144;bc1p0g5qy58fhat0ra2y3tvynr6re3ll9nhm6yy0ufpy2yykal39ex8qknqfe4;0;6;221277;221277
7145;bc1q9echu27kjk67qy65sgvx0ashhc8qlk9ph38sm0;4008003;187;1734213819;1730205816
7146;bc1q4lf8c39gcphv54fhxp82xtnsxajc39arspukka;3155115;3;9584979;6429864
7147;1JTvbDJGZxxgVJy4RPyjjxwv9K3fr3hWwS;19557573;1;19557573;0
7148;bc1qq6ekv40lyj5agh9w0yphn0ry6w4ymtuy95yc27;670;1;670;0
7149;3NhfmtGxFsnUDXfvDZ3sZ1mtsNcuM6xSzT;231371;252;179936901;179705530
7150;bc1quh9jm6p06nqnvgvvv733pl0g0y6ycxl0aas2t4;8589435;7543;695624483;687035048
7151;bc1p4563qehu6qc5qnz0un9yyznryl87uwswed3q0fuhttaggz4gdtcqtkrwsp;0;6;230279;230279
7152;bc1p9922et9k23lgr2pf4y0s4uar7zc07cu96tuh0w2dt205q6t3e34qtr7x02;46552751;2384;1596909624;1550356873
7153;bc1p3srjxn3c7scpcz5uqhc8mhx5y6fklvpaeu63pqdd46hhl5kqg0lqhxtjrs;306726;135;20680568;20373842
7154;3NJLzPjakbwZjY8oGz6cY6HFdGAdPfosLF;11000000;92;80083352;69083352
7155;bc1qvs2hts5u0mk06ayecd3m85ps5w5emuxtlxeg9x;46052672;9579;104485020;58432348
7156;bc1p944a6ylc8mqsetkc69mhjt0k7p7yr2gq99urcwk0e66npffelkzqaeemqh;7644;3;7644;0
7157;bc1pp6pl8y63zw7z4v90ftd05hj84d2y4zaaqywae5vcdz5azhfzlc6stuau5w;765988;33;3651396;2885408
7158;bc1p24pzagfdmvagem0h7240wtt8uquer32k7xhfav90yexjg7d8jmqsgqzklf;43006465;20;680894037;637887572
7159;bc1qet9rpjm00cyg4quc4s5e54nq2vja7sl0vawqgkr6pu2ezuwld5uqtegmu4;121320;4;221320;100000
7160;bc1pxsv67agmykppvqkunhu7978eecerk4vmu2qufg8z9xy8wfq4ch7qh6cg3k;0;2;20799;20799
7161;bc1p65njsv29dugjd8eltajwuze7ahxc56jaakj6vzhgsfhtxj93zd6qx5shhd;9966840;2;11966840;2000000
7162;3NSsX5gETQGtP1F63YKtJ14LwtozPAugQJ;1292638;18;14137678;12845040
7163;bc1pks2fl3wghkes8urc9xfwtsj9aqwz2qwfaf5ata6k2tnf95x2sfassjuekl;896707;867;397250990;396354283
7164;bc1p358w6d6lw4zk8ykl0dqvawl0uvhc9ez8lyutkrpzvaxa9z0l0tvsj2ak8e;0;21;957514;957514
7165;bc1phpwr9grhngmzkthmvgwz8m0aaxs8ewwyrlnyn0nx2map46cxg9jqhjnwkd;57072;95;758028;700956
7166;bc1qp48k695gnrlanvgluhujuerutakt9zfvqntmwt;2665725;4;5965725;3300000
7167;bc1pf5vu34qxsakal6fl8fqmtew7smudrswhv8g3nehkd2q2rjnjngtslpffdn;253798;890;178912330;178658532
7168;bc1pa67p5r6a9q24wezv6x6k2wejfglmdwf6nzzv6el5pxl2kvsa39cq9wn0e2;0;11;329485;329485
7169;3K8t6FmdsLgJmeCPDRKE9FMKy7RDevzyzP;1156716;48;58854703;57697987
7170;bc1q0s027ufd0vgslc6w9p7dhelx69grl3tj82d9p7;42011;11;3346096;3304085
7171;3G2j7uqpBLh8c8Eab71g7nhAoL7c7Cdcdy;7650861;10;25344911;17694050
7172;39AaNxFqtnymbokwH4eTvTNft7G1q4VkCh;4065741;129;118366331;114300590
7173;bc1q3hflhhw0vzshnjwk2t7zyv5etnu4aet59w3fn2;5714486;29;97847496;92133010
7174;bc1q9s5npt65nk2363lym0d2nv85yjwe2xc8tpqdrf;29803;1;29803;0
7175;bc1qjwmj89hw7zlkupuygtl5m8xwev7yfcdf2fllpk;1203435;36;2310513;1107078
7176;bc1pthd8w8u65vcptw3vd29xfecppvm32atqy6799v5u72u3g4nzma6q0xzv4v;69600;11;887674;818074
7177;33cJuBZCmVV7npxR1kL16C5uSy8YDzRm2h;2520251;68;62445277;59925026
7178;3GHGfv3MVvd7JjMuwfAh9N6Uy1L1z35XvX;176804;86;12737143;12560339
7179;bc1peler0k4pwlprjg0jpvlrzuacpjeuhw2nywarmknmzc9z2uy9r3vsq7p8yp;211410;9;2450147;2238737
7180;bc1qsqzyyg508lqqq54gux8n8e57xqcs487mt0pcuw;2499258;2;2499258;0
7181;bc1pg2f43866lcr4wxvxw93dm27k5lf32x5zxzqdrkxqz96n2g668lrqdzspeu;0;2;44000;44000
7182;bc1paqq293qru65xtjvnxvrj5du92efe09grmplxt2dg2d0040zcfdrsxxkr59;421891;54;1361534;939643
7183;bc1psj9ulpfg68v25aknv080qyghmqvuvw5gkzmc25442g5h0w998rssz66h5n;353608;11;4720854;4367246
7184;bc1p4gdfvl96h2r3dgvu36cwjw0fvqwza9q6ddtujvme70f0vytsc09ssvnpgf;45110;49;6869058;6823948
7185;bc1p4k8gqymg6pc6kf2npp7zj3zqql0m8zxe0v6qvky5ugajvd3gcvmq5esyrc;4258730;5654;3783101249;3778842519
7186;3NaUVSrqig3EWCfwKdMWwB31HeioVv7zSt;5792618;895;1224289209;1218496591
7187;3CyPYhddfrQxFfCzSzCjP1BZGvMVBsvTW8;1050000;6;1050000;0
7188;bc1qpjtmzmpte5j38nkf6qpsp4p0ghejgjhm4akqfn;466460;1;466460;0
7189;bc1pfkv7eh463ynafakfar9uwq0nf8uamm8cxyy5phfnwqj70sycee2qxf98w5;824750;48;66029021;65204271
7190;bc1pywyj3c62d47saltgcywgk47vnxh5wrmxeh6d6g0rwvfxp5sd5pcsuvnypv;19309;16;19309;0
7191;35Qwj5MAMbmWiBLcKpfpydfoDN878p3PnH;4086763;25;52240403;48153640
7192;bc1qschfcda64ky4mr80fheptj50axekhyacak9kqn;47645834;9595;106812952;59167118
7193;bc1qwrtry4d3fatr44l4qxjvs6rh4j8ehumzg8cp0q;51946431;9421;116822654;64876223
7194;bc1pn3fpycmcqunhwq8k6vnzpu8zjgylvdngqqwql3yk8amhzu7l3uyskmez4w;1231935;163;214100037;212868102
7195;bc1p7a9p9d0x4det96u8ghaxrac95mfalgn7m8l8ws0ekdzsf3wyxstqh29h2x;1662527;33;35513758;33851231
7196;bc1qa7dh7n6t0ck2krsndnyhj9jamn7r6t8wz2k7ww;6067815;1;6067815;0
7197;bc1pj8vqya4sff0cl5syg98a2tsar8l66jscyekx6ncxwp72x56dd9as0xcsmd;32424;18;32424;0
7198;33mCANyeUJntSUWbcX6rPx2JkJFngmXnay;274252663;1;274252663;0
7199;bc1prhldflepd92hqmwzlryql8kqqdgqjkegvk2up00qn86n68zp3uws5qyssd;190251;84;19145457;18955206
7200;bc1pn74t3962dsk7q4wendyul3apdgcxvc5qdekzpye0wlwmf3v6jlvq09rwyu;18652225;179;18810660;158435
7201;3HT8zpakS3nQpo8e3WiLVSYdC7Tz9Az8ya;2259055;2;2259055;0
7202;bc1p77y0773gwqt7mhlsl2nwnds9us8kl240p22j4vf337mkwndme0xsfnw9uf;133754;65;173146;39392
7203;bc1qkvuzd8rafnuaa0xcxtvn7j0k8vnxv3cvg3k8hj;39811;23;2441248;2401437
7204;35ACiETYSFhxuuKvvXJFnebSfWkQSVzrz2;7834756;5;43890858;36056102
7205;bc1pcqms2fr4ytkjda0svyrn56h0glpzq64mflerae9ku38rjluxusxqa954sh;9821184;292;9821184;0
7206;bc1pds8hfpuatrd3jczu4vr8uzylsekxkh8s3mvgnle7j4snsu386ukss3sjp2;4180272;10;4180272;0
7207;bc1p5pt6fxqpx4a6h6smmksw38symmgas7m4y63res6jcqjjl777d36stzrqx6;4368;134;496184;491816
7208;bc1pqgd39wlywa0tk6ftcdwel9t250ykuqm99vr6x0cfr9g8065a6evqanuh6g;19430638;5;24905638;5475000
7209;bc1p0kwnyzfqfedw2hswyfakgmk38yuh2nfvp0lsje8kmp7seasupuvsl6cyx8;7031;10;7031;0
7210;bc1pvnk8dyftrtt8rxmqrqhwcpht9al6lf803sz3ye002g3lfxzdh8ksc2gltf;0;2;20799;20799
7211;bc1pk86z8phpvhhafrggvn9gq2gc42awpnxskq8ykhaslesnk5ctusxs2wc6vg;450668;2;5925668;5475000
7212;bc1pl35wn7k578zg55exz799m6v6pnu563wg34t7yg7jsnmxpmvw5fdscdsmvu;11307360;270;11307360;0
7213;bc1pkl8ll7407350vh5mj6zvx3rzc86xn5jqyvhnw9gr54hfzkfjq42sn3z9k3;0;22;988151;988151
7214;bc1p6hw3e4sg8gz88ujs5dnmg9mxmvsdmam0u3ctnp5rpg4wpsa4keks8m0pdl;1207677;306;233484737;232277060
7215;bc1p9yrsnjykjnh34dll4snmmem2m9arc0emv25cqmva9k3u0jw4ja4q7rszl2;31975;21;10083544;10051569
7216;bc1pcavma8cc8afume6kxfnpmjukueqh9jtx8snug8s72cmxeh7fwtps43vluj;668296;16;2501801;1833505
7217;bc1p8gl5t07ht09ja9ev6s6tcsk6u6h6yejenfwkus3jpgca260c2wes7n3ydw;1092;1;1092;0
7218;bc1p6wa9ef6jmwx2mppdu87ldrp9xv63e6q9k2y6v82265hyl6sdfs0qzlrktd;9984104;278;9984104;0
7219;bc1qxawfg5h07kkwvhlwl5p0z2skvy3h4pthy62j55r9rmctucksar4qq8fqxv;165560;1;165560;0
7220;bc1pkyjd4p9jnftyan4ta8sch57qej6e69u8mppac3u59kpkk6hkk3msm7e3zk;226770;217;482284;255514
7221;bc1phwv2dx28medh7lrcgukkm8r55r00mrgc22uj2eshyrs72nexq9cqzxp4y7;11340312;300;11340312;0
7222;bc1qhusje0kaj58tchnsk5xmyurx73yfyclnq744h8;500000000;2;500000000;0
7223;bc1pk2gh4y6facf0kfphztlcnjfkp8zh94zvx2pgleq2mwhr70spztjsmepts9;154198;299;30521884;30367686
7224;bc1qu9e7mwghh690es37xjxz0ah27ygllqknh5zjq4;15072;9;1752572;1737500
7225;bc1psxq0wp0vztkpmy5z0q8cu27wxy2qs5a0hrsk7nswdv9mpapevauqplk48c;493901;255;690967;197066
7226;bc1qwcnhweqxfdx2h7exytp0m56mxplsz8t6r3krzu;23160;1;23160;0
7227;bc1qsmg5ysa8pw53g3v8enyevvs69jpdge72eqzqqt;1821461;1;1821461;0
7228;3Ke21osfhEbEryUeqdwAuAY8VKxm5B9uB2;82171421;6315;166307381;84135960
7229;bc1pq5z0hvxnewyz2kr40j4d32nx9tn0jx0vvdsvjnlckjekyhdm0j6qh7w6hf;15124910;2126;16273694;1148784
7230;bc1pl4dtcky3manj7s30kmx467uykd990ex2vk97n0cfdx2e8mkz032s0ygh7j;0;5;209616;209616
7231;bc1q6dmx3ejs4wamhhxn30mnsawhespufzeupvtjyh;215888;30;215888;0
7232;bc1p4j7d2cj3pda35y3w3qsphc45whrslq2f3qqd0q54kud0mgwrauaqe5mt86;5453324;13;13170352;7717028
7233;3P4WqXDbSLRhzo2H6MT6YFbvBKBDPLbVtQ;16614537235;955121;49999648274;33385111039
7234;bc1pf94r6cpj7msazym2jcr0xra7n9tq7pfr9l97zawtxwmqv44vzpqqj97vcj;4903090;1;4903090;0
7235;3MkjCjLWjnF8tnuwoa8z2xrFss4aCvgNvV;61101273;33;157424146;96322873
7236;bc1pcltl7jtql4ydpl2w8w8awy8zt6ylcgtgpjkhxf840k36eyx9jwpstruezq;10000;1;10000;0
7237;3MDSFu7nRRNRFtENSnNbMbVbL2zd66MeJE;1321279;58;64749124;63427845
7238;bc1pqmf443hpts345y6unhadjgauuz8pz7mcgnq5u4zp4d2330g7wamqg40rz3;1142050;1;1142050;0
7239;bc1pnnx3qn3v8g8vepm39w9ejpv58hhrthwclxa2ld9skc3zne9esygqsezh69;0;2;24445;24445
7240;bc1p82lsstz6a5sad9ujef63v0vglkgsgt03hd38jmnqkle3pa8m3v6qvjxqgt;0;2;21396;21396
7241;bc1pc6kd4vqj4wsacxhvvvm6dlzf0gn587vsm56tshpeqc4ulkfxy7eq6mc276;394672;155;10157996;9763324
7242;bc1pjfwprqgr429xy0jgzm36wuz3m3z4jy0k9rgw3yhthva70sulgccsa0rkh4;15971736;298;15971736;0
7243;3NmDsnVBVKqUh3LWtw2S3Q7cmmquZfqLsS;751224;6;5538520;4787296
7244;bc1q4ylz35tlwgfw6g8sce69htmzp8kexq25fq4vjd;113895;29;113895;0
7245;bc1qfjznz099cc47fhpa9kp3rrygs47739q68nnh3t;286336833;2243;77415194547;77128857714
7246;37tNikUxDpU11kBTFcZNxXyr6M8qz119bL;1834290;172;34949745;33115455
7247;bc1p7cd6ssjjpmec7q58mknqmxkg27yn75rlmgmwd3gtwuxcvmfghv3s58pwx4;0;2;215000;215000
7248;bc1pdktxz3jj9d6yhdjfyjyxk4m83x0a0len5j5j8nruu4ruqz2lph5stj80vw;524521;390;1797183;1272662
7249;34LMfd3d634qaLass7vMZM3PFuUtccvsTK;42980;5;20956586;20913606
7250;bc1p7m9pj5pcp3hsqw29y09w09sm0j8qdy3xdap2x7dkj4ug8panr20sgcjmdt;10000;1;10000;0
7251;bc1pderpgune9sudse4md225ldhlnmr9lcft0g0d75xtks93upyaa7tsvce2gr;97638941;8;237971246;140332305
7252;bc1pg8p9r6h8ct8ut3hs9zf6lhc0p2n50ldadmdhmjsdl0mw22s0lyvqarl4v7;28642;152;164174592;164145950
7253;bc1qzl3gq6q2udcvjnp7qne64fpwl40e6x49hksv56;76169;32;76169;0
7254;bc1p0392tzsxh959rnu8hclpts4gf40unty3thxhthfnj9unlrcppf8s65puwm;28380;1;28380;0
7255;bc1qqsetj5gpqvk3an2n4na4pwe3du6nz0gv6frkan;32799;1;32799;0
7256;bc1p8n996q0xyt0uvtk9me0xa074a78wkus04enem4rmzz56uc0gxhlsjtnaan;4540682;38;33075954;28535272
7257;bc1p5h4dksjn5d3cfuu5xh42krx9mdc3s0hyadxu6tek85z95nh09gtsz4vk8f;0;2;21396;21396
7258;3MAKmjzuT3rCVTXP5skYLrSRhgQpXpPKgo;888922;2;1888922;1000000
7259;bc1pxn7npr0ua8hsh6nm98qx082udf3gh2k2fdngkqrwdjrtpf29mcks6ck3em;14980056;431;327939452;312959396
7260;bc1pwkpylvsmaq5x63vt7437rl527hu6h8r6snpg34qwsp3mghzx0huqcxtuhl;1650;5;1650;0
7261;361BvMJaEdGY1zcnPDH9grq7ysw7pwaWuv;91539021;1;91539021;0
7262;bc1p3rhf2v078v96ycw25jxp2m2dah9ysmwjr0kskurclzf7mameup4qwky4d4;0;2;21396;21396
7263;bc1qdd8dmdr8v7p3k9slc70g0ty7mjlv64gfc4jweu;146403915;39879;2627054069394;2626907665479
7264;bc1png8zxegv957zefe8mn6lnsnmwnnkvjs8vt05p3u5fsc9uwgt8gksk0s4gx;487574;78;14005557;13517983
7265;3JogL9kcGg3RiWyPzAoxmkNTEGpJoZ8Pri;2040615;71;17128097;15087482
7266;bc1pvmv20s6wxmsj4rscwtl8j3y8ptj95vfa6fsv5wwkh6mg9z800ncs9gnd7g;10000;1;10000;0
7267;bc1p6nqu5al00lls2s69gfqq7hg6e7kxncyq5f9xvlep4yfdu6xsg7fqmv6w06;10000;3;1623563;1613563
7268;bc1qjy0vm8zwj6lr0rzktsrdzl4wvxkr3kkyx8um4v;702197;339;171580053;170877856
7269;3QUck4zeU5Z4yQLLGCkKG8M1iqFo1c8Cac;17599381;588;436443492;418844111
7270;bc1pmyuuq2rw67m8au5v9njspf0gmx9dwyznnfjj8lqqgpad2aqzj44szuntkq;96159;62;3295291;3199132
7271;1MzeaqAQ4tvsjimgyaSQNVwAUsj5WgMnQb;1800;1376;197130858037;197130856237
7272;bc1qxfwscupycf6wpekj2ufwvcpevje3ru75xqv4j4;62858;19;717399;654541
7273;bc1q6yutf45c8kavyarsda8kq40vf0tqrs87wk2y39;99570594;1;99570594;0
7274;bc1py66vrjk3zd9f39ve28aphz3j5lqkmjrwy8tk3g5yffll7cv0hwgs9qz4t5;140137;31;345442;205305
7275;18pXVXqDLghucR1TNiBBiG1oDszxECS8wJ;0;2;386244;386244
7276;bc1pkn9grm44es6ya6ae3tgtcuu0ykxqgp9w4tf7llreh5p9ugma2u2s2mjmtl;0;25;1083348;1083348
7277;bc1q6fmqp3ytm5nzqv00amknm63axjue2ueq3nj90k;59579300;11423;143204869;83625569
7278;37GxSe8h5fFsArVer6Zad9MfPFXYB9Bdjh;19931446;2;39931446;20000000
7279;bc1qam8c8ce7wkfs8ndt6vx69urlpp75yr0nsg9hlp;381012304;4840;2310219214562;2309838202258
7280;3Hniu3vCJPyMX4xe8NfSRb7xorWQNH6QMC;18870549;11;79570549;60700000
7281;bc1p3xr07j3tt8rxsfqnmlew6mccwgup7ea0g3rajlec4fthuujw0mnskfmdfg;105132;1;105132;0
7282;39kGpgRNV9RrpGNF4NR7r14DtvK7vzFtKx;11744030;223;180699869;168955839
7283;bc1px7gyf92z52lttq79k2mzqltzl7jnenh6ufzttag3eermgwes84tsxgc409;0;2;329946;329946
7284;bc1qmzd8j02rsq3fwcr5g4lhych2ud3kq6d9764qjw;1043474;1;1043474;0
7285;bc1p3z4mnc7n2272gufz6ec2xh67lmlqsv8zgsggmczzgqhkxcj64xcq0fpy98;80473;11;5990879;5910406
7286;bc1q49xnldvzdqj6glgqvgqma98zfzlletdgtpyan5;898280;52;49733324;48835044
7287;3Gpkdheop1YqZSuyJEehEuCDXP9qg7fWmM;607590;3;1895966;1288376
7288;bc1q5mwzupgxkrm3j8j5y99khtnt4p9t0tw9n79l03;113020;1;113020;0
7289;bc1pyxt8lj2r5r6gmxrap0zmfyj6qygdzph46ujceu0gwpl4pah79ssqrvux6c;1092;1;1092;0
7290;bc1p2dsl4sj5qfje68rx8xflfmaxkrd4rln2h0qc5uduaejhv5j26ylsp8yu5j;0;2;21396;21396
7291;bc1pm3sjnnu2tzzrq54nedxz8vxqj22zyj0azcpswwzj2trkqv5g5dmq4pkflt;0;2;21396;21396
7292;bc1p66wzezefsssg9mze295lqhlkr2rxyjmemytzs3g9uqm8dwdeamdsruq40g;3915328;1;3915328;0
7293;3QXqUe9JXpEVEGQgSUXwCZSvQZFcEkqwFe;2015672;350;121582975;119567303
7294;bc1p7cacky5uexrg83gq2uut7avwzt7qnjcltxn8andpxkv0at6tufvqln5322;7644;7;7644;0
7295;bc1qsscx7qhgf9gwksje0zltgyrw3ztvfl9x6zj6m2;49864246;9703;111111134;61246888
7296;3KWB5d4KQ3x2TLu7ByhxdFuHWswehrF5JB;162053;57;14478675;14316622
7297;bc1qwrtry4d3fatr44l4qxjvs6rh4j8ehumzg8cp0q;51951430;9422;116827653;64876223
7298;bc1p32nktsuffprllv0j93a2d3q33s0l6rlh598hynkgrt60lf6upqmqasw00d;155331968;8026;623353093;468021125
7299;bc1pwz3xdt68mwyaaf7l3ju32d4g33743qw7akvyufq7rymqllpkvupqtfgaky;1088292;1;1088292;0
7300;32W8tV2iNi7QFxYDsS5txBmh12miRDybdU;635056;1;635056;0
7301;bc1ptkhntl3wxm6tn8hztvarpk0vsgcal33g879e4e2hfk9w9ehqduhqe9wuye;158221;204;1112119;953898
7302;32yyBnNGwqJri332TYSENgaL2PA43Rf7iu;2121107;14;11009340;8888233
7303;bc1p2l650ncw2v9weyzuw473uhrhg8t2pfrvp3sp5xad5q4ncs2etylq265y39;407450;1;407450;0
7304;bc1ps7rjupvl8rys6dtymg9qgv5vvlj9pd9l5eal865jmzux4y4z2hkskt7a8k;0;2;21396;21396
7305;bc1puzfltgxv8uj86u9vrqtnlhaty0qmqjfcdv54hnckpcvrge8xz9msazkw5t;101292;1;101292;0
7306;bc1pvenuwgdnm8c99205vkalfyvs5h8sk49ht0cn9rjkkzrw2z8hu3hq23mu2d;510920;21;510920;0
7307;bc1pnagrdssrej2s29zxgd7peue43aszvl4kms82gvtqmz4l5h0qv5fqwqg6pd;6552;6;6552;0
7308;3LrZtwx4CFEKMuFUJSoyGYdfDyPfgHNyxs;164650;2;164650;0
7309;bc1pmv2h7g09p8zk7z3fgy99t0jjnc5n53ygakxcvllehx8xyractgzsdgz029;7510890;3240;990574667;983063777
7310;bc1p32phtl6xvm863w38ae9jvexgz4ymj0p3a7n97kr6u5qefeuph2dsw7e32g;15806925;16189;11148382007;11132575082
7311;bc1qka5gx0xhtwmxkqghs5m9fqhrvqrxjzwjmqhuac;372876;43;18340408;17967532
7312;bc1qastn9j569gyztf6k4haakyvc9y54hue6uz83pk;1797500;4;4482184;2684684
7313;bc1pxs0jklwhmsytgygugcljlwp69fca6ffsrzsl2tm80z09rwgmy3psagvpz0;9332641;89;91440873;82108232
7314;bc1pd3c6c6purcyztxetfcuws8t7qnvnn2csqzyv64ydtrcue9asjg0qxk77gp;11961064;285;11961064;0
7315;bc1prylz8a34dms0aqxz5vewpg5sdha4pvf6yqgf8rv7qwjqmutx73aqrnd47w;1041193;2236;89975909;88934716
7316;bc1pdjlxt7v4572fqkrlzdsx986l6zjtvl9s7ymazc4cv3rpxgqz3wlqhc76uz;115268317;7901;412256811;296988494
7317;bc1p57upcxh0dm3vkxa5def84eg9n3pwh8ps9luvdl8yr6zfrhu45ftqg5x4zk;16086955;1046;296471354;280384399
7318;3EPqefU4dBJMTYkd5uuSBoXJ1Ju4EXrLdw;253149;3;810940;557791
7319;3QA64JSZKW7Z7QmTRcXz4ydN9aTvaA9eVS;162328;194;1284254147;1284091819
7320;bc1puqsgjqgn7tx7m2qvqthfs3ns820epkqlshr6qej88hen30z0t7vsexdnzt;0;6;193889;193889
7321;bc1qrkcs0fftlc058j40uestczm2d44lzvx3mh3rsf;306002;35;306002;0
7322;bc1ppgs4khrezwu5ly5yghlkpfk5hh0zfwg9s8drh5ywu5xyu0jur5js88znzq;330;3;876;546
7323;3Lh6EaxxCRmKXNVyzUXjMrsawoxegqAewr;6314951;5;28074212;21759261
7324;bc1p9dg8ehrvj2rygdj3je4rwmju7luaejapemqd930kzyffg6e7pths6yw08z;2184;4;2184;0
7325;bc1qqmjqrw36nawgdv9856t4tfypwry9vxkxf78vht;1803469;525;120319822;118516353
7326;bc1pquz62anahzfwnqf9wagynvdp8hv7ehy2agxlgy72h0hxs058zqfqk8ksyq;25197675;105691;328911053;303713378
7327;bc1qrej8nj4g26fsenchfpy7w8h94lpuphu5p6hupp;25546;5;1497069;1471523
7328;bc1qudsk9z5tmps978lr5zgsv3x9kjdrtpsdk83x55;5929921;1422;529686292;523756371
7329;bc1qguzk63exy7h5uygg8m2tcenca094a8t464jfyvrmr0s6wkt74wls3zr5m3;285145689;898;454459689;169314000
7330;bc1q7wzarhtdp9mqayhqddn35zu3pfemz59t7f7h9d;695960;18;70257447;69561487
7331;32rVqL8FcyAx6rzh5dKgpw7hrRjDGANDsh;112879;4;1710907;1598028
7332;bc1qhy26tndy5jlzla2n5fzpl9xr0ve0kfnsdxmevu;96914;1;96914;0
7333;bc1qunt2qkqz6v6ykadayrmr7tr06s4d39yuzvcm0c;129645;1;129645;0
7334;bc1ps6pvqn7p6jknmy663zwvplt5vgqcwfdvwy50cj8edh8j39h0xzgs73akf6;349878;232;470088;120210
7335;bc1pelpqd00fqnsv5kfh8q7t36rt6en74k3h43saj7l5wvhh59yjprrq3ud7yt;13091;49;21549;8458
7336;bc1pzu9s27n400ke8fn9gr09xy34yfzsk458r7qd6ddd956agpeea5cs8vncd5;17395;31;535782;518387
7337;bc1qm647h8lsh3lxek7pw0rymypgza0cw8p6mqxl56;0;2;4039667;4039667
7338;bc1p2jekedyv2g4vq6w64ruh52gu4lskw4c7zuvd3d68xhjnfesds64qknm8xt;0;3;59142;59142
7339;bc1q5r8lnkq4qmvjn0wn59ykrgah6p02rf5yu968t7;96665176;97;1270174369;1173509193
7340;bc1qt0qpvxf4cdkwfnn46xkkxgzgx2hhkmnfjn8pxn;1043890;1;1043890;0
7341;bc1qnmr4w0ezq7c90n9gr2xahfvrsa3k5u2ez3c578;5828965;1;5828965;0
7342;bc1pe9hqmdke569tlsksvtk75y3gxzwh72hllmk7t86pxxn0mlrx4raqs8cd3l;127253;138;199741;72488
7343;bc1q79tuf4flkzdm5zwf8rgfqucavm3gqj74rmkpjs;3267095;25;3267095;0
7344;bc1pjfwprqgr429xy0jgzm36wuz3m3z4jy0k9rgw3yhthva70sulgccsa0rkh4;16360168;317;16360168;0
7345;bc1p2ps0lef8z36d59vt2kgv3c9un2gn3n40u5axf8j8d78s98dq2x2qkmyqa5;2334597;7;9133259;6798662
7346;bc1ptdsalsl23jx9x87dlctx3mcnrz5zm8mexz0lrgaqgj5uf5wjephq2r8gq8;142611;127;63321756;63179145
7347;bc1p9vgx07z7h85yu346ew45wp9cyu09pzkwf685p2t9hx30jacumfhqa254sc;591200;1;591200;0
7348;bc1q6nefe82heww8ch7mkyyw7560mggtaa6kh38jq7;2555830;12;12583975;10028145
7349;bc1q2ppf03h4menyc9mywhunvlnkpz4fj3ynw8svx7lftc42y6rrwerquvtje2;0;2;1167265;1167265
7350;bc1qh7sjxsc9whzv2sd0806ywfledh2ujhgwkmnre9;143813;1;143813;0
7351;bc1q202rwadss5k6phxjazugjp87ncjmt62szj0ylk;205758900;561;650957729;445198829
7352;3MZ9o7VYEwmabJZv1hd4wZ6Dza1aGGyyEp;2099693;147;35982752;33883059
7353;bc1pys2y99dxaxua02ufr9ry3vasr8l8eszse0qsrgqv229rgh0jvmzs0anfsu;23450;1;23450;0
7354;bc1qhretca8557gdrswdmw06z4vrdqj8f085ktkmtj;1013197;285;97379225;96366028
7355;3Q7XnsuXoXq8evA4orcReFJadzBXL7YSxC;2005267;36;10923681;8918414
7356;bc1pdktxz3jj9d6yhdjfyjyxk4m83x0a0len5j5j8nruu4ruqz2lph5stj80vw;524521;390;1797183;1272662
7357;bc1p97tzhadxh5ns7k3jldk5lq7auuhlxnp90rrt84xqwcq2qyal3s7sfjy2uc;12459256;305;12459256;0
7358;bc1qa3hn9e7fjvave9ywhzc5r7nkyyhc25dqjsckep;678368;73;39561420;38883052
7359;bc1q6a4uc752n8vfvl5h7fturgktrant4r9gs4h8dw;3129598;3;3129598;0
7360;bc1q435jpuhn4sx7srzg4vqa3l507x5e4s69wndqv6;11642229;14;12443214;800985
7361;bc1pwyxq0pxm9a4ushckeel5zxhq0kh4esr2epaald72dec5csqjqjjsfrgxun;5460;6;5460;0
7362;1Bn1u44Yjtoi6DsF9HVJtNSQiSS5ZUQ2kF;21861300;437;102517484;80656184
7363;bc1q5tlmf8muzyqlmlelmtavan00sjf893u9uj53pu;25314747283;376;4660105909034;4634791161751
7364;bc1pu42fs5j9vcn3htsxs25js3q4trwntmmssgh4jwvyhm029nft4kjqjry8s3;0;8;532077;532077
7365;1CE7DiVEQeXdWBTfV4KdDF3mLujrS7m2gv;374760;101;4345311;3970551
7366;3C6J1b3wkSEP4bQnZvv49KN8d8Mh96UtYF;783954;1;783954;0
7367;bc1qqvjxqaqammdcj5q5hsnkhfrfhk7gg26a5pnf53;7919557;11;130176293;122256736
7368;bc1qm320plg66kltc7gyy6pun9t00k8r42h7j0wnan;183105;4;198639;15534
7369;bc1qgye5d6d7ynw76948fsqj7sp9hu7e4cq5agkezs;153152;4;675703;522551
7370;bc1pfmmevkhcynyru7qk99ws7w9pq492wqmjd3snld95jn08cjxc9pqqsytngw;357849;68;13323879;12966030
7371;bc1p7prl008fv27qg2yjmwscqxvk3xzvsq5rr0gk6fd22ylepwk0eevsqnk29z;61572;1;61572;0
7372;bc1q0dehgj8p6xazpraea9lrurrkjuqcr6jthrt44u;11476328;1788;12533317043;12521840715
7373;bc1py9ze5zexfcw786g2xu7xpmjl5s04meqvv9hv79x509qzpmsqlfcq403lu8;98892;1;98892;0
7374;bc1q9gsvrsxuevd93x7h5t8jhkm6sjcjdel6qlxr4lm92x2m5zflxh5qwtg9qs;0;2;1278116;1278116
7375;151ka5k445RAKho16dKP8MXyofMCPCbpN4;1503668;55;70150614;68646946
7376;bc1pwkpylvsmaq5x63vt7437rl527hu6h8r6snpg34qwsp3mghzx0huqcxtuhl;1650;5;1650;0
7377;bc1quna93n9faefxukxp5t2kh8fw3fzxay78s8ckyy;19917472;111;19917472;0
7378;3HtCZVDAwQhJUwe6iNcbRWHACvaeL8Wk24;1223793;73;16711915;15488122
7379;bc1qg2fgvcujk2w2nln0tyzle5k4zmrea22she5mad;96914;1;96914;0
7380;bc1phvh8lzxmrl0e9h8u6s2wjvtvxy84y3y95jvvwrxv4r420zn0xkrska3qhg;553188;462;43033990;42480802
7381;bc1ph2vc8d3l9mjtf7eg0qtahddc66usjt7p604jsfw6dpthn88ejyxsnf8s2p;2184;3;2184;0
7382;bc1p9d86nukdvhnll2lypug2g4h2dc2nx7ukv49cswguqc68dqfla2gsgksxyt;24184;5;24184;0
7383;bc1qmc7kmnleqtckd6c7a6pue0zt92dyrrql2rahlfc42wpj6xvvpvcs409rfe;1022381;1;1022381;0
7384;bc1pgnfxwf709ar2e6mju4t7fqv2nvmpxva9x0qpkr0ag7tujzahqduqn4k4qe;281625;10;3560097;3278472
7385;bc1qjy0vm8zwj6lr0rzktsrdzl4wvxkr3kkyx8um4v;702197;339;171580053;170877856
7386;bc1pdj9kentynshvhvz98gnqzxafggen34p8a3wr9lv9247ukfh0fdyq5ch85q;4239936;41;82430526;78190590
7387;bc1pfdp60esxhf9a56jdr444wyugl5cg4xqfzd2pmtqlk9sxv8x03z0sw76sy5;221581;217;400610;179029
7388;3EgiM2fX8X7KTVLYgyUmTpUViLiEm7NE4z;4918008;4;23917536;18999528
7389;bc1pd337xn43jvv5jmr4jgemwtm2uej4wek85c59vp4ld6y9g3zpq96q7tfjjn;6552;8;2506552;2500000
7390;bc1qplu20c3pkh2vv6mnzdcsvc4a4maesc6570dj32;414754060;21;414754060;0
7391;bc1q9l8rmjfcx0j6uyuf838pftanuu26k8khpmm6xn;7825459;194;1152424693;1144599234
7392;bc1p0y5k9vt32yycjlkjsx4z59ugl293yuty3rn6ru64y8rm6qgylnmqawgath;0;15;1893108;1893108
7393;3P8KDwWFM2LfcG8J95QHs8Pm1CzXv6pzf2;529986;2;1123986;594000
7394;bc1qfwzv50ft34rqylxmsvf68gv27drhsjtyhyd2s0;214550;10;13448951;13234401
7395;bc1qam8c8ce7wkfs8ndt6vx69urlpp75yr0nsg9hlp;381012304;4840;2310219214562;2309838202258
7396;bc1pr3e34fuz8j8hgug6mawugmexhk0jmnfc9jeeuw6mggxuudq6ghlqk5p2dz;2180199;794;4220833;2040634
7397;3LBcatoSKQwT1SuE9aGsYCdUfuaxeCdiNZ;28764936;17;35110066;6345130
7398;1KfWCtFP7ZxDeoQ3TdhxvRmvQ8zhvVmkuY;7827507;27;7827507;0
7399;bc1qaevdusmzmuuffn80dgnsa6ug6qa369vf5pvcts;1323987;5;1323987;0
7400;bc1q07knnufkegezyr8n7eaqwsxjygreg8yxg8aqdz;0;2;77538;77538
7401;bc1pu28sw9p7nlq7ue47fzudzvhk987k7vtuhkz43elrc8a3xajnpews2q54j9;6959453;47;21483245;14523792
7402;bc1pt8rhn6dm6amwjr3tlyzllvy4gtr7uzdenwxa2q3mz54m2pzpevzqkcm58c;113916671;8069;413863043;299946372
7403;362TjXCBzA5C5K8ipGJyE8JUVFDNgU4gee;10802056;927;852366476;841564420
7404;bc1qa3zk5mnv29hcr3f5vczattnj878tfnkxfqq0zj;19713849554;224;1802081517848;1782367668294
7405;3CEzfUj9zbdzaHqs31cukPCnoKiY1XCyFP;3109317;275;1810000770;1806891453
7406;bc1pghw0ty98scuzpqe2qc9dykqzc57dxwst2vdku0x3vms0y320n7aqvgq7jk;546;1;546;0
7407;bc1p0p805382tguu2gjzs30kzg9c5c3960duj4d40smdtkcjcsxk5ndq8mgtg3;456053;4;1286895;830842
7408;bc1pm2s33a6xc5g7fc2xs0k54vjdsjk35s6fs8ecem9sx4wmapr33raqygn4zu;89307;6;1432708;1343401
7409;bc1p3dy2t0azalpjet8ttqv27wcp0shrj2056gw80qtrg4x9kqx2ypvqxjv8v4;3330;5;3330;0
7410;bc1qjl033nq7dpfcg3l3p78al34hlfsv2seg774drw;37772;9;502562;464790
7411;1JnNT9W28DiWitkAny9yAPhbVB9zRscn4Y;1006784;1;1006784;0
7412;3JcDkwp2na1hvQVheyAHLU4NMnAcNPzmBf;211641;1;211641;0
7413;bc1qplyyckh8mg0c7dwy8lelr99f609gzz73kfway7;1584075;1;1584075;0
7414;3FCS1bRKbeQavjnBSqSa3iRgM7vX3w5Hto;297540;1;297540;0
7415;bc1pmxu0lwup59vrqgvyqcsf5u7sxgxstyvfga47ejrgukkmcrkzn68s25nyr0;1634281;527;99868800;98234519
7416;bc1qschfcda64ky4mr80fheptj50axekhyacak9kqn;47651631;9598;106818749;59167118
7417;bc1p7cacky5uexrg83gq2uut7avwzt7qnjcltxn8andpxkv0at6tufvqln5322;7644;7;7644;0
7418;bc1p5k8w6e0u2ccfqnrr2q6zkfu44esh5r399s7d78ul63em8ltvmynsd675nq;3276;6;3276;0
7419;bc1qcq2nu6ed6hd64phnkc0lxdklmtuexal2y0qk9u;1405067755;18748;5465597375593;5464192307838
7420;bc1qxgr703tvq3av6avxhjuw4newsjv7aytyavsu8e;93164;19;93164;0
7421;bc1qwrtry4d3fatr44l4qxjvs6rh4j8ehumzg8cp0q;51960766;9423;116836989;64876223
7422;bc1q2us6cmxe7tj4dwn3k4nrlcmdl3ex6ahststpzl;51866;79;146143354;146091488
7423;bc1phwz0pv3628cr7q09ntertzealtj9sst8jrfg5s5vh86305phx9rqtk0jl7;1908307;780;2486482;578175
7424;bc1qmhq4sgtchfgh6ul75x3rsuegt55mef0zx3ehm2;4385541942;178241;835902983029814;835898597487872
7425;bc1p32nktsuffprllv0j93a2d3q33s0l6rlh598hynkgrt60lf6upqmqasw00d;155416647;8028;623437772;468021125
7426;bc1p6lex34gqrdvrxmqsvw4ztww7dskr9yhlsuc6e2rjvh7d8y0k25eqw9fcl0;10000;1;10000;0
7427;bc1phxfz3unsdw2lzps8wrvhrdlpw4txwe7jnt0m6uaxhuqptycl0lfqx6z654;1092;2;1092;0
7428;bc1qpm7q5je7j7e3k94eadsgd3akggwtwjfx6c5txy;43136;84;3704974;3661838
7429;bc1p0z6gdjpw7e7656qqrtuy6vgy6qgrh2l2pa6n8d7sztnvg2zhw0zs0qqulr;0;2;30000;30000
7430;bc1pc6j26puxfms3u2ekdd8lxj6vshyuusw609unyl06x9wm65lvtutqac7cxc;65883423;1651;6183463391;6117579968
7431;bc1pm68gqkjzx69wdr3psddrdjh8nx9nt7rfz070nnmpuz5scc4genlscswc4g;0;2;34000;34000
7432;39N34eTRX8UaVDU3QfqD2XEg8n31fhnTYA;8949937;6;27156256;18206319
7433;bc1qxr3njusumz6xzy76c8jkcwcm89ltevakxswt8w;96914;1;96914;0
7434;bc1pcd5gzmewe7vsqsvcq080t4dmse24mykqan4a9pvq44vqdpl664ksc7qcw9;34788;1;34788;0
7435;bc1p2fm6ujkxvkwywyrh3s5rwzenxej2svzcm0cqzs7nhruq0v73pctqg0cfxh;1968;6;11968;10000
7436;bc1quxfqmmdcv7keztvr6299ky9fq3fdl9ahwa0lxt;149728;1;149728;0
7437;bc1qzk700cuah4qnnwgnpvv9yfvvzeqq2wuxk5g7h2;9654860;34;9654860;0
7438;34W9Lnf7mDD4PNKCVvzhmWZdWkrqDjtWmq;156194;1;156194;0
7439;bc1pcqms2fr4ytkjda0svyrn56h0glpzq64mflerae9ku38rjluxusxqa954sh;9625272;305;9625272;0
7440;bc1qyukvjttmvldffsf7tndhu5gemlps90x0xqf4n7;132650;1;132650;0
7441;bc1p7yxqya4mwvdt088eu4vggr4cevsy9ql3rp32p4apqy24qala4qesx7ekz5;248835;63;275234;26399
7442;bc1p7ptsywxvpz2ykdaff3pe4vq3kpcrh9q99y4d30ze62yla9efjdwqt7znz3;227153;266;16447511;16220358
7443;bc1q5tnt08jshthy3f8ng3h5ym364akmqqjj42634p;472869224;57;959779260;486910036
7444;bc1qr35hws365juz5rtlsjtvmulu97957kqvr3zpw3;64675988509;166402;193979079271789;193914403283280
7445;33EDztHvU4D92yYxCuJ5sJ3RixPzR7Yk7L;8571392;247;811068569;802497177
7446;376LD86SZs1Z4hvoQXw7q7WuDi3yBKxXLZ;1079689;87;48008483;46928794
7447;bc1pdqukddxjw9zralar0dw75s969gw70v4estcdpht29l8x4y28jnxsu22f5n;1092;1;1092;0
7448;1GC2vtneok5zjgvyPGf9CnVmGhcG1bDaUY;389216;17;1462716;1073500
7449;bc1qzng784fxyzvj67sdvlxkl2neywk5ll7ayurslm;137957;1;137957;0
7450;bc1q77dq5s7azxzl3g2zsnap2rn4r0p8w9xqs3e92a;105012;21;105012;0
7451;3K6CFguYY2rQHcjTUdG5QJNrUHZ1ASpLaY;1248553;688;769827057;768578504
7452;bc1p32phtl6xvm863w38ae9jvexgz4ymj0p3a7n97kr6u5qefeuph2dsw7e32g;15806925;16189;11148382007;11132575082
7453;bc1ph0ppyjlm3zzdkchs023q0lcrtczxksy9684hpgupxecfw403ynrqal0xmd;18606;4;218904;200298
7454;1AR9sWV7ZR2C2ohGSDDKXipCfZ3RLGynHM;778942122;1254;33607393368;32828451246
7455;bc1pjke4vryfv4mhyt47kha443cweakcd0v0npdq85qqs36z4mw3mjgsx42w2q;9615889;483;348410484;338794595
7456;3Eg4KLju87bwXLUTES3hBw2rG5tahS9XiZ;7043686;78;188078914;181035228
7457;bc1pnpyqh2f9tefs5xx30348evuf7277hcj5et98t9c4jt66sznxxkgqa3putn;4937627;218;975235863;970298236
7458;bc1qcs0f3zn3f8tnnxgugd04sxe8938yhnfg52pxpc;758166;1;758166;0
7459;bc1pdjlxt7v4572fqkrlzdsx986l6zjtvl9s7ymazc4cv3rpxgqz3wlqhc76uz;115373583;7904;412362077;296988494
7460;bc1p349envul26dmhahl66hjslw3g4l286ssqgjxhrwkqrul9uzrwwesc04wls;346629;5;1076629;730000
7461;bc1pk2gh4y6facf0kfphztlcnjfkp8zh94zvx2pgleq2mwhr70spztjsmepts9;154198;299;30521884;30367686
7462;33GjwCnY4HGSFqRXkDFHMJdUXVt54LAd7c;63998;6;1212166;1148168
7463;bc1q02p0p3hlysdxmmekppk5whhevzvul3c3ppnvnv;551961478;56170;999480194;447518716
7464;bc1p0zjes3g3hhhpuegrenjm305sfvj4f7qd62d5twsx76hcyvnm75zqdct0mx;1092;9;3553;2461
7465;bc1pcl57jq4694jmt42wt69xqu2thaqk2gt2cxlkx79xxmxmlzmqfghqjzn6v7;0;2;25929;25929
7466;bc1qejm9u3seqz5c85mt7x9fgshrcvsc640wv927yr;342458;1;342458;0
7467;bc1pq5z0hvxnewyz2kr40j4d32nx9tn0jx0vvdsvjnlckjekyhdm0j6qh7w6hf;15124912;2128;16274788;1149876
7468;bc1pnhh0ssve8pw65rxxjfc7tlj8c8rgdu9adqq3f4m95vp4572rxqcqtyfmnh;420;1;420;0
7469;bc1qu5k5v56j5zwgnagltvdac4cku2vz0q9r0nagg6;50100000;2;50100000;0
7470;bc1qzpt0k8zhgsn3nlp22dwfnrgznawwftuzkrmk89;500000;1;500000;0
7471;bc1px9l7uak4m9pt3u0swh6akafzr6m23e8tqt8j22creevscfxfa86sgr0lwp;4391928;31;193585281;189193353
7472;bc1qudsk9z5tmps978lr5zgsv3x9kjdrtpsdk83x55;5929921;1422;529686292;523756371
7473;bc1qt6r23gmckla55mjdkqsd64797sgdtayj5sgna0;4129897;61;1617034300;1612904403
7474;3GANesA7QaQd5sz2yFfZfdu5tJv9FXZzuc;50929783;35;124490755;73560972
7475;bc1q6xpckrejvk8ecly5ggdlh6u05jp5m745xd2rj0;2505858;1;2505858;0
7476;3P4WqXDbSLRhzo2H6MT6YFbvBKBDPLbVtQ;16616601311;955132;50001712350;33385111039
7477;bc1qvnpc460l2u6k0qr8q4s6hqllqrjdf732lt42lz;32049630;15;32049630;0
7478;bc1p3x5nalrgryphy20tqskgsxt5fsljwnvs4uxq76m2nc54s8d4vs5qcuct0n;17268;40;42163;24895
7479;1BZEjWB2KpmViAnESYPi527Rsc6VGapJEF;25632545;3;33916707;8284162
7480;bc1pvwfjv2wtgqettx0plcs5fz04e62vz02s74cjldcv89cmaqmenqxqu5kkj8;104614;55;156717;52103
7481;bc1qprdtd7j8l8we9vx98y0pvytfgju7m8futkf4us;405452;3;466680;61228
7482;bc1pnqgj3gpkzjjy9yc7fhwpzlr098ypl6t87wnfe8tjaqmr9t94fh8qvmwl72;1092;1;1092;0
7483;bc1pul8q36hnneltaud56zxjam8pjv65vcaah2ef89n8wtm0ux4j20sqkaqey5;0;2;26000;26000
7484;bc1pcwsxrew88mfskswng6c2yhspnq3dcz86e3w2snsqr6fz3q9mqq6qqm934p;34475;1;34475;0
7485;3CmYbBAK6zgX2q428FLiSRfPrQS2ibp1XF;1530265;188;176184451;174654186
7486;3E9va1rmKU37fAVA8u81CMroLFgwkTY8LZ;1409538;4;4520959;3111421
7487;bc1pv94r7rhrjxq002j63k5eg3ete9hecquyvw24ymxsv0gpfcs498ssr8kcyu;160621;1;160621;0
7488;bc1pk89ks5h45f4ju78galw6dlh3v7qdkvq6szl0lhr3zeqq7rcfn4pskkwjdl;1266422;620;1390568;124146
7489;3MZ9o7VYEwmabJZv1hd4wZ6Dza1aGGyyEp;2099693;147;35982752;33883059
7490;bc1pcvvjdsdxttdv6kx6cvqhv20h6h5fkknhh7yyp48m92sxpne7q30qrp78vq;4935718;15;85706906;80771188
7491;bc1pluftdw07sdljsmtlnczkmcra3nv7t53lm9q829cpjna4qnwjxmrst5yvse;8175020;14;18868668;10693648
7492;bc1p557vh9qte0m76tyew50gr63vlc84nvrtqflhefkec7q3ks4v0geqknf9qc;10866;5;120208;109342
7493;bc1q5tlmf8muzyqlmlelmtavan00sjf893u9uj53pu;25314747283;376;4660105909034;4634791161751
7494;bc1pl9mpp0huxezh387dwz4jn56njyg66zxe27gyls8ak2v8c5qxfrnsnmlwxc;3098381;13;12792027;9693646
7495;bc1quh9jm6p06nqnvgvvv733pl0g0y6ycxl0aas2t4;8593531;7545;695628579;687035048
7496;bc1pyzpy3nsjanltv5qspjg74wm6qr3m5jds4qxxt79mdrzmqkqrrgnstzsy77;12730;8;13330;600
7497;bc1p9922et9k23lgr2pf4y0s4uar7zc07cu96tuh0w2dt205q6t3e34qtr7x02;46552751;2384;1596909624;1550356873
7498;35nnDNzmqVei3MiMDZ3sHe9MUFQxzGyAxe;79497;127;94116172;94036675
7499;3AdQ7eVARkwQfYT211uRkHt2DjdJb38SzL;158560;35;13787564;13629004
7500;bc1qvs2hts5u0mk06ayecd3m85ps5w5emuxtlxeg9x;46052672;9579;104485020;58432348
7501;bc1q967yql5pg0ucpvlfmhj4xxjadfekvt23ynpcwh;278662;46;14996734;14718072
7502;bc1pxn7npr0ua8hsh6nm98qx082udf3gh2k2fdngkqrwdjrtpf29mcks6ck3em;14980056;431;327939452;312959396
7503;bc1pamn85dvswqlmgrn2fdhrmu8rk3j2fnf2a52m2556nn0a4lh99fns44v4u3;194821;1;194821;0
7504;17v6tNsaSWCQGuZg8Cc1NxFwMqcQJj3vgb;854436;25;5538911;4684475
7505;bc1pkv2z7qfgk6tslfk9t8pe52x6mcxm9hql3we99lt7jqj3z4sz6pcqn64307;2184;2;2184;0
7506;bc1qhw4gzy89y2ew7e9pzvt4vyvxr7ulucxuu7ma8m;42069;1;42069;0
7507;bc1qzejwn2cws87tr2rqvuj8rhfsu5y9z2exyze5hf;55295;1;55295;0
7508;bc1qxdnspfsh9jqgg5a2ynj2j8khjs34dytjk86gju;1649516;1;1649516;0
7509;bc1ppf8pdsw6nnvk3vzkkxhlzdhhgfz9zaa0yh7qyfgk9d38g6ak0czq0smqey;0;2;23559;23559
7510;bc1pj668n0aqwg5kl75ntp7mxrudes2qfzpdj9wk8lfcpdvjrrzefkkselgm4g;188945;6;1986238;1797293
7511;bc1qvkvj3jwh3mrufeclq8eynetsp6kp6jjj4k85xx;72937;32;72937;0
7512;bc1q5yacgee6sn6ksduc3hy0ss77vcwnmsn4d0xas43szpcnmv05s0zqv30swu;697019;1;697019;0
7513;bc1qt73fs8q7d0ud5xhemnwxqajplmpae7ltrpptvr;29251087;4;63535450;34284363
7514;3HGQD7s5AnkjyyxzvqAbSQNHAaLGJYjWQh;6901631;11;35976157;29074526
7515;3HSt5druK8YavBREmNd33RgpSrqoG3kTRp;235613;1;235613;0
7516;bc1p9kky4yhefu6rakmca0g6jhk6v56lmzd6azvzpz00rdl846rlkefs292cum;0;2;28346;28346
7517;bc1p09gpkgluwtv4cxll7h3mpsu3z9z8z9nwx6fx200pk47376ec8slq3njsry;1824224;3969;1030955384;1029131160
7518;bc1qdnqts5tkud29jcyn2e2e3x8trnplwke4p49dmx;1636874;10;26125318;24488444
7519;bc1qec8sj2fhfrzjjeadq6xdmm47xmwffceckcvn67;2900000;397;525092194;522192194
7520;bc1prtaj8ghcpxvc8efut2dt25yrx90t90el8fzturqxcprdmx8mepwsmmd7lt;3184;11;954686;951502
7521;bc1pyeempw875cmd3dcdsa0jkh9jjv4cud4m904tzn06922h8r5yc6zqemtvvs;538993;11;2275122;1736129
7522;bc1pd337xn43jvv5jmr4jgemwtm2uej4wek85c59vp4ld6y9g3zpq96q7tfjjn;6552;8;2506552;2500000
7523;bc1p9srxdqx7u4u48ahj4s5gd3x5m932zm4fc4a4ds5ncm580nh864jqm37k26;117279340;7879;409713438;292434098
7524;bc1p0rl9hthgmfqj4u8nqekn6ag0dnvy2xl2wf4ct5tu6rjmuhvu375s8epg57;0;18;2593367;2593367
7525;38PRPd3Xh1pg42AVX11MQ7vpkKdV9yVHZU;343854;9;3076059;2732205
7526;bc1p0y5k9vt32yycjlkjsx4z59ugl293yuty3rn6ru64y8rm6qgylnmqawgath;0;15;1893108;1893108
7527;39HD3rQXVVuKbWGYwDXkhAUcTZa86F5eHV;322497;26;51770416;51447919
7528;bc1q6fmqp3ytm5nzqv00amknm63axjue2ueq3nj90k;59586798;11425;143212367;83625569
7529;bc1pt8rhn6dm6amwjr3tlyzllvy4gtr7uzdenwxa2q3mz54m2pzpevzqkcm58c;113916671;8069;413863043;299946372
7530;bc1q8llaek4l6crwleuf3gdvypxc42ljnw8a86g0ja;324673;29;324673;0
7531;bc1qmj7rjudzq9v8hasrpk84s7rtkxg8zh7sczwwg2;270827;32;270827;0
7532;bc1qr7pcuqwdgfk8nae466d0g9x2erdef0xpflzgca;0;12;1623179;1623179
7533;bc1qws5cw8sk3anvqtvlldur9mjukg3rsh5ufd8flf;1872257;1;1872257;0
7534;37Mhs7ykFmUzmVMjvT3c54K16MgumdZaiQ;1343698;40;29376670;28032972
7535;33cJuBZCmVV7npxR1kL16C5uSy8YDzRm2h;2520251;68;62445277;59925026
7536;bc1pnr0z509d56x9war5vt6c2v6yw33crafedfrz53yhy2fk747jyrnqngvx3m;2445497;10;15647952;13202455
7537;bc1qz2ls64u57fp292u0vxn22lp0kgqj6vy5e8xmm2;1200;35;39600;38400
7538;bc1ppnk3vnp60w62al2z0eejurpec34lqvakysetv7pcy6h9tya6avgsk6affp;479210;2;1479210;1000000
7539;1JpBZ5h87DAbsj7NNmJYuJKHEUnwob95aL;2796876;22;2796876;0
7540;3B3nyQwS9FRGL3gsZj5Hi4Uk543nBcTKjH;1192859;3;2568077;1375218
7541;bc1psy25h6v0qeks86mdjswjtxzvk7pvhsemd5t8uljdn3fqhd9440eswlfnjz;4914;11;5460;546
7542;bc1pymr2nrtmpz2lkatyw5za75ulx3vpdnayugaxjx2nuz20ef7gfznssyje72;11871512;308;11871512;0
7543;bc1pfcwz2gs7mq5rp24grqshzh5l07cvrvdre0xrvfwewu5dl92cez3qqp8tlz;16847;38;36276;19429
7544;3HsJ4xFKa1Fqivtr1QtVe8mJuTLsdGHuEH;2553475;11;7013156;4459681
7545;bc1qvdglygzjfrqrenjkjaja6fa5c9r4dxxvchq645st6qcqjj0mtqks3vsc9j;0;2;730169;730169
7546;bc1pam5mgcvnmnzd5jgqal0z9a4fyaekp58qyalwsyqp8tmz404qvs6slgrwa4;1638;2;1638;0
7547;bc1pec84qltanph8eswn8j7mvenc9yzpc7dk8plvm23z72zdwj5xznysz6npw8;7881;18;8427;546
7548;bc1pswwfzp54jjtm5fhsulhfk4aws3y7jt33k2v0uz7cpa6n6su3cveq9t6ut7;0;3;29000;29000
7549;bc1pee3ugdct7zxqqunydgm59zpn3s6fgmav6pa6m04hufr6w8ttl8msp7v7yv;350430;88;359096;8666
7550;bc1pkhtgg0qlu746n3ec5fvpqfdsuu5a9jq6myhakkzyr5y2azs5jtdqvwzdr9;534763;9;2907760;2372997
7551;bc1pwff84f2440j9q2w2wmtt4fal8nknttx4stvpv37tt072afldaxcqsyf2zr;2088015;16;6175680;4087665
7552;bc1pyrd0yky4c73flrz0nv0srgumejedr0d4g596rzsy7jev47tuf8cq0k7jh2;0;2;27035;27035
7553;bc1p5k8w6e0u2ccfqnrr2q6zkfu44esh5r399s7d78ul63em8ltvmynsd675nq;3822;7;3822;0
7554;bc1pkssn7rsej92gtej89lyx0wecq2h66qt3j3hvrak2mf84zswh48rqwmer89;10921;26;39821;28900
7555;bc1qhqcjtfn8y3pv9r593nuqzr304wvw73zhqtf9eg;109920;16;1214652;1104732
7556;bc1p32nktsuffprllv0j93a2d3q33s0l6rlh598hynkgrt60lf6upqmqasw00d;155399191;8027;623420316;468021125
7557;38DgJrNZKQSgCTM2fcygdyA3e9B1MSHbtH;1708114;90;406043032;404334918
7558;bc1qzn0rzwfy6vnzr8zdjew3wm2khe6x2z5vutwp37;536602;332;250182935;249646333
7559;bc1qgzq325z7g0yazy7hkn6jy2yny2dl5kf83p2dss;2949553;39;195313902;192364349
7560;17StnGroPUsNXBq4AVJQ1fqGftoFZh3zva;2309816925;42461;447527140922;445217323997
7561;bc1pe5hjd96yjfra3jkeyagrl79gf0n48luhv4paw9egmdhmzkdhnteqyszhzk;0;2;11666;11666
7562;37j72cpj9f3b5Vffcr7YATdKix8ptM21Pm;464752;10;2356013;1891261
7563;bc1ptchh0l95ql4zh04den4quulj3yaq59tjt285s5ugsd8dz9ytwwkquya5d5;0;20;3228537;3228537
7564;11vLTmnHZQprLXLhiBTjBvYFtyDfH3SVS;67856800;374;351923870;284067070
7565;bc1q3g5cvz9v09w9z9d4epxl0hpc2uhz87fyvyd46l;4945055;3;9945055;5000000
7566;bc1qyakae36m7zre6a0hqyw0hy5uwdxe09rm6nkwth;450000;1;450000;0
7567;bc1ppgu70dg6t86xs8n2s5t98h937da8pmy9ft2lnwg5mn8dejllw37qffhyfk;9889968;280;9889968;0
7568;bc1qlmugvk5ge0f8n5uaduna5utjqy7dyw3ehz8tqc;35171;1;35171;0
7569;bc1q44sg6jeqgrh2dhl5ld6dqgpmhrfzgh753ncleh;3610392;37;904099893;900489501
7570;bc1qq904ynep5mvwpjxdlyecgeupg22dm8am6cfvgq;328052557;403158;33386144515885;33385816463328
7571;bc1q94dfsmthahv796vd9ps0r0tekc89r32qqsq3pd;83318;1;83318;0
7572;bc1q8ecsgaupqxt384h4dpw04lyq9hvegac2zdfvp4;32874;1;32874;0
7573;3FfKjnbkGiUW99JGDWWvNR3B1nM8A1vyDP;1935890;5;5607644;3671754
7574;bc1pqwjm4dt0fhntnvs3a229nl9arwqmhdmgra56yajjdaqfk3pfnxxqa4mt8d;0;2;10276;10276
7575;39XuSofwsWFm5icjSNHtwM2zLG3iHseLNo;321115765;668;12344709321;12023593556
7576;bc1qnfmthny8f6ckt724l903fglt0tlpcks3z5tlx3;38191704;51;815042239;776850535
7577;bc1pcnv3zq5ykzu9pkmsdn64ky8lvkt39vtcqxz9ajalvgfulgn4ndjsztl7vd;28368005;49;186818410;158450405
7578;bc1pdjlxt7v4572fqkrlzdsx986l6zjtvl9s7ymazc4cv3rpxgqz3wlqhc76uz;115357918;7903;412346412;296988494
7579;bc1pjpay9563z3ql3ms5rnx98hj0dxkeup90tuj574vyxk90n7yy0f7s4h5lug;1437652;661;163246212;161808560
7580;bc1p9qgegepk77pyughc6zsqvl6sz6kv5tej8j8grdd5lem095efur9s0aayrh;1769045;1;1769045;0
7581;bc1px7yyjjzyrmndfctqn23lhj3j5frrvfgp6hdg6d4sdh5p8jwfzc4qwd9ydz;0;2;46000;46000
7582;bc1pxlg2jrlm8rs7ux4rlpc5pdjz5makmqrx7vqgdnzrvq4cplumfy0qgpcgtn;131811;1;131811;0
7583;bc1pasdekl8rx8z5macn8606hcze0xrqna4mwfphgy0srzn72n8fhmvq4yuev9;0;2;210000;210000
7584;3JrF88WaKY1eYDk8mMMj5zxE6vU81SGrfg;3416815;18;16432436;13015621
7585;bc1qh23vxua6mj89dcdhj4gkkn3dfrjz3xck243ufk;137236;5;137236;0
7586;bc1qfkr6ymdvgwpz5vagthxxw7uq9lqnvl443hjt9p;0;12;5267119;5267119
7587;bc1pq5z0hvxnewyz2kr40j4d32nx9tn0jx0vvdsvjnlckjekyhdm0j6qh7w6hf;15124911;2127;16274241;1149330
7588;bc1pw2tj4qfn89rcwd22s2psv28lv5zamzr0yye0vkl7gauy0dgu73cqrew6jp;0;2;36000;36000
7589;bc1ph09r0v3jlue3dmdnnagjlcmcw0lvjdgrrw3tj3y6zrs5ma790umqyx6ph5;500000;1;500000;0
7590;bc1p78jmyjyqv28yhmnvvwptjrvjwfzu5dksnaejsyllpfy30nnk9hgspw037d;3636;17;15878;12242
7591;bc1pl9fa7s244za6aj5fysc200r3nwfnnhaf7v7gsxlluuq5xfhlzvjszt54gw;0;2;29242;29242
7592;bc1p6s97kc9s4w4gp7q2605ds2v64jw5r02amktj0md8rq0daqgcn26qumgen7;0;2;26000;26000
7593;3P4WqXDbSLRhzo2H6MT6YFbvBKBDPLbVtQ;16616767313;955127;50001878352;33385111039
7594;bc1p5srnctka3nzumay7p8595nhaw8rf50jlhhjft33kqmqyenv00qwqccdhml;950000;2;950000;0
7595;bc1qldapsh7yws52nxfvp8msc6kag7jury3rxrw4dm;168300546;158003;4754200546;4585900000
7596;bc1pew6s05q67m9vryme0yjnh6xhafw2sldjq35zynxjer405lruz2gsnhapew;179139124;4498;225421398;46282274
7597;3NNm3Vnwj8GYkvLeLRjfkamW6JmWdaDJUj;2575262;18;2965262;390000
7598;bc1pu65s36fp9y724wsjxyywlp87j6m3kvy690kjj8gy8u6m2zcdpanqtum287;6491945;517;157749830;151257885
7599;bc1pt7f6ke8ssrexvvc4zt05flfhur2afu7452chw9r4nuvpwpmuatrs7dye0x;7016330;362;122353069;115336739
7600;3Levp6zgE7RbHdKUqxEigUShkifS31y4Lw;4519416;501;726587467;722068051
7601;3JcAPu5BFSki1QvmRJrj7XgEeZZbrTH892;2445000000;17;2445000000;0
7602;bc1p8uf7qdhsz92g2gal6q5e0ff02z2360gpm5u7le72nvpfhjak2yps0hyy6r;15822;8;15822;0
7603;bc1prj9mhy2zu40jgd558ka5r3a074md5pdgs0gug7m6dymj55crlglqy2625x;1535450;22;8598060;7062610
7604;bc1p0lvc9e4tyvpx49gtyfj8cchncqera5xw86mrlup0k0lv4tkglklqp6lahk;1240399;22;9669448;8429049
7605;bc1p6ehw24hqruc3m4wghrm3avvusc8aqqe0ah9trsnpk0py4sh8th6s3lec4d;810076;1;810076;0
7606;bc1pcn0kk3tdvwwdewf6w9g7eg9fdx4v6c4a85dem0v4dpuqvts6p23qtavqwt;461455;2;461455;0
7607;bc1pk94aqqttz3pffpjrgzdypg065qhkp8603a3z2jm9mwpa9xjdm9xq5m8hzu;1695278;1;1695278;0
7608;bc1qlps5xcg733tsk3eeuyvkdfqztwnglf0cmarmc2;697700;1465;216061072;215363372
7609;bc1pvey0mtv0d7phuznf3jet54kvcdjypyep3hwlt3mt2dcu6873t2aqg98lly;0;17;2301840;2301840
7610;bc1qve7mqswxwgtkxuag9xqc46g5p07y3u3mcfu3ja;4888;4;1050270016;1050265128
7611;35A4KqdhzrSRHYAdajkr9JT73Qjjk8hAFS;25599993;9;25599993;0
7612;bc1pej4gs4u0dncmf65ga0x90ez9hnlejyz24ztsxtutdt2s26mvra0qjt3djw;4992566;1759;276977231;271984665
7613;bc1p0a88ksgawz0c8se6zjnhny5a0h65790qx988u6s7w270wr77z9eq2ls8c6;681629;285;21282544;20600915
7614;bc1qya54kp940mq0wfu3uf5emyws8unufx84fchj4f;154285645;108;1874631443;1720345798
7615;3N4ot2Jf3reDtvDyf7axDXpHLjc4KBpvNL;285317;1;285317;0
7616;1GYE3gfo5iZWtCF7uggSfNA7Am5x7zzH6R;119152;2;119152;0
7617;35KxjHrJaVuVT9bcnd79ViLQQ2jhidfCFv;175000;1;175000;0
7618;bc1pcuqmqtaaapmx078u9xsmww5833xtt5vlecx63xjt742622cn3zmqexc7vr;2092;15;7822;5730
7619;bc1prt6c0e75pflsqn8a9p34xmmrvu20s768eqzqzdd3kcgzqhk5jrzqwgcj90;4318000;1;4318000;0
7620;bc1p5qyyythr3y3k573m3d3ga3y3pxvmlmxcsythdykxpwlxsfg5zf7qjlq0lh;2320652;1;2320652;0
7621;bc1qwpwxaycvxkeneuss5nzr4dqfnz90u6zxxw7tte;917067;8;5365974;4448907
7622;bc1q0yf7tkyrvxv0m3jnjvt0hdvhvdeeahdfplz2fn;898433;18;5084476;4186043
7623;bc1paaaf0dpukyv3c6qmjdz0ux5e5ye3xtzql3dt908tull9r2cddwtqcmd9sy;43111194;3;43111194;0
7624;bc1pukssg238h46sm8yygvj8kxe3lu4vczz9cc6nuwr9x55wrd2jnm4s6skcfe;775000;1;775000;0
7625;bc1qullk2d2e9ryqy0svwwkuw4y7zqn0qt6sagc2a8;7388000;170;733440847;726052847
7626;bc1pakv7d8drznp39092g7k4qc5qd0d6weqsa3rgc2auc7ahctzlmptq805vjw;0;2;2581391;2581391
7627;bc1pv68fjtw0fhey0n0pl3pgwrwhxhulg5z7d68v0mfg23lgdclylu9sww4sl2;98972;160;13803006;13704034
7628;bc1qgsmtclxrzcqf36rh9amy4nyrwtjlkczz2st0jj;20574;532;74835121;74814547
7629;bc1qnsupj8eqya02nm8v6tmk93zslu2e2z8chlmcej;15491010224;757167;748504116944884;748488625934660
7630;bc1p4ltw3zh65n2u8ep49xrwxvx6tu3kazn289ew8g7mdtg6rau6g5psw9zgwj;1092;1;1092;0
7631;bc1p5thl80kpa9kssdsupjte2tj2cqdl57nh5mzra8rt9f232vap2tysmh6fpd;124959;25;124959;0
7632;366cUSQhekanzHRXbJ2rEJigR6B3dVyGC8;548288;2;548288;0
7633;bc1pjwqgs2qner7ktd7p38fq3ju5ahewc29awyq2h6v485tjfncm8ets70k7rt;0;2;23000;23000
7634;bc1pwwyr9nwrj72uxl08arrrl4vlamxa30gjajdmh29h65hg7llplx3qj2lsqm;487000;2;487000;0
7635;bc1p3p6l62pax6qymyns5j22x0pze8zxsc4x4fpawthad37ytl0yc7ws42gz83;0;4;181177;181177
7636;bc1p60qq9ywrv3aqw7djazdtr3gxpx438cp502w9dkf9cdu95gu8rjequ488g8;449517;882;562832601;562383084
7637;bc1pazewnx6rq77m5uf9l4vhqqem8gmjq4wdzjrwu3v7vfcvlkxsskgsx9rlk8;1575000;1;1575000;0
7638;bc1qqvwvsf4le95ugjwj6nl3l5xdsye8xxd7q4w2j9;30837565;4;30837565;0
7639;bc1pgkxhzwva7dlw9glvf5l2sz2mf24a6e0emz9wtdhgjn0g874m89lqr2e98y;3103868;1;3103868;0
7640;3GJcGTgfBKxbDwfjQAYJSKzSVhxhEEamNj;804982;2;804982;0
7641;3FcahWu9umBTZDCqjw2quj6tpSrC85aMbY;628840;2;1314228;685388
7642;bc1pmqcs7e0zvyy6ymggye8ej888wfmhgeund8a4zfycs8paplvhmcssrple4a;49409;39;6317056;6267647
7643;196ffxyYwyM9x4YpWLQE3hWh1CG6oPNZHr;10000;1;10000;0
7644;3HvqyJtQDzduXpjwgQuHbQEC8rxUAXGynr;96824;210;131678652;131581828
7645;bc1qgxc40e2n883yr7z9cmudezm6cx0dp8g8q0jrrp;34198150;14;570900182;536702032
7646;bc1q4wl9aenz3m5kaqr0t9xfkmzqjk4r45ltlmugx7;2792596;1;2792596;0
7647;bc1quh9jm6p06nqnvgvvv733pl0g0y6ycxl0aas2t4;8618107;7557;695653155;687035048
7648;bc1quq29mutxkgxmjfdr7ayj3zd9ad0ld5mrhh89l2;69749442068;715088;475490549122514;475420799680446
7649;bc1pkh64k8vv5xhapys7fl3qpdvj8yf8q4ca2aagkfp8kv0lwytleyps9s04cg;115912599;936;8277068212;8161155613
7650;bc1parhpltljfyxren8aa6aaljwpvezxvnvjajmczzyxw5qeerqp83yqtvt2fx;104940;356;233340;128400
7651;bc1q46le3ygnvpqw6d9v5q090txmsneydu3hs5dpuu;8430947;19;145430434;136999487
7652;33aANM7XQEp6ngLY1i3WcYFcQJg5VC8J4D;1975000;1;1975000;0
7653;3J7LNSFMR3SBxnZN7MrqAqwFySyb9cQmVo;5102709;33;13385710;8283001
7654;bc1pf7ckq4pmu04a4n8l4lxrlv0may0wn9v9rll8meetycgn5awa7crs4zqm02;2000546;2;2000546;0
7655;37jz5DEUywvcd8QDQ1WEYifD8i9DCzLJnJ;1975000;1;1975000;0
7656;bc1qgxdqf7837dxe8xkhvctgc499kwh5xw7ap3uwhs;151380961836;49338;698209807651;546828845815
7657;3KbwykS7vL841jjwur1j8ffyoRzGtthgpv;1463798;1;1463798;0
7658;bc1p6cdtpjs269p088sahnwdpvxzhksgyujcdxjgrxh83g5h53a3cngsylvhy9;190645;184;1101656;911011
7659;bc1qexcf653hsnjt2l2zn88r50arsflm8hyqlsq7gl;2828771;1;2828771;0
7660;3Jhk14fJFGgSG6XZB8Txn7czqQw5mh5uGQ;1122000;1;1122000;0
7661;bc1qz72mh7lcr2fzn7csc52jpj4fff28e80w7nlq3u;1850000;2;1850000;0
7662;bc1peep3xzuqxgqmu03jezthanf6hjccrncgwrvl4730tw7q85gljunqtrx4k4;504117;10;5289772;4785655
7663;bc1qwjauegrf2sqhgxenafqlzydmn7q3t5d2yc2uzy;1500000;1;1500000;0
7664;bc1p4yw4xewjw5a6mtgx2wemtc50syfax32lwuy8gdq939yz5sngauuslq6guh;2569427;254;202931835;200362408
7665;bc1p9k74tzwr2nxtynlkqfansj6tmke36f89tg8a58t20976umyxm2ssd757xl;602624;963;791693777;791091153
7666;bc1qjr242hcxnss4jygjlkmlqt7d3aytaj58we6rcm;6534590;3693;55031347;48496757
7667;bc1q4v6vdk3dr5wmv9jfgqpf2kyv64jy92ljnday8n;94651;40;5776662;5682011
7668;3AdznRh5TXMtWUN9xzSSLLtA1uRdhKpSst;442532;13;29119327;28676795
7669;3PpW9KSswLNuZiaaimtvV8ezzgp3XfDnRN;364313;6;2495692;2131379
7670;3DzyejJgWFLpTLWDcf5J3NfzPYyWc2S1CY;4569509;1;4569509;0
7671;bc1pn9adl9aeyfxekjdlpytp84zfh6vdmrmly9n2jmkxc37vuts90nmsr5ftzl;875000;1;875000;0
7672;bc1q6e94vfe67h3726dgjv7tgqlgvzg2texs7n2fs7;407562;3;769665;362103
7673;bc1qsjgl0v9x5ew9h5g5ne20tm5fs3hkh8yaau9ued;2655511;18;9705352;7049841
7674;3PJL746BTx7rL2S8zqEoTGJq5QeftCuMFH;103578678;10;137321171;33742493
7675;32onoxTAi7SpcYv78FWEepCo15MdqcF6Yu;70137;47;19374021;19303884
7676;bc1pqdepdhfna4spws48rnft5kvk240jwql82kuf082763r5wh9y9vtql45mpr;130923;1;130923;0
7677;bc1phn43ue35htk38venk7wsmp9wtfgurmmajr895a3pp7uhgcf6hq4qggflkr;822159;348;76418958;75596799
7678;33bXAkuEnHSZrzv8gabomZntwxHVLLUzgZ;64260;1;64260;0
7679;35gWHMa2P766Y3UDbzEsjaUGneWxxhfE5u;219200000;8914;309610759456;309391559456
7680;bc1qf2gyua85nlyj6gf8qju2n4hccvnjlr0vknd466;0;5;140769568;140769568
7681;3EFFvCzFb3xmBAiBxXE2m5rZ4Fu3z7FKH4;1209099;6;18117624;16908525
7682;bc1pk03r93y6t893vn5m837pwnudyraxkdc8xvk0revztumxtx9h52es7qlve2;2989196;58;50755553;47766357
7683;3HDMmXWLf5na2AaitWvPodKcrTHv5qYZiv;7940567;1;7940567;0
7684;bc1qyreth7mkuv6y6uqmsx9826xcswfu6hg54ct9r9;126346;23;126346;0
7685;bc1qzlc08achguaxzp429zx5a0wcf4l0melj724f4l;49823;1;49823;0
7686;bc1p7calwrn4fszpzsjxrty4venyreleuwm72hctpg6wn5zeptyd8hksr8n5d2;602957;6;902957;300000
7687;bc1qu6cymp0nvjwq5fzft6cfq9pe9hwk65uc227xta;407007;331;26672374;26265367
7688;bc1q2nnfcrss5ttyhxpezjx93z9zjlc4c8k0nrahv7;755638;198;16901147;16145509
7689;bc1qs728kvlkxpt4d4hraf9rkcun4xg8kwpkhsah20;1200;41;46800;45600
7690;bc1q3u4qpmqhc78j2nm2y9yd5x4cj2856tzmkrup28;1735000;1;1735000;0
7691;bc1p8ne2n97kdhu8fxgsarah78lj2gh3vcf2s2jqj6fl3rzxq6ft3ewskju30d;774067;18;3501638;2727571
7692;32xQWRDbzg1f7rK2aUKhfeGqecmwtoa8UG;291355097;1;291355097;0
7693;bc1p8y4jxtllfufhw3ukd5ry33sy7gujrvsgg83k5r20djwg7ttkmhrsl7ew05;633468;24;5585933;4952465
7694;bc1p6zvqdkrm2wkx9206t0u9n8w852nu88ux5f60cw3wajln206rdgxqm422ym;2275000;1;2275000;0
7695;bc1pepf6r28p6gsnplwk9lwmj9cszfz7zlc8e358zldgyjuut2frdrzse5m7n3;1975000;3;4950000;2975000
7696;39m9zPZRCLz9o8gs3erjtUYeroCThdkbfB;311185;6;2245911;1934726
7697;bc1pwegvru46xrzkashxecu6etl5lk8kvycjxn6x80ayyrpvz273z9ls9g4560;25000;1;25000;0
7698;bc1pj2gn86alwpdgfttc3us6hm3xksa50qd5982nk6uug5hz2cw66plspmzgrk;76689;116;211419;134730
7699;bc1q7jgqxhezxkt3uraunxchg26w80seekrq3kq4agzq2kme2ue4evxs5twqns;328697389;6;328697389;0
7700;bc1pd5arr4taa3d6ggfyr4895p70p0jql84sty895rfw3n09976ceu6q07gcx9;975000;1;975000;0
7701;bc1prvrfjz2guud4zvwhd5a3mp8q0u6kddspp689sghkv8x2syc3xfrqteqcft;2730;5;2730;0
7702;bc1pd5xleku0wkd3pazla7vspg9tntggsrly6wysrxd5d32epjpv84csswu5zw;1337339;35;19871847;18534508
7703;3Cea4D3SaWvJ8mMAdwekFsigWe2EiJgCvG;500000;20;9532012;9032012
7704;bc1pk72j7x5w65d0sxm2t8xq8drldzeue5vndywagjtn65a25qlct7pqj6heez;14694616;1058;1190831026;1176136410
7705;bc1qf9vs33yjwnkspg4t64fxlj8vqfgaq0xhyh24m4;172666;1;172666;0
7706;bc1pdux82pjhjz92lukm6e3ar840afw0y06jartp0uhfvyagll0hp9lqtr693j;0;2;23204;23204
7707;3EnUGQfbSKzpYEwujASNVj6YHqJnnss4eQ;100000;1;100000;0
7708;bc1ph8axutuzl4mcfr2cd44m8k9mv2m6rqwkaakntpmhfrnfsqwe74yq7l8yjj;0;2;25000;25000
7709;bc1phl7ymw09lkl6ze9v5u6dsaq04dc0qzx9rr2dhllt26tmkdte9c5sd5qwhr;975000;1;975000;0
7710;bc1p7cacky5uexrg83gq2uut7avwzt7qnjcltxn8andpxkv0at6tufvqln5322;7644;7;7644;0
7711;bc1qx6kfg40ggl54t5vaqnwxut4y5un9ns5u8607ps;117697;1;117697;0
7712;bc1ql62fscshet7pc5scx9uwmn7xyckccu88uf2z4w;0;2;16736098;16736098
7713;bc1q0gsqx6wsncxalcxwsncq3ty5t6s6kg352f64nd;400000;1;400000;0
7714;bc1pcu2z7jndvt8grnpy3w030ru83n8e4tv0et6td84779nhr5j44p0q60zan8;35965;1;35965;0
7715;32F6wCFfupQVwH8N2RuBSotYcjhPa44WYd;324880;8;1652511;1327631
7716;bc1ppq0tjvkm7f0pyxy3xrc82pqaqfmytjqpnpl06nnnjv4f23gwh68s7y4uln;10546;2;10546;0
7717;36uA5NRiAHyGVF6dT39yY2KgcTNwZJ1U6J;37651274;3326;427409652;389758378
7718;bc1px36uquhj48wryeqlme744p88spvpd3z8ae6nsd7mfcl4s86sp69q3lz0x2;590243;154;19333744;18743501
7719;bc1qlw6fag5dk2uqmxf3zts74eg4w30jkfy2w8lu9j;9099597;1;9099597;0
7720;bc1qka9595wg3lveqm3a8jv8nag8qr42x995wnja80;1080120;23;45349867;44269747
7721;31rpFFdYibJ6uZMroyekW5nWWnvpzUuoKw;227595;3;436805;209210
7722;bc1pnr7h2u0nh9qg3fnlxmjqt8gwc9vmguay2g99mjtza6srpsz75gcsnmagey;0;10;736659;736659
7723;3BhUuV2PoAL5itM9YhZed6Gc6eXsjmxVgR;432645;3;1738867;1306222
7724;bc1p3h95yrga9j789j4afaplgz2frc28euw2vzchqmjmwfh305lw0kyqav3ak2;975000;1;975000;0
7725;bc1ptchh0l95ql4zh04den4quulj3yaq59tjt285s5ugsd8dz9ytwwkquya5d5;0;20;3228537;3228537
7726;bc1q66dn3y49wezzgrr6vqju6gg567vugq6e2al3w7;661382;3;1536382;875000
7727;bc1pzdhm30jte3403n6xq3f97a99qjfm09zdrvxs0zz27jtzte0pu8eqazq9rh;183963;411;65609501;65425538
7728;bc1qm34lsc65zpw79lxes69zkqmk6ee3ewf0j77s3h;1933868551046;1370641;4533926069363661;4531992200812615
7729;bc1pnf7rkl9cvjpsfnrd8qk3hhrv959sp45gznmnrvt7pljfeg8yav2stfl8sg;592112;55;41435281;40843169
7730;bc1pwtdaddqmvlwt3pgddsdgajt6evdfnpf9xjqx08xrxsr3me98x8esx9mwld;22102;27;27349;5247
7731;bc1p07snax7s6tack5ug2kq9vc2k62q8jnfwnfpk8s9wyd2v5d4ltwaqeh9ekj;14345793;626;287968658;273622865
7732;bc1qkvsul072w500ed2yhzwkajgxt50ts5ntq5jnf0;139690;2;139690;0
7733;3MEGCiBXRV5uaiYhm4ZomZo7mZwKTxiPYY;70330;2;518384;448054
7734;bc1pah37tmeda4dw645mw68n3xl73a09hf88mrsrvpy3an4eeyrcmussxekxf9;475000;1;475000;0
7735;bc1q86rsplxqqw56vyx62sspfelyathmx8eejvh2ym;158965;25;158965;0
7736;bc1pthllkssy75qmcuzr55nu3fdnumepzamn3ln5976gj5qratcntm0sr9wgqz;0;2;213793;213793
7737;bc1p2kygxg0q6wldg7s2nmxjuu0dwffe56lljnsagq6katuvgpdx4qhsmty36x;32701126;10;369369908;336668782
7738;3Eb2hSmixb7WBukiE5Fb7GFaTibGpWsSYx;567408;1;567408;0
7739;bc1p77m3jv28m5p4lz8t7pkpy9946yp8ylcqjdmlgzewcc8y6m3z46fqgnzdhj;8617756;205;67570897;58953141
7740;bc1pghl3waru9w44qjhpd2tx74ucwh5yxfhzyz08wj48mawqsdphlekqvgakxg;46415;25;48653;2238
7741;bc1qrfwremxfhr7m6hlm3gh5l6lz09k7dtf2mga3lc;18366103;2;18366103;0
7742;bc1qk4y4p4gdnlcpjulw6gmqxxevxkv7n8hmrdzftr;5457830;1;5457830;0
7743;36CDH7WQzQbA3XsfgFg26jvp4nznbcJN2v;1726648;46;51379303;49652655
7744;3LTadDPPRRUXRRqUH7tXjtzS7BUeb1JG6M;2968004;1;2968004;0
7745;37jAAWEdJ9D9mXybRobcveioxSkt7Lkwog;1637114125;355665;13393090716246;13391453602121
7746;bc1q3l7709mtkst3m8vqm9jl935e9jfeag4q4a07kn;1569;1;1569;0
7747;bc1q768hpmx37rapuvp7yc75gwn7h8mvqh7w35t34c;8608317;1;8608317;0
7748;bc1pwv38fmy2uyykzgmfkpgf5qdxnukkr39wtesxfa8l4em6dzzr5sssveylnj;752300;1;752300;0
7749;3NGW7ZCPPRUDQD8oyutdN3DrwF7FCKsfsD;485000;1;485000;0
7750;1NDxDDSHVHvSv48vd27NNHkXHYZjDdVLss;174003893;647;27528113777;27354109884
7751;1G795dRq33c1qbaWpSuvQzmfED4p4jTCA8;24295230;10;24295230;0
7752;bc1p6wa9ef6jmwx2mppdu87ldrp9xv63e6q9k2y6v82265hyl6sdfs0qzlrktd;10633792;289;10633792;0
7753;bc1q4ghv4e4et7xuw29r8ur6mplhs8sfvwlplrqpah;1570;1;1570;0
7754;bc1pajtkkmz5eq4rumgdjhms62203lrz4g6p2df07vn8gr7m5zjf555qkera45;6647600;1;6647600;0
7755;31ovYxd6knAQE6Y5eN9xM1YTieAN579zGM;54849;1;54849;0
7756;bc1phwv2dx28medh7lrcgukkm8r55r00mrgc22uj2eshyrs72nexq9cqzxp4y7;12049640;321;12049640;0
7757;3CtK1EWiV7WZhWTNTbWGnWs3gE95n1W4Xm;162814;212;72474026;72311212
7758;bc1qrvjzp37usa4j04gutda3g5clf7r9pne72g2qqe;332655;8;332655;0
7759;bc1pcnmz48fz3f3x6nth2aczg6d28kr6xx2s6c0tgztzfpeh8z5x565sgdawg2;2321651;1;2321651;0
7760;3AnoAqskuv1mhtSMMsbiY9zi7AARhVGuAy;988264;30;18142380;17154116
7761;31yuSoYmpkV5TDxuMh2GUfchJFef4kHyus;24719817;31691;5362064733;5337344916
7762;bc1pzre5u5c3qlwltp4cz807teqqyzq85v2mvq4rtff5ahel7ckf0luquv50lz;259501;454;265456908;265197407
7763;bc1pquz62anahzfwnqf9wagynvdp8hv7ehy2agxlgy72h0hxs058zqfqk8ksyq;25194532;105690;328907910;303713378
7764;bc1qs5rvq9c95qjpps2q0nekncgfx0x2lepykvzda0;45683;1;45683;0
7765;bc1pkl343mf5y56mfy99xwu2j6mp4k6wt29hd7ysj8l5kwpdqlz2lc8sxgufgy;10551472;779;213818776;203267304
7766;bc1pp84rlx3263eakv8xg5ek9cemvzhf7rne0u6fsjsppr67lmq5nugquhc294;403541;1;403541;0
7767;bc1qk69tx4cauw9wp6l2t77h9hy3wpwrcdj590dtvc;65000;1;65000;0
7768;bc1pzucp0ycqqs0jp5mt2t55equs3axfd8vf8902hqxd3p7amnwct74sw2u6cm;24618;66;37953;13335
7769;bc1qp6kuwfduhd9wy3482ysmp862fgwq7je2drhj3v;640215;62;239323306;238683091
7770;bc1qmwhgm09hanhvy2ln93q44wus85gkxupz8g3f93;1090986;4;19699510;18608524
7771;bc1pcnvdm09dj3wqlel6uxjhgrcjx33g8yyr3gw8mr8x7l9cy2mhx7ysanwydv;0;2;26288;26288
7772;3CJ7ysgq7bs1bFxXzGSuAUM3HSG7m5FRSj;3853531;38;27612900;23759369
7773;3HoTSCN6YWN3f3Q2HLDHoPAnMfRacQjVbW;42834410;10;89165469;46331059
7774;bc1pr6taqgyewua38pqk0qe0sghtqrtlhx0u04zv39dpat0m2t63z2ss8zmghu;5022494;144;1648901358;1643878864
7775;bc1pafk00fc29njhkfhgatklukn4cz6wj4pt0rz862edsz9gg3547u5ql5xctp;106330;120;5977985;5871655
7776;bc1q2tg3dzt6w468evd3vckqj8gtj2uzehd5za02lw;14963937;1;14963937;0
7777;37Q5Q5rs9tzBG3QuM48qyzdVSccXudSEK4;119068;40;49788468;49669400
7778;bc1qpu0gh6wmpwhvu5zhjm40n0mucsk8ysnhzz2prd;184699;31;184699;0
7779;3P1dehec9ywr3TtopdpEWk94qjoEdWTvW7;15685;1;15685;0
7780;3FfBxMfttmAvtaqkpqtUxUFKxnauX1MCce;2413385;127;386163821;383750436
7781;1LRNr7fjrzPvJcuWXH2keGjHwNizt9v9u3;1192538;3;1192538;0
7782;3FYaPYevgKSQuFkXNu4XmLpLCZseGLQdC2;389584;66;63732491;63342907
7783;bc1qt32z3efq588ev8cuuls23h02t9mq36792z4z03;21207353;7726;74038048007;74016840654
7784;bc1pwjna8h2epv73aa4atmqfztm9mj25f957vdemprn7ezukygwcrz3sm5xk49;10847200;289;10847200;0
7785;bc1q202rwadss5k6phxjazugjp87ncjmt62szj0ylk;205758900;561;650957729;445198829
7786;3Jwydy1Jfn9TzCdXnoycWL3oba6FTK2KnB;1858051;62;76773632;74915581
7787;bc1pwyxq0pxm9a4ushckeel5zxhq0kh4esr2epaald72dec5csqjqjjsfrgxun;3822;4;3822;0
7788;124ic7ruBPiXthUdXoDu58m3r2DpAYcRa6;18000000;5;94926252;76926252
7789;bc1pyjgg6799c9fazdv3tmr33cp5maepq84yes9hfvua2j7sewskxfws0jpc5p;86265;33;86811;546
7790;bc1pgsq4mmcrpjzgekw0d6r2zzkpzjhldxn6yyrfcl93ptlq0fy7t23qmmcdzn;0;8;459837;459837
7791;bc1p233yerwey949jkz9t7dyynw4yz84nx6m3z5uv27eq4dywpgg8jjqgtxnxt;0;10;740214;740214
7792;bc1plm6cy2mcumfrxmd9un4z9r09uence0szv7x8gkt0zcge6tdv8gks9xnjcl;0;2;16671;16671
7793;bc1pdscfmuj7lvtuwlvez9lvj5jyj7s08zqhlrsw2c2cfqz8pfjekrus04wqdv;88227;34;111672;23445
7794;3E3t3A9xf2Cm6CWkdvYhvpCDbdQzuzxjuY;8043514;3;23850660;15807146
7795;bc1pp64vnyx0fxs2c9cyq2k80a9f5s7v6kzq7xnkr0mtaxjtcvgr2gzsnnrxe7;0;5;158532;158532
7796;bc1pl04m0hnu86qnkzhtvw7cpylvsd5p983q59sw9demdsfghq97582ql3m30d;9872103;2;19872103;10000000
7797;34enKVYKzKUE4rvjZ6zF3oGkHxY9CkXrKm;180195;3;990819;810624
7798;bc1pfewahnqzlz2ga6yw88yskqjp8wqnqfrchwvu4ewwhmqg5k74nhzstxz4mm;5085539564;9882;25837361275128;25832275735564
7799;bc1q40e98as8pu2at3gl6f3ke79hk7fpcxytnqnpjt;100000;1;100000;0
7800;3Q5ZK4WtiGnc7pdWFrydQHC1XAJ1Av8g4u;971312;2;971312;0
7801;bc1pwwy73fkhdaemv9h3p9r87snm4lvtdvkxqdj7wwq88wfm0vsdthvs4v59v9;186715;409;683165;496450
7802;bc1q2tmcnlducr60amyqluh2z3rxgjvegdj884ms85;120800;1;120800;0
7803;bc1pufml5dwztn5qnyschemfd2u58h96j4zs0l3vjm0nuy2kup07jh8q0w5dx6;51904;45;834978;783074
7804;bc1pjzwuhqprkhtspmd7jdgd9f3jt2mqrh6d5374ev2v9w5hxzh5hzkqgwgvgl;73398;111;246380;172982
7805;bc1qp32szg2w60kn3mserdjpw7tjnqxu4ch2xmkzq6;273921;4;1808343;1534422
7806;bc1qlmuh74alvvmm079lguej3868uyktpgpm07e78j;378956;4;3113620;2734664
7807;353L8z3DuvYJrSNVvs6WF5dnvSyKfSf6jN;825699;184;200482336;199656637
7808;3JnTRHxng3QejfL7mFXRshT4evgqrpy7PN;2991432;24;157940989;154949557
7809;1KoxcSXRhjK2tKsomMEBG3w5YteFUDXDVC;1000000;1;1000000;0
7810;bc1pcsp7e3lfp5k9a5cexy25s5eu9660my9g8m3ucvy8u4ukc94d88cskadkam;954638;552;127858181;126903543
7811;bc1pkkty304p980rsnud60x83n0t6zk6q9y3yx94e8ktxlmkrsjjpavqcuejpm;49954;35;64869;14915
7812;bc1p3fkxvsamr6jutyw789vj9ka2kya9wtcaw7w45g4mzlf9tzuhnfeqyj0a4k;18970;21;19516;546
7813;bc1pd337xn43jvv5jmr4jgemwtm2uej4wek85c59vp4ld6y9g3zpq96q7tfjjn;6552;8;2506552;2500000
7814;bc1q0qd2vjpwnxzn6zvfxqd9hmum2sdnhftraxqqlz;634965;107;27005639;26370674
7815;bc1qdg6q0rwx6cryu42rs9ljp3ft8ytu33nmr27zps;4979693;1;4979693;0
7816;bc1pmtdggt3xsraucfjq79gvf3hn36rayyumgpj0ksauucc26f7pan7sum8f30;3585491;19;18057919;14472428
7817;bc1qgdyrkmjmgfwqmn95a0elxc8a6yntmrk02hjsj2;100000;1;100000;0
7818;bc1q5fdgjw8r97f63t0p5qhvu8rg9sf7jcwrntfwgl;170683;1;170683;0
7819;bc1p8nhncwk30sfk7gwef052l4ulpkvq39mtkcej4qn49gulveg6s65q0pd5gy;2008313;11;11152232;9143919
7820;3DSo7zd3YdJ5hAgfDxGqd3NkWuWUX81uKC;7447620;2;14947620;7500000
7821;bc1p3g9ejjq28h7vf7k7ksqav90hpe6vedt4aerc8jsvldwct32g5wus30582j;16308928;23;81522161;65213233
7822;bc1qsx832wd42rvhjkrud683yatx3ecgyc7v58lqynjgg3wzwm9nsn2s0fm95q;7104302;1;7104302;0
7823;37pg6A2MZ81pp7f7ABDd2xG49qfAJhG3Jn;22617875;6;51742875;29125000
7824;38sjcDCS9WRG2MsSup8LFC9wzeQNUjYMz5;105526;12;984619;879093
7825;bc1p23rw062jm8x9a24rpd5f6zkr5ym44a6578jr27tf476j83hrraeqs4h4gu;677785;1024;82093511;81415726
7826;bc1prcf5p4vjyr2fqzd869zjn4pk5w4p4fyk6an0d8kehvyz8dk32xest5ygp5;0;2;68000;68000
7827;bc1pymr2nrtmpz2lkatyw5za75ulx3vpdnayugaxjx2nuz20ef7gfznssyje72;11839656;307;11839656;0
7828;3NiE2QUYEkHLUWWrTJUHnXipp7qEgCk4V6;835333;164;178817912;177982579
7829;bc1qyzq8ewvm4ckr5kee8qykdu5mw2x0u3960vp8jf;1699834;1;1699834;0
7830;bc1pvvllkus2rqczh7pgvcdrxk8j3q7yrfmnw90n70qngvn84m2xs28q7j76zz;27022;10;27022;0
7831;bc1plne00rquxe6afmvu4jfk8hc5t5xz9swp04lyp8p7vke8h4wsdhss08m2vc;129194;18;18725073;18595879
7832;bc1ph0057nc25ka94z8ydg43j8tnnp38u3hxpadutnt4n3jyfrmjzmcqw99mk2;26461077;17733;13013161985;12986700908
7833;bc1p8ypfk5fccrhgt0gxpckahrk4nss9z8t8qy4a4sc2f0ayzjspdp8qtj4np3;12000;3;12000;0
7834;1Ka8WuYg9AWyqWPPQg9T5HJ8PP5rgs6ihK;85864;19;8560482;8474618
7835;3K5PuuqtKcbea7GnDzo4kinrBooMYpREPL;2257920;2;2257920;0
7836;3JGQVn5DLCCckZjwbdW3S7ZPAHJ86ff6yD;1307904;3;2650777;1342873
7837;bc1pj84czvznynv4uyexlfda57mv2r63apmvn5vz94tuqlvgvf6u3chqlvrx2a;115976225;1185;4222525386;4106549161
7838;bc1qa0fp0sw3fwkhlk74f66jfmr5pd5pzgs6t772jp7z4ce2s3kp67hs5c5rmm;1889985;2;1889985;0
7839;bc1q9v2wepme76qxrqmnp0t84sfss84njnwes99e9u;0;2;47000;47000
7840;3MPY2f562rhxfXi1bFMhgREKRzrGhewuBb;4678611;3;15649121;10970510
7841;bc1qvfdcdkvj44p28nvegzmm9a793xcscd350lufdn;970922;1;970922;0
7842;3Nj8WTm3pjVuY4vw8A65ypAXcmy9azzMHE;681980;11;3773959;3091979
7843;bc1pkcy88m9xsxjqjml0wwypcnqsfqtfkf6u59z629m6lj4l03g0guxqmc05j5;6552;7;6552;0
7844;3LuPjJchc6UCdgRxmVJ27bfExypGLyujUs;11244883;9;32672944;21428061
7845;bc1pnfdrxsja50kaefrl550lws8zws6h57vvkph7asa59r5n7l0wftmqy2vzt6;310344;1;310344;0
7846;bc1pnhw6uv8su6ejav9ncdcgmchtn4uevp2m0dmuqnlhh75ga92qzrjqtrjxv8;58419;475;5069721;5011302
7847;bc1pcqms2fr4ytkjda0svyrn56h0glpzq64mflerae9ku38rjluxusxqa954sh;10445416;312;10445416;0
7848;bc1pn9exvrz4kw7jdr6vtqehwt3pktgfqyqyfdxwy6jcc95rh7tfvrys2026e5;229073;12;4095084;3866011
7849;bc1pl35wn7k578zg55exz799m6v6pnu563wg34t7yg7jsnmxpmvw5fdscdsmvu;11298808;279;11298808;0
7850;3J5okkDJoWVR4NpGxs9UErgrjN2uYCfPok;2352734;106;41139670;38786936
7851;bc1p48enudcyagztwx53xjr55dqmm2pu6de0hsesxwue2tqk64cqr08sl3qhq7;0;10;747567;747567
7852;bc1pn7n0zaq7g9ley9aujgqzf0s5l9fgck7lxt8p3znx3xhvfxkg8p4syk4nk7;3399;75;102699;99300
7853;bc1qpq43n2dewv9tpxtvcehdxunys35vs07k9hh6ae;84971;1;84971;0
7854;3FG2ESDyJWEArDVeEmswGazYjELVG2zod9;10217709;20;30364496;20146787
7855;bc1p6wa9ef6jmwx2mppdu87ldrp9xv63e6q9k2y6v82265hyl6sdfs0qzlrktd;12045424;291;12045424;0
7856;bc1qq6fl7xqx8kmfs8thkdjfzu0cgcsegerqcgxkg5;36120;1;36120;0
7857;3FTcJojx9ovJzqnZ7Fha2HoQVisyeTHoeR;199396;7;6542792;6343396
7858;bc1pvjt83qmg2mq3tj6nyxjk0pgu47fyrfny7f892kd390zxd53yngnqfa9kzq;1638;2;1638;0
7859;bc1q02p0p3hlysdxmmekppk5whhevzvul3c3ppnvnv;551961478;56170;999480194;447518716
7860;3MoxedxbAZu7Vz6CGA9HWMxrQ1osEP1TQc;110809;3;628449;517640
7861;bc1p8pk7dfsuh37lrky6n2pqhajej7zz07vd5aq2w6rh7xze6kgtrhssq88lfs;1092;1;1092;0
7862;bc1qx4x2mxjf3vreug62py9lyedyvysdaz5qsnxjmn;364486;2;364486;0
7863;bc1qh5xn2pg85e3pwmswegav5tkjd8f6mn26l9p48q;0;2;825892;825892
7864;3P4WqXDbSLRhzo2H6MT6YFbvBKBDPLbVtQ;16621834190;955137;50006945229;33385111039
7865;3K2Ag91UCnfz5yRptFJPbYnLgBcnzujK4X;2317235;20;2780712;463477
7866;bc1qkk9x0zj7jwtvfev8hpadjp0hqzst2c4um457j4;2811317;1929;7248872800;7246061483
7867;bc1q4479xgqpv88h7e4gu4n9yn0elu99swgd3m2r4c;15694;1;15694;0
7868;1KnCcBZud2YUQyLbauSTcszhHQNDcuD91C;10000;1;10000;0
7869;3ExqBE4prL7GXjH78198okPxA96221AHBh;6928261;3;16892687;9964426
7870;bc1pxculxv3f3pm6zut9vutt0cmhq20d498hms532gsgln8dyysgg05shv7t46;0;2;105000;105000
7871;3KQ6FQ5UUm9TgbNR9D8FVePYS1TydnNP2L;744974;3;4430034;3685060
7872;15L9ogacXXB6Z6GxGPz9znwSXXGyKbgRTv;615408;18;2345411;1730003
7873;17KGVCC4VtrQzaYVxHHW2iTXemCgU3rUgf;156342;1;156342;0
7874;bc1q5sfgzqc6yu3hmq30xwurh2gxtpckta5k4k9tqc;665065;551;56200664;55535599
7875;1DE5UvrGLD9PWe3vTU9KSntPR49eELzUcm;521426;5;521426;0
7876;bc1pdktxz3jj9d6yhdjfyjyxk4m83x0a0len5j5j8nruu4ruqz2lph5stj80vw;524521;390;1797183;1272662
7877;bc1p3p6l62pax6qymyns5j22x0pze8zxsc4x4fpawthad37ytl0yc7ws42gz83;0;4;181177;181177
7878;14nVUmXhxZnh7RBGn3T6QiG9c6edoAqHb1;775510;63;29962879;29187369
7879;bc1ppk3f45l9epsrxyu2vp8ertfuvw636paex57ayp5mw7mhn5h37yjq3x2asm;1150000;1;1150000;0
7880;bc1q3j3vygcahng6c440stgnyqvt766kzyzrw4flz8pwa4pax06wevmsu24amw;45572120;1;45572120;0
7881;3KHB4CznajZvQAnb2JzxoRUZ8Kwy1sYXFx;5109891;12;29803897;24694006
7882;bc1qumxdwtnl57pp93wt3rxruw2qhfjh8dctvptw7d;8625061;18;73364546;64739485
7883;bc1p0288ntwa6lawt34prdsu28mj8w3xt58qxal52kpq72grx55l4z3q7gyjru;22491;40;10818312;10795821
7884;bc1pj4phec763pz60gn2fry3ysc0hcwml4gmf0cfd75942cws2u8y4vqsldthq;1150000;1;1150000;0
7885;bc1p6t6phdhzel0a7kxh7dr7ra584f2nl49rhusvwzzfttsfvjs9pnwsmtn9j7;1759994;240;127584099;125824105
7886;bc1pl04m0hnu86qnkzhtvw7cpylvsd5p983q59sw9demdsfghq97582ql3m30d;9872103;2;19872103;10000000
7887;3GEqeyCs14fUVdh9o2wMPKwcnMwXuU4cqW;194421342;620;1328470382;1134049040
7888;39Q9cP7YSpHSPCU2Vt7VyVNqbpjPj33eqW;720000;1;720000;0
7889;3Ep6ribawmq3vd3CzjH9oUJc7hYaYmyw1Y;50089000;3;100589000;50500000
7890;17CGzYWDccwgyfeBwPbyMhHkn3gbq1mMfi;312378;19;2783224;2470846
7891;3NYVNrEZKVe68tnaRcrbQNFexvnVnCEdmE;737994;5;5057492;4319498
7892;bc1qkkyg2rs9aklpzl6dn4cd3wuas3arr5z4e4cy0w;47806;1;47806;0
7893;1DFb55dfLsvScBGyyDHeEjrbBhapnQRobu;41108;3;41108;0
7894;32ff6t5dD7BdXyx91UEwMQtEvkfr5xXJse;7850;1;7850;0
7895;bc1pvueeq00qf9kmcm6qcth6y4dssem2nsep7pm90npdns0d2tmr498qlpqpey;19900166;517;20879206;979040
7896;bc1pv6qrn7aq27xwfyqfmq7ga47z7njahse4y6jpv5jcxjxvtlr90zqseu8ytg;2184;6;771345;769161
7897;bc1q4tx962fn2kwdu6wuk7ehz9sjthaa7dttz7cghn;362122;16;655124;293002
7898;3EHPWamjeajBNYfr3m8jESDrT2J8JMToNX;1975770;74;69121804;67146034
7899;bc1pm5ts6h2rsrffrukmkpk2tnrnrn4cla40v633wkmamhe75sjs869qzp7kfn;307546;1;307546;0
7900;bc1p80tp8k6k5cdjhpv9l3vgyjmcc6gd4qzhx4kwf6ruwudum8dfu5ms9f88mx;1150000;1;1150000;0
7901;bc1qgw0df7h0segckt80eeguymlkrsm7ac46xay4tp;46074288;283;826229644;780155356
7902;bc1qfs9ypqtztkjfyc3z3r7eanmrjp5wqc4886kz04;420690;1;420690;0
7903;38UBi1sake8p69NfU2QhDMP1X32n9jwoRE;1157210;8;9833311;8676101
7904;13oHUAju3Mz4r5HdV3oCr7pFdzeb686H64;235648;5;345733;110085
7905;bc1pr0zt64smp559x4fkhu8qs6073hrn4l2re6pdr4cptdm9alxq8pnqkcgngl;0;2;99836;99836
7906;3LWe2kUcckMc8XzYaGyZheXCuRw7rQcqip;3049960;3;6149960;3100000
7907;bc1qahruf7fh9ffx9pqp43ntwu2qknguyjszqyc43k;89286;13;2026748;1937462
7908;bc1pk40pm6avclmesjwvepjk97twdwj9wrv7kzkn9ealc687ma0jrplsz63pqr;883002;254;51184294;50301292
7909;388Ufn99aKUgEFaSDNb8oSHPNFc13FNVTj;7359597;33;16000609;8641012
7910;bc1pkssn7rsej92gtej89lyx0wecq2h66qt3j3hvrak2mf84zswh48rqwmer89;10921;26;39821;28900
7911;32BcSJwz4Lbh34qwSUXZRRUBtzni31Mrxy;2767077;104;94915488;92148411
7912;bc1p30uzq2jncnp4t8gmuv4yhwwrzmzlz4jwxnqzjlsfgkxawn0tl9rs4y9qa8;31320;1;31320;0
7913;bc1p3m38dzhz66d4rcltvghl9uqssgpraxgv38wusm5rem6dzqaqkkyqkfj4cl;1150000;1;1150000;0
7914;bc1pxvz508759xatsrr4mf0gxpctuyg6n8wvxkr5j284k65d6sqshjtq3tcaep;1150000;1;1150000;0
7915;bc1pf66z8w5wrkc7ez3uzjpp3m4wg5nf7uncey925erva9chtv02fvyql6c3yr;1150000;1;1150000;0
7916;bc1qu9wmpz7ap2ceu63wwqg7uk6ke7qjeww5fpyfkh;10974030;1;10974030;0
7917;bc1p4m7jgcaqyvmwz2emvdfqjks90kf3uhxd7yad5jglfekqhryh6s4q2ts20x;660;2;660;0
7918;358EQUG9BsJrMg69eP89zkftu3wYHwBTmB;783066;1;783066;0
7919;bc1qfnnf3n5s2pr4ufuzwgkm6ulet9hd8nr728syv5;818998;4;818998;0
7920;32JZtTB2PcAPjC5nY7Pf34vxYmAtAHtF8B;78545;1;78545;0
7921;bc1pl7ayx2phf66ftsuz9743n36pfaprw36dle9mzdrwayd5sg0g2wasps84kg;80898;352;914661;833763
7922;bc1p769tx0cfh6nllqk9yz0mk2tj4ecw3dhsa4rfjl9kk8q3hkygph8s6kxk0c;40234;78;682808;642574
7923;bc1qtf3aehl5fdjjtjveh03sepup8g7e2jakvuvw7u;817858;281;13939949;13122091
7924;bc1pqzx08rcanzhwzc9cxtwkunu39e22wg74eayz0lpkuqvgx7jjfs2qtdfkjp;1150000;1;1150000;0
7925;bc1q4l6c0fy8gpnsf43jljlvpmt2qel5fa0m8qrxtl;8773317;5458;2613418213;2604644896
7926;bc1pfstjerqgz39d5m0e5gxlc0rxnec2yu7dtenj4y6t847ngtte03zqkk6uyd;4660525;1;4660525;0
7927;bc1p70822cklxp0702uggxu9erur9mmlczsv3dgwe34jekazjuz06fmsrfjkzc;210197;52;5809538;5599341
7928;33iGhXxZ7xR58sFWeVoLqNHUS2oLJ5umc1;2154300;7;7754655;5600355
7929;bc1ppn0r2kxvexjrgk5wacvpapns7h9cx5n6c8aqzdk2jprmsd9k3xusgpukxf;328064;227;2671061;2342997
7930;bc1pk5pjequkx4zpuu72f75lfx3e5r44q2635ccww9v5ezsjcf73yrpqt5w0zf;1384673;4;3322821;1938148
7931;bc1p5guzt65f0zt4ceauj6klka8aumzhshzf0qwdmnt0wrveclxjp40qwr6mu4;2343937;145;389814181;387470244
7932;bc1paauf9hq58c6ccelm739pjk4ehmsn84ncy8nedqutjxddpurjypesuekjtw;10000;1;10000;0
7933;bc1pknc47pvu5y2flunz3z3c2alz35593z3nmvp6qjucyl96u2mw7a3s5heuy3;1384500;2;2884500;1500000
7934;bc1pjfwprqgr429xy0jgzm36wuz3m3z4jy0k9rgw3yhthva70sulgccsa0rkh4;18623224;382;18623224;0
7935;bc1ptc75j6aa5xxg4j673flfc0t77uf2kmw29hjhlj8dnz5ds5wvny4qxzn5pn;4691249;2;14100978;9409729
7936;bc1phpe73me0mhgdc9gjx9c3m0qafp52damygre90l3sm7vex8kpmeysu7g4aa;69514;5;100060;30546
7937;bc1qf8ns0957eexzr6r2tya73kgp0dqrmr7eaegu7y;4384943;3;28454385;24069442
7938;bc1pw3c3l5qzgmp4xp6lplm5f0t44fcejg9p9c4h9duqf7sr3t764rmq735cfw;130000;1;130000;0
7939;bc1pk5rchwfa3pnsgyqm4knpgkhc7hw62fq9n73xwpnty5rmudevuhtq9h5lgy;130000;1;130000;0
7940;bc1p34qcyc3v9v3f877xldhsaq2wn5qy0qf5fm0zlg5d8ffskafha0ps7ju87k;4200000;5;13888640;9688640
7941;bc1q9qszmhf0yzzxz08d7w7gt0e2mmnnwr762jl7x9;0;2;95382;95382
7942;bc1p2l7k9sf3jlc0t6z2699edum5mt8nyxt5uc8rj9dgdpfnep6332pqcyuw04;2968559;37;58205765;55237206
7943;bc1p2cg20tal85xj46pvh5j6srgj7dq6kx00jhmlp3jzysa7xwa82lpqf5tjmh;211870;44;17147277;16935407
7944;bc1pclpj6appxaa8q9ah5fzgydjnkvzwuwrt7qknhyty59l22xn652gs0pczu4;25429723;426;7230628076;7205198353
7945;bc1pp2dsyy43zazcddj85kp484zrtkg4a6ccllnmu9g5swz4fhx9ga6s49jrf0;53538;83;67211;13673
7946;bc1pee4w6trtfqht5wc88muxskq6h3n0hzuqrsg5e9esfy4jjwfkhycsv5z7th;5340311;26;139053963;133713652
7947;bc1p2ykx6ehp3vretx8z4ludqcsfxld0084she26m54z6hkc47pzt95qgdghyd;381481;73;17982761;17601280
7948;bc1p99gctuuw4yxf7qjta5dwdmhxnc4gvctt6uzg49jp5zr2elsweuaqnxgvvj;217373;451;300747138;300529765
7949;bc1p348k5myj78uvxyfczerqwfp364p0cm8vd44ne7njnsw9fkycdtxqthq3rg;13076693;34;324900851;311824158
7950;bc1p8v4tgl3gxw0nlehlzcmek2fpe2a5mswmart8vwl0hznrh0e93gaqxyfeqc;10000;1;10000;0
7951;bc1ptl7sl9whhvj05rw7r504us2fjxu9uyc0g7kudzljrf586gnpvzxsn550m9;1855502;6;5636542;3781040
7952;bc1qs0jdyydyd4kv7fwqre4suhz33mcuy3838xdsla;4824882898;2482;3351069252033;3346244369135
7953;bc1p482vdg8a55qg42ds3q4gpcpmcv2rz90gg8el03gcl40fhctl69cs5jcrpd;145772;458;2997660;2851888
7954;bc1q3ttnzxk4h3g85v7cqaa908c30wuw8lez4tvmex;27631350;47;458151434;430520084
7955;bc1quh9jm6p06nqnvgvvv733pl0g0y6ycxl0aas2t4;8638587;7567;695673635;687035048
7956;3KDLxLkxrD6u2PSYyNaKHW1G2vG8Mcvonq;2477436;45;30897246;28419810
7957;bc1p0s2yqh8qvuq5aqvepdn005p9ra8j0532vc325e3vaehlrn5a33gs2y53dq;5060;32;12275;7215
7958;bc1qsw5td5vamqu5386d4svcs44h7yjry585dnelyx;30870;109;4495357;4464487
7959;bc1pewft6ra3824wezhqyshthr5njwnzpnvw8gl9yjezqsm4u3y0l0gq44hema;1546;2;1546;0
7960;bc1pj68ky2k5ukqdzsxk0j5z3v8yuu5d0xdds9peqz6djxl6qjatcums0zt9d8;61618;75;5067019;5005401
7961;bc1q3s2rw3plrggafrdu4lrzzwl7sm6gjxanyuv0r3;900000;2;900000;0
7962;bc1qd72hcxc07gncsrpx2udmz85f6f9lk7sgwf9umk;10000000;1;10000000;0
7963;bc1pg2sv68vxt0svzac03hpez7aaaelg9rz8kde3zsadkgwcvw5837uqqyy5l9;546;1;546;0
7964;bc1p0yl82pgrz8txltk8vy5r3vnrv93k8fhp79j8zd4yk7e54j8dwsrqwt45n6;8576729;610;225439972;216863243
7965;bc1qvf8pa0s8f42a9uzke48du60fmmgfnk3z0q00j9;1063701;49;60218643;59154942
7966;bc1q49865xsts7vhcdt8pr4f8yj48d7lyg74qg92ls;263203;27;263203;0
7967;bc1pwt8gpyf0yrj8qcap7fd0sedal798updwxm4fatlj0s4nh9x92r9q7sxjaj;457594;10;1941884;1484290
7968;bc1qjr242hcxnss4jygjlkmlqt7d3aytaj58we6rcm;6534590;3693;55031347;48496757
7969;bc1pzwdu2cqcuy4hlws5w3ky07x0xqt83jt9vzn9qr7dyh4qs5uax08seqj5q2;798330;1;798330;0
7970;bc1pf25tk6uylplxm784mqy73t0lccafzrjz08smvetcl9vka7up2j2qa4728w;9335;24;7266849;7257514
7971;bc1p7w30kmfdf9nfzucsqkvnckzn4anqy3l32cy2xvw6j4rlvkt0fr6sda6xy0;883301;3;1083301;200000
7972;bc1pg6g499zuzfpz4c7ztxn0xw9yavy2fp8f2edp7fgzm3tuuxakn3sq4q4rer;10000;1;10000;0
7973;bc1pzmsc85nm4wmpdwx8kw285jdf39ydgtxgv92j6u2ktl08mjnqdhaqt3g9wt;47266;28;49450;2184
7974;bc1pgnfxwf709ar2e6mju4t7fqv2nvmpxva9x0qpkr0ag7tujzahqduqn4k4qe;281625;10;3560097;3278472
7975;bc1pk0g6vhprrqqa65r8f20q453muuqzs24w06c4uf2dhzpppykz9agsm4r2uq;5079051;287;95594780;90515729
7976;bc1pttunmlcwqgcdsrr9velqr5vzuwy5y7w6zhcnuc5axyr0z9qy30hq3596tn;10000;1;10000;0
7977;bc1pdxmplg7zxg876ys8pqxan2vpx7y4gjpsx7aazd2vapasdaf8ezjqveea30;17295;58;43418;26123
7978;bc1p4txjfjytc0fyq39zm68efx8tawsqerlctv3m5dk03m30x5zmed2qp7nfu2;27000;3;52000;25000
7979;bc1pmjn5qc6pzts4lqtreaet76p7ry00uapnwg7d2qnclaxgtn4wt7tqzvgh0w;278019;22;2788689;2510670
7980;bc1q6yxzzjmd4uld5hnme4rphz8u3sgz95p9cdn5wg;175239;26;175239;0
7981;bc1pzjhfznwearvxsqlxkyjs5kf59m2a97wd2l4dx8tfkkgaqsdafkusudxjmj;84276;48;1084003;999727
7982;bc1q7dzh42ex7lpyfv7dpf7fsgpeu4xhuyss27yhx3;83264;121;3877512;3794248
7983;bc1q62yv3ntfuch2d5h7c7gncp5msn0nqyzdpctt2m;193172;128;75988326;75795154
7984;bc1p7ute0fqup238w895w0st2vjmgw6svq9t6hn9qh2e3t06mhfnh2gq3dq8re;62746941;1390;2290168763;2227421822
7985;bc1p7v7s88938p9l8zy6c30zwqfx7sgc6mz7pkypc4kw2hxq3jmz39wqmyq4r7;142290;580;952301;810011
7986;bc1qw5hdn687s6pa732p46xrqh0qx4clpwc487heh2;2038844;511;266873158;264834314
7987;3EpRa1a6Fff3NHTCKLYHZhf9aKFsYV7V5s;1887249;41;28063615;26176366
7988;bc1pw2q0tln9xdd0jls8ayqa334yretleafw9nf56qkw097a8pygxtkqtq9qkz;130000;1;130000;0
7989;bc1pdrlkcjv2pst5nnqzjjxuz9fzaa46n8ldz4j2z2cka7cmyzxcf55qns0jn8;34198808;94;228452524;194253716
7990;3LePwon2AmaaryWEVJL6kN4NBbiZNL4Ybe;2232932;1;2232932;0
7991;bc1p8lnlvc4fvwlc6hn9m48pjngplzvq5a8fmmvllez6ycpxszfus7ws5yd8q8;275482;5;962602;687120
7992;3PcBkj4LywMWsTqF7YG1ZL3nuEXiqC8Amx;137520;184;1012608709;1012471189
7993;bc1pqa4qhmzlwdfaqn6hp03rg4qyxul0xy8n05dtf7wx0arvc0ys943qav0qhr;1565576;7;2655576;1090000
7994;bc1q88255mu2r3k9ne5krlwm25p9gwt96k5kma6hyz;725874;1045;337843046;337117172
7995;bc1pxud38eujvu6fdc8tm2gfqv4jzs7dn3s4g7fga5q3qajdxqu3xr7szwjrxp;2404331;103;192889862;190485531
7996;bc1p452gzhn2lvfqgnpj3ze77r52yucwgmwp20zuaukajqvza3njc2ls480dlu;0;7;6991918;6991918
7997;bc1pnyhf99du3pz5fnhnk3k4u8n2yykh7f34rdtnu3nhm7eut8rwm09qdd8euu;4700000;1;4700000;0
7998;bc1q4gg3955f3r345pnusf9lpevkcpudj9p4252tqm;554718;2;554718;0
7999;bc1qm4027ns68sldw846txkzu7urfkz2vpa86y7kfr;909416;10;3555880;2646464
8000;bc1p7cacky5uexrg83gq2uut7avwzt7qnjcltxn8andpxkv0at6tufvqln5322;7644;7;7644;0
8001;bc1qqlnrav2pp0046k6p4w9xsa48yxf684ccqrhar3;907839;1;907839;0
8002;bc1p3nz68z39mkx40cju4vyxe3p9rja7u9qldjjdc23g6tlnd96tdvxsf8w83a;798330;1;798330;0
8003;bc1pmt3mwd4tyycalx7c6at8n8k06p474ckvut9z0m0h8zm8cldwa78slulvz7;42707;37;45983;3276
8004;bc1pqaqguy8ysghze8m2saawl8wya7977svw86rhsde02xuvpf8kqynq999scj;130000;1;130000;0
8005;bc1ppawzszllqewfnvauxug4pelg50u9wnlxm93x06qtfx2t6al05assktf4ep;897360;2;2483514;1586154
8006;bc1pls6wzfwwcxvcc4gzdyq0z64nry7u3qfmdkr59ud9wl2sfuvrdv2sa77ayp;1054697;305;79499524;78444827
8007;bc1pfjalxkg53s43vkazav6e7wregpkcz5wyp8dasts9vrepp6dcnmuqtq7f52;19945;16;19945;0
8008;bc1pcwufme085rg9sv76fe900q7lvd74j0thethfxx2jtzl4fdseyq2qr9dd3x;1092;1;1092;0
8009;36uA5NRiAHyGVF6dT39yY2KgcTNwZJ1U6J;37662389;3334;427420767;389758378
8010;bc1pamsqj3uzsp0htluj0mhnens90yl7xx7lz43qz4r4mz24p9pml43sa2fh0f;161282;4;361282;200000
8011;bc1pzdwp69f525cy4ljk4c87qpnfjmtkdq3fdm09qwskl4hmqv8t4lvqp2lnh6;10402;3;87402;77000
8012;32XgBaSRQrHMDCD4Ykbw2kkaUsJzFitKNQ;10000000;1;10000000;0
8013;35WCKJwMrokFyTYKZ5mvJGtzmQgc55yB7s;852837;99;33709756;32856919
8014;bc1pd54u06rqljxesazcdavrk2jsf0m9zkzpk86puw74v45hxd9hm5wspmfgyx;0;2;21505;21505
8015;bc1qmnym47wllw57ge3md20080q3gx2k7d04l6c496;91157;4;498324;407167
8016;3AKJKzr7k7GMXuWj9XhpepGYzqbxWgP7wX;16987290;55;16987290;0
8017;3Pyxi2ozJ5jcbhSeCJYucGpjoTSzegQZJ7;17021113;110;457199587;440178474
8018;bc1q3j0ch09fhuefacxyd0rc7fz9kl582f2exgxh07;469706;1;469706;0
8019;bc1qd5yc9ap9hgv6rzy90jelk6j2z4cdyt0xqa5xna;126931;1;126931;0
8020;bc1p6ftt29cajzhmpt8tl5juf3e8zwckmjp8npannp8wy4r3dty7yt3qhvu3hd;1000000;1;1000000;0
8021;bc1q6nhdlh9u0a6fwesq6p4krmhufwhxelghj2zj3z;10000;1;10000;0
8022;bc1pnhw6uv8su6ejav9ncdcgmchtn4uevp2m0dmuqnlhh75ga92qzrjqtrjxv8;58965;476;5070267;5011302
8023;bc1pcqms2fr4ytkjda0svyrn56h0glpzq64mflerae9ku38rjluxusxqa954sh;12729928;380;12729928;0
8024;35oauq1u1tuoqKXrBZdBN5tf1KxcyCogwk;99527;1;99527;0
8025;3CP6gHwqk3ic2zX4XnWG5qr14x3iFZy17q;260720;7;22235877;21975157
8026;bc1prr9wfcacrkts44qtc4kr2h97sjz8kwkyhlvuvuxeqwggx2lu6uxq7rvqm0;2689698;455;158208613;155518915
8027;3AdiNervmqUNxrBs7YPfBTGfb5mEfH5f1w;429090;5;559090;130000
8028;37bzazJwPLMDtRpyxzma7EK4Hx1AKbHQVH;9595100;68;186593402;176998302
8029;bc1pe2ssl8almea8lth20qwpqn7qxu53xl2k3yn3l8hct64yc3tevf0qktrq3d;2000000;2;2000000;0
8030;bc1q3xujm436x2egz0q6jrknffnzqq5x4kksce0ezn;94632;3;1250568;1155936
8031;bc1pjs2l0qqaycnc0euhglcuqcd3q94t2cykaq4jztvv26kl40c7hezshdsm2t;10000;1;10000;0
8032;bc1pk2gh4y6facf0kfphztlcnjfkp8zh94zvx2pgleq2mwhr70spztjsmepts9;154198;299;30521884;30367686
8033;bc1pvat0l2a5u30mh6xm7hjky7qdkzep9e5xe2n7nevj22s2w8vankms4cajmg;130000;1;130000;0
8034;3H7tojdKbJ186DFFc5PPHrgmez7U22zWC3;2098794;301;268322379;266223585
8035;bc1pkqmeg9n5ljmavvtvma00z8pszx8s5k0yclcv0k97m3cpj7p669cq5lxn3g;31089675;218;3412268125;3381178450
8036;bc1pq5z0hvxnewyz2kr40j4d32nx9tn0jx0vvdsvjnlckjekyhdm0j6qh7w6hf;15124913;2129;16275335;1150422
8037;bc1ppugce2mhj3n8xgknvcylm30sa3q4fdl9w9m74t8k9pvuslv2r29qesx5gh;41656;145;107597;65941
8038;bc1pj4lsvgyugyz5rjml279zr20x5v9zpap4uvmunz96g2php864w8us9u7y24;945755;1645;96173297;95227542
8039;bc1pquz62anahzfwnqf9wagynvdp8hv7ehy2agxlgy72h0hxs058zqfqk8ksyq;25219745;105698;328933123;303713378
8040;bc1p6yv03ney3wlhjj6pf8xqv6l5cwj4c368p2qkn8pwyqys5dnrxxws2a9tp5;22970;22;572232;549262
8041;3P4WqXDbSLRhzo2H6MT6YFbvBKBDPLbVtQ;16618471198;955150;50003582237;33385111039
8042;bc1p4un259ak02yqzl0853u0gxdxnhg5k6c8rjc52v33n3rw6jkjuk5qwz0wcl;4936975;3;9936975;5000000
8043;bc1qhz9afq6zu9v7wmnnwvpuyxgn8q5snddc9dn4f5;267194;9;267194;0
8044;bc1qzk86urfh6tq9lc7qpjn08uddtsa8555kc3yndk;65859;10;207709;141850
8045;387wUAhjrxDhLBkCsHpD1EBMfBZhAWCEGy;180717;22;23608211;23427494
8046;bc1pqqgdtmd9742v4za06twh98u7n7uk9geqgh4x26uapk3dd5l8ddrs4mzr2u;61764;20;111764;50000
8047;bc1p7xm87ram9q03w5xt2d86zwkzwkpep57053aflk7pjpvfd2ns2jdqv28482;1150000;6;2229579;1079579
8048;3JoB2H4vdxLczWggkNcAWVppekhTBVUZLP;86241;34;44449427;44363186
8049;bc1qlps5xcg733tsk3eeuyvkdfqztwnglf0cmarmc2;697700;1465;216061072;215363372
8050;bc1pzu9s27n400ke8fn9gr09xy34yfzsk458r7qd6ddd956agpeea5cs8vncd5;16849;30;535236;518387
8051;bc1p0wkhy50957ssfeexhad5ygmrzsggdl8my3wfr2z334phtuyqjcrqga99a7;350954;74;386426;35472
8052;381KrtiMLDpZHP63DzAD7dz4fTouSm8kHx;6589518;5;15114400;8524882
8053;bc1ppn0r2kxvexjrgk5wacvpapns7h9cx5n6c8aqzdk2jprmsd9k3xusgpukxf;328064;227;2671061;2342997
8054;bc1pdras0q85zldzcncpd6p50ypqhz72a89tvz0gcpskzh0n52p05jps33xp33;217854;65;3763812;3545958
8055;bc1pfh2uqrrcdpyvsx64h94gvaswlk43fjd47etwt5ee2ne2sskd3ezqjnqcht;0;2;15639;15639
8056;bc1qks7w63vmp7gretv90q52l0ef462lhpj8vgmxx7;60000;1;60000;0
8057;bc1p4gfln2269w0prek7nkjqj5n7e4wmahcdhd9t5san6jd3azp4hzfs8j2n5p;13679;104;935638;921959
8058;bc1q03pchycestdv09f4jtjd8sscra9x70qyvgav7c;132959;2;307128;174169
8059;3FptKtNVujQPmt8eeCyDvsnrYx7ritmU2f;3197644;6;5637412;2439768
8060;bc1p0gaxcq4eyhq2efjzvfvqja5u2exz8eqfdngfqqenwzcjdxc6k8vqrl6cyy;1227915;17;13533066;12305151
8061;bc1pwjna8h2epv73aa4atmqfztm9mj25f957vdemprn7ezukygwcrz3sm5xk49;3717288;119;3717288;0
8062;38zWEbsRJgQ6KXg5cLJcUKovJR6WAMHort;1804182;57;20441178;18636996
8063;bc1pclpj6appxaa8q9ah5fzgydjnkvzwuwrt7qknhyty59l22xn652gs0pczu4;25429177;425;7230627530;7205198353
8064;bc1pyjgg6799c9fazdv3tmr33cp5maepq84yes9hfvua2j7sewskxfws0jpc5p;86265;33;86811;546
8065;bc1qmsr69pd2zlx5m7ms8ylcu70cfd2nxgpmz084xl;202305;1;202305;0
8066;3PKKTtGxGgrnMh1dhwN3h94DazGDJ3ELa9;1166690;9;5043856;3877166
8067;38qwrmDcKkkEbTCZPdWLFKDRJdjQ8wFWRx;361854;9;3736014;3374160
8068;bc1p3eegtyu6s49hy0kh248v4gh03dy5mxppz0g7lduzvsnln8jn8w3s49tl9t;0;4;92841;92841
8069;bc1p482vdg8a55qg42ds3q4gpcpmcv2rz90gg8el03gcl40fhctl69cs5jcrpd;145772;458;2997660;2851888
8070;bc1pmqcs7e0zvyy6ymggye8ej888wfmhgeund8a4zfycs8paplvhmcssrple4a;49409;39;6317056;6267647
8071;bc1pzg0wwgedmq3x7ka3503yd9jcpa45lv8p06xahk06emmrywh6d95qhcpq3m;17184;16;44284;27100
8072;37d2qXVdnA8n12psrEuWjrxdnmgFZQdRdB;88750;2;244127;155377
8073;bc1pd785em0d5wgws6zzprty0vhxe9jqa3wrsdnlup00h3ylgptyecsq7enk03;354918;3;3826570;3471652
8074;bc1p2dkwtv4trxk7xm38r2q8sj2hfjtjvc0zyy028mpthed5yg2wp3psvp0vzx;7245;13;7245;0
8075;bc1qmrvw8sjjr49cggm68zlq7f3dl9cpjmcfrpdxln;60000;1;60000;0
8076;bc1p3vk4p7luqwymxpuecd7zfd0rq6yzjda6uhun8mts4kyzfpwngf8sg9netl;316243;21;5411667;5095424
8077;bc1p3ap76c2syv7dcaywpyx9s38qzp4qg52q3r9ytsnc9p3kkzdmgf5qdzmy0u;75183;64;665559;590376
8078;bc1pr4d86gflrf5qdy0xuck7r3p5969xjnzjux5qgwydr525uva5dwkqlgcrzl;390536690;7850;1026203465;635666775
8079;bc1puf648kyeusdn4wsekzkryjlwmswcya2xlluljvm9cg5rtjytzteszem3v9;9500000;3;9500000;0
8080;bc1qlskszre00xsk8a5vdkfwqjpqg4qm72e94v25w6;5261616;1;5261616;0
8081;35JzWeXbCUCaSGpTFFWyBqPW2w95TYYDpg;7219326;3;14069461;6850135
8082;bc1qdlk64a2v376mpf8zvvzur72qy0rnaclccpdrgq;60000;1;60000;0
8083;bc1pdj9dmn2w0jgsyw60ylerc2q2v5vpcxyvk2va59wgkxpngjp53hcq8tx57m;104368;16;104368;0
8084;bc1qrq6al4s6amayfs4ctr6529nqcrurzrunwf8x2c;57104;22;57104;0
8085;bc1qgkxafqhg8x3l08ty2sklqszl89yy8n4qv70kry;1200;39;44400;43200
8086;bc1qjr242hcxnss4jygjlkmlqt7d3aytaj58we6rcm;6533210;3692;55029967;48496757
8087;bc1p9thzjyv8gra0wncx2zrtqhlev86jp7qx2urgrrruwfxt683fg0ksaq4yjs;29055;1;29055;0
8088;3JnTRHxng3QejfL7mFXRshT4evgqrpy7PN;2991432;24;157940989;154949557
8089;bc1qynygs8d3ju9cpum9pepmh94qk57tf67paka78g;9689131007;39411;18120380838908;18110691707901
8090;bc1pwpls8xwd5f2vs3shkk348f40x4z7mce72x52uwxy66z9urdk2mrqshdc7g;137856;44;4046151;3908295
8091;bc1qhawufm0gttq9ex3t7cfehwa8r3wlwr3ycnlyp7;1567;1;1567;0
8092;3ABx2JvPqU7v3Vt9sH2GrRjSzhQWwzyoKs;52132;68;11262982;11210850
8093;bc1qz0peyg9fykpueestpxmd8qjlk9llvjxdrk22eu;4100000;3;4100000;0
8094;38iycHTJoPgMW89JjUEw6NSHiCfcWDbbRN;827825;29;6470584;5642759
8095;1L6qbVz5kbirpJPFGvzG22MVyCASRTGV5A;902186;52;7957642;7055456
8096;bc1p50uzymsnh58d5jggcm0jd4tjkq33g4ctmyp97afuca8y7wx64jtqyvk64r;546;1;546;0
8097;bc1q957udu9p6dj3lsjg9dlt00nyn2jq4yhpjd93x3;1214488;2;2445488;1231000
8098;bc1pzjhfznwearvxsqlxkyjs5kf59m2a97wd2l4dx8tfkkgaqsdafkusudxjmj;84276;48;1084003;999727
8099;bc1p3wu0ws8yxa6mk0f4pdvj0eu9k22mwqwj8tpv67x5gr43zl0v5krqj0wl50;83399;3;233399;150000
8100;bc1qn4u6untfvt6jm0gvznvlh8c2khhjelfrqzw4j6;22500000;1;22500000;0
8101;3EUtTyXjfnGCvv8kn5hVDPqs3KztSC8VJr;3969715;2;7969715;4000000
8102;bc1qz6n0v6ge66tz95vkv38ngnqjhvm7gx5pv49nhr;22425666;1;22425666;0
8103;bc1pt8rhn6dm6amwjr3tlyzllvy4gtr7uzdenwxa2q3mz54m2pzpevzqkcm58c;113570923;8065;413517295;299946372
8104;bc1p7v7s88938p9l8zy6c30zwqfx7sgc6mz7pkypc4kw2hxq3jmz39wqmyq4r7;142290;580;952301;810011
8105;bc1pp5zgszj4deddqd8gpwhk4qy5j400qmv49rwa9rw3dej7cra9zggsl5p0mj;18875;20;19967;1092
8106;bc1p97fwehnwsm59zqaqtkhd5t24gk55qeukdxg6gkm7605z094h24wqzegsc7;1092;2;1092;0
8107;bc1qqwdgfe0jp0x3tyzkuqsd7yn4tehltuc0h498aw;238750;3;238750;0
8108;1BzaYX286LQX1qjtX54U3mEADTZ1CZMCc9;22959838;121;60974301;38014463
8109;bc1q378m5u45eagrlfpndul88hcd39gg3ldty4jvt8;154594;20;154594;0
8110;bc1pek4fm5h778c0ep6kx0qpevsstz4c4yw56ewd3ue6r2qhpne4fsnsem7lrl;3011018;2;6196636;3185618
8111;bc1pyf0xjmrv52wytxdf7x5u8j2e7p0qve87phf0yptr7z2m8566msdsy4672n;14965;30;29109019;29094054
8112;bc1pk3362ad89hxg2vcahg0g7j5jecklwsrxpklfvdxyl76vm3sptz7svwcc5f;3092;4;3092;0
8113;bc1pqq5qvztgx4jre29haknxjfr44m6avwaejk9zfewtl03l04alfczsja4xry;0;2;274000;274000
8114;3QwEuMugqaAszRR55Ljs6CFHUf31rcr4fg;1091193;33;13441147;12349954
8115;bc1pfwu69lz3jvm9p25yddw8c6dm3d84n989xkt6s69sg43espgut6ts77ar0s;25662;1;25662;0
8116;bc1pymr2nrtmpz2lkatyw5za75ulx3vpdnayugaxjx2nuz20ef7gfznssyje72;2514912;108;2514912;0
8117;bc1pw8g9qpuqjwrcpy965xmzpxrga6am7zm2mssuteah36x8ayjdndyqz4rc39;6561876;1;6561876;0
8118;bc1qltzrgarcjn7jtgy809ltwzktd0k6f7dqjmgwx0;51691;1;51691;0
8119;bc1qd5yn2juh9utqu8eq57ce3wuva5pqjppnjj79hu;4987;1;4987;0
8120;bc1p4gtdksj997te6056cxn38eganeksmt33hze7gvhs8chtpzywxa2s6pkf03;664780;15;5460931;4796151
8121;bc1pgnv9ejz4zy56s2ral89h8g4w4ecyzc7xqdkpa5729phpa5xkyk3sya7mju;758949;5;1903123;1144174
8122;3JWhbUZ7oqKFrCDvZpQRBk1eec9gBn8zCi;399765182;21;2237198229;1837433047
8123;bc1qw8wrek2m7nlqldll66ajnwr9mh64syvkt67zlu;68335484030;377768;315841962636387;315773627152357
8124;bc1qvpjjchkkmy49f2refkvsk4a7k2zatv8qkfyen6;60000;1;60000;0
8125;bc1p32nktsuffprllv0j93a2d3q33s0l6rlh598hynkgrt60lf6upqmqasw00d;155150400;8021;623171525;468021125
8126;bc1pp9j62v7jk20px6dym37nkwhytjukrg9w5xwaykesfkd6w9f9rk2sl2j67z;2333;23;64142;61809
8127;bc1qcjw52mkjfp8gyp0mr4mkjtg0fg4xc5v0ft8de9;181202;4;2057480;1876278
8128;bc1pee7392nf7drqrydsksxnlju96dydu3ck76xw37algk592yz7fxaqah22ct;1765823;289;58690655;56924832
8129;bc1qmrdh42v48z09re2r6zlar556mqflnytzdmlw3x;337171;1;337171;0
8130;18hofVCQv8cMDpqDNqSXyrUDffq7MKLxiu;1187676812;36921;14501954676561;14500766999749
8131;bc1ptjhxjdcvmggwyw544jda5m49428g2cjzx273n6y8pkwhmfap4q5q568fqn;347132;3;747415;400283
8132;18yAZ8ZwSMJ8U63jtwVoBMDzGccNdeo9G6;1518202;1;1518202;0
8133;bc1pva8ytsvd8zr9xjcqy4gaum67yrl567m3hcqqydency5t5lk7pdwsuyhme9;29523;1;29523;0
8134;36uA5NRiAHyGVF6dT39yY2KgcTNwZJ1U6J;37642968;3320;427401346;389758378
8135;bc1pnzug2ufvdltvq464e2e0673faex42hkqa7fpnpuxw55tlqgauzusut057j;293806;56;10906759;10612953
8136;bc1qvnhrf6023x5zmdwr24lnpcqefdmnz6503dcn7d;1948442;1;1948442;0
8137;bc1qx3pr9jl8yfpdntz2f5hj7fkqaw85pwpqe3rvm4;60000;1;60000;0
8138;1GVe9d4rL5SJjAiKwC5wGzvkHJDt8DAPp5;2484211;725;501145611;498661400
8139;bc1pujp4du22h7vyn0y4elskh7gd9d50k2rpsgrerzh5yfcqlxjgqttqmz62y5;25215;56;1004806;979591
8140;36syMfHGZ1EEonx6H8y44UPzUhRGBX7JkL;73939;1;73939;0
8141;bc1qseldeunczdhjtdl0qhszyuz38eamrqzcyahn2n;369100;2;798117;429017
8142;bc1qhzdx938fm4acd59fwwng2mf478paunyxdnwyud;6691826;356;159324865;152633039
8143;bc1pwrx739gm5he5nvlv0nvvdyndj5chnpp9nku4w8fuztq0su73s2lsdd9ujj;2730;5;2730;0
8144;bc1p43vf2y297d6293fgdxllxcl2x0rc798egrf6m6rus2py56e0j5jsh9euxr;171454;553;634104;462650
8145;bc1pcqms2fr4ytkjda0svyrn56h0glpzq64mflerae9ku38rjluxusxqa954sh;3563104;135;3563104;0
8146;bc1ppgu70dg6t86xs8n2s5t98h937da8pmy9ft2lnwg5mn8dejllw37qffhyfk;3404528;105;3404528;0
8147;bc1palwtskh9ecdwjzmfyftcuhp37za0mtk6wxvdu33zsjcqmjt88ghqyt7vet;137053;8;2981165;2844112
8148;bc1pu0lcfmxtagffcemzjhr4p0p3gl737c3aryqtpnxtu5kpav55zl3s6alx75;83520;3;233520;150000
8149;bc1qnqxv4aa3wcxj6ef079vfflrupllqyczha00ys2;60000;1;60000;0
8150;bc1pl35wn7k578zg55exz799m6v6pnu563wg34t7yg7jsnmxpmvw5fdscdsmvu;2022880;102;2022880;0
8151;bc1prr9wfcacrkts44qtc4kr2h97sjz8kwkyhlvuvuxeqwggx2lu6uxq7rvqm0;2689698;455;158208613;155518915
8152;3Pp7UWXTi6tNxkupBiyk1g9ZVDdB8APDmx;89457;43;3534180;3444723
8153;bc1qxtt7g4t3jz7naxsgx9fdvquvm59c6p383cfu8s;22434;1;22434;0
8154;bc1p9psnskwmejux0hykg8tjs7r5cfkf63ynjcl4hzuzzkfv2ashvpfqurk255;0;4;92841;92841
8155;3HSLW2ymvxN5HRdGEed4bMXqUqFAJvkXh3;353117;2;729004;375887
8156;3JwEQHvpGP3j16MbU9guHEzpAPAFdbfHDc;3831696;1;3831696;0
8157;bc1p6xcjcpsv660hh7gwmneyh97slmpmc6gv8dmexhk736urnggr2dxqzzgcey;27914;25;40644;12730
8158;bc1p6wa9ef6jmwx2mppdu87ldrp9xv63e6q9k2y6v82265hyl6sdfs0qzlrktd;2549184;109;2549184;0
8159;bc1pp94c06pdg6hxvlesf7px8ktzrc5gz8w0as2c8d4g9lzu7kjrps0sh449ay;0;2;29000;29000
8160;bc1qvauccym2u5scu3j980zt3lqmtnfty3thfj930k;6115477;35;55604905;49489428
8161;bc1phwv2dx28medh7lrcgukkm8r55r00mrgc22uj2eshyrs72nexq9cqzxp4y7;5162288;133;5162288;0
8162;bc1p349envul26dmhahl66hjslw3g4l286ssqgjxhrwkqrul9uzrwwesc04wls;532489;4;817489;285000
8163;3N1siJb1JFftwSdj4JrS4b444TBb6tHXZp;62619;1;62619;0
8164;bc1q6fd3fsv5j5znqc8h0sqcgaqryu97xpltk9em62;60000;1;60000;0
8165;bc1q78v30rjfuw3f4j4kkv7y84zad67ntlekxz5kar;1200;32;36000;34800
8166;bc1q3jgudhez6yuf7mj5v2x9pym7s6edf8732938mv;100000;1;100000;0
8167;bc1qhae00e2s2x0k98204y0sujmnd2qs6jqtttq0tk435q3wxd2wy93sugvm6q;82891;3;837763;754872
8168;bc1ppugce2mhj3n8xgknvcylm30sa3q4fdl9w9m74t8k9pvuslv2r29qesx5gh;41656;145;107597;65941
8169;31yuSoYmpkV5TDxuMh2GUfchJFef4kHyus;24719817;31691;5362064733;5337344916
8170;bc1p2zsphmk97vdsjkssfvayytkntj0afqlhrut9wy8u77sddasc5npskx3fze;230796;103;29715853;29485057
8171;bc1pquz62anahzfwnqf9wagynvdp8hv7ehy2agxlgy72h0hxs058zqfqk8ksyq;25169500;105682;328882878;303713378
8172;bc1qp2zkhxxevtgyuhpeqw5v0rulamhse5307307vv;6534747;3;14600451;8065704
8173;3P4WqXDbSLRhzo2H6MT6YFbvBKBDPLbVtQ;16609713957;955086;49994824996;33385111039
8174;bc1qmdxd8ts2ylptzqwayg7pezz65r85v4vdrpcatr;0;2;839440;839440
8175;bc1qlps5xcg733tsk3eeuyvkdfqztwnglf0cmarmc2;697700;1465;216061072;215363372
8176;bc1pfze7jynq3958cacq7p2dmwv45tt49265xgnqtn77269xqt3alhjq2p7840;0;4;90343;90343
8177;bc1pwkvvhs94kmcg6y3xxwhwunyyxqn5s7w6c777feua3dycamnp8dwsxqvkd5;50060474;325;985467245;935406771
8178;bc1pjfwprqgr429xy0jgzm36wuz3m3z4jy0k9rgw3yhthva70sulgccsa0rkh4;16984584;310;16984584;0
8179;bc1p97ceuz6rwhg7qudwapq6mnc90xfpny9qhra0cpphqu430209nglq5mvz2v;52092;1;52092;0
8180;bc1qprvn3qfu0fufyke3qlplte834vt4r5gx937xzq;1074743;1;1074743;0
8181;bc1qxvcs6k6crm2pk2ns9kv8hss7kgp9fnuwr5gzx5zxpfnmrt4l7m5qwtuuak;4833081;1;4833081;0
8182;bc1qcllkfad8hk8vcudvk5m6v3k2u0y3krw8yuhrqm3elkp38dk7n9yssxascr;211639;1;211639;0
8183;bc1pxsx9jg4zzu6fs6xmerelf8dhrfrzf0kaqr6ad8s59ea8sggpervqyp9g4v;0;2;8911276;8911276
8184;bc1qg6afmzj3qkrelqnatserlrdw2ug436sr5xkm6x;209021;25;11628302;11419281
8185;bc1q29nn4v6qedndr54khtcqz56c4tclj2japh9udak9j5z4mlxn5csqydpuy6;7246;1;7246;0
8186;bc1pwyxq0pxm9a4ushckeel5zxhq0kh4esr2epaald72dec5csqjqjjsfrgxun;6552;7;6552;0
8187;bc1pyjgg6799c9fazdv3tmr33cp5maepq84yes9hfvua2j7sewskxfws0jpc5p;86265;33;86811;546
8188;bc1qrmk2pvlkvkalt52m8zcs2qkdlvhpnv2m6u3sl5pchekwu2ws0n4spkw2hs;10996;1;10996;0
8189;bc1phd59r36epg8gc4lc7ek3vwrnzwd75llq4pj2wxh900lhe7t48ghs4yp5qw;3968191;7;7178081;3209890
8190;37n2vjkd5QFV7cBix48enkPSwRe12hLUjW;4286056;6;27030362;22744306
8191;bc1p5fj9numn4kumxsv6ngswcttmpqhverw97jj4sgpsj4hl9vawczksukthz7;9639;17;9639;0
8192;bc1qzpwyhy9rzhn7ygj3j847k7am7wea5jp4k9wm9n;285541;89;42582464;42296923
8193;bc1puf648kyeusdn4wsekzkryjlwmswcya2xlluljvm9cg5rtjytzteszem3v9;9500000;3;9500000;0
8194;bc1pp6pl8y63zw7z4v90ftd05hj84d2y4zaaqywae5vcdz5azhfzlc6stuau5w;765988;33;3651396;2885408
8195;bc1q3wmx7lnhr6s5pudjdny2sle6cewua09e722v9d;105106;32;105106;0
8196;bc1qjr242hcxnss4jygjlkmlqt7d3aytaj58we6rcm;6534590;3693;55031347;48496757
8197;1LjyVJkgZyUXsyUxdGT11Gwy93Tv1G1GSC;191172;69;13934641;13743469
8198;bc1pp5k557lrkmuu2m4wd9rph0egq8vh2lxvuq87fmynjtlmzmn7g3pqun2npg;4000;6;5000;1000
8199;3DWiNymyfNsVay5SwDbbDD7VgpHQivczuD;1092563;123;30554512;29461949
8200;bc1pg4ykq9n0j9guzvju0q0lfrgvfs6fwap080n2ylad05ju99a72mmqm55scw;5261;4;5261;0
8201;36z67WCyjxYuDZBktoiwjbTP3RQ7X6Y8vn;1465198;1;1465198;0
8202;bc1pa67p5r6a9q24wezv6x6k2wejfglmdwf6nzzv6el5pxl2kvsa39cq9wn0e2;0;11;329485;329485
8203;bc1qyllwtf0l0clws354qz4edglvslh80lugwyyxea;29610147;1;29610147;0
8204;bc1phxywddaaaxpd2f38scajyst6jvlu02r3266w9jv723p6qweerwvqck9g59;5000000;1;5000000;0
8205;3Ax3tfXwSCadXU1KMjjjPEZMfRF9RRaWbc;4991214;3128;18514187614;18509196400
8206;bc1p9srxdqx7u4u48ahj4s5gd3x5m932zm4fc4a4ds5ncm580nh864jqm37k26;117392559;7880;409826657;292434098
8207;bc1pzjhfznwearvxsqlxkyjs5kf59m2a97wd2l4dx8tfkkgaqsdafkusudxjmj;84276;48;1084003;999727
8208;bc1qm9c9l9jgt4q8rd5zz9swlwk5lnhcc8udfgrxag;227362;1;227362;0
8209;bc1q69xj3w47ruyl03e6rs67qp6dfdlpt3dyky6jthg0yd2esvknuyws7vnmlu;100000000;1;100000000;0
8210;bc1pvwrrx3cdj0ln22ufwx2hzkvlvpfc8nxdtu2t2pjddd8p8ky2cupslafjwf;2918003;4;3593003;675000
8211;bc1p465u3zl8pa206w8543f9znt77rnvpa55atm4vm35kn6chts8vtzqg4pwna;9949495;2;19949495;10000000
8212;bc1q6fmqp3ytm5nzqv00amknm63axjue2ueq3nj90k;59579300;11423;143204869;83625569
8213;bc1p72s26hzuc5pl5al664cduqnk02f57vtc7fuuy0h5uxf8xfdch7dsytnr5t;0;3;44522;44522
8214;bc1qvmt94aqexglmgkgg3j34920dhgktym5tgatghz;102291;2;102291;0
8215;1UiW61F9xnBnnC1J69aPJhFm3ZXvZEkCm;968974825;39357;14402766480483;14401797505658
8216;bc1qw5hdn687s6pa732p46xrqh0qx4clpwc487heh2;2038844;511;266873158;264834314
8217;3Asq9Whc21V9GaPrffLtiHQ2q7TrWrVKs6;1449832;3;18771880;17322048
8218;bc1qpy7j4ck2ytthl8lcu5cm6ryjeu0nr7sk76q4zx;251565704;8186;35908133369;35656567665
8219;bc1qn0xzwjyez2e6kvwglk40mfw9k90j8cazp8rwkg;0;2;1254622;1254622
8220;bc1p0zhsthzh00ugtfjfu63edyr3adtvzg3tdamf203xzlz4h4m4j5gs640sr3;546;1;546;0
8221;bc1p3n6sn79m50nsy0w7wnxy2zmjlhkkfz5knutftw6sdf3k8ls7aqzsxuz94v;7054718;353;246458898;239404180
8222;bc1q30rarksfgghhx5vrn0ruxrtw00amjsgx3mq552;31250000;1;31250000;0
8223;bc1qschfcda64ky4mr80fheptj50axekhyacak9kqn;47645834;9595;106812952;59167118
8224;bc1qfsnj8ggvtakdvxrs49sdmkt4wjvrax3m2ckemzna88kgjnde67kq7h6dd5;908841;2;908841;0
8225;bc1qwrtry4d3fatr44l4qxjvs6rh4j8ehumzg8cp0q;51960766;9423;116836989;64876223
8226;bc1pcg2stwjvcmunx6j0l6fsgjtgvqsqg79caa5xygchc0f0arjym7cs8trqya;817654;52;24162359;23344705
8227;bc1p2h82zx7z7j7w4zn2nsjl0cplg7f9qg866jkcq0tcqsfs6v0yzjmq0wen8j;354233;6;784233;430000
8228;bc1pmhky0agy5lretdtxdc92akhqw35l8tsh296k9gehag95x73vanlq4gyfq0;5000;3;20000;15000
8229;bc1p9mvuu05tmzqhx9g94h37jm7fh9vm4nzrgnzaytqd3jam05wu8v9qq0cw6c;546;1;546;0
8230;bc1q5ccwe6zqypw9ahw6jt3a69uumuveec8p0kdgpg;262286;44;9013806;8751520
8231;bc1pc6j26puxfms3u2ekdd8lxj6vshyuusw609unyl06x9wm65lvtutqac7cxc;65883423;1651;6183463391;6117579968
8232;bc1q4yp4u0u6eu4zazylpygndr0kp39p9gtmvvttdr;361152440;1;361152440;0
8233;36uA5NRiAHyGVF6dT39yY2KgcTNwZJ1U6J;37654066;3328;427412444;389758378
8234;bc1qg8v0ua6nqmfsgm25nq5c80mn0884g707v5pq7x;10000;1;10000;0
8235;bc1pqf7hayd63ps7ukwgsx84hgx88wcexg9y6zp7g7sz475t3f0pkw9ss20uwn;1025026;1081;237555090;236530064
8236;bc1panpjxdyxf8pqxa257c70zllw5lv5zqy9rzhlfw0tkmj7j34uznvs5hwgwu;5330126;1;5330126;0
8237;bc1qu7fremx9lgrrdfy3lnnkhmyerren47ngde9sja;149676661;1;149676661;0
8238;bc1p86f84ptvxfv2jyzv6d4wwdnr9zcl4qw66uzq9p7ntrn0zvxpyyws3u2ar3;0;6;157595;157595
8239;bc1psg6npqx2n9hkc7sjru54sd0hqkx96zpusft6d489adx6yw8lzzyqj353em;180480;28;869184;688704
8240;bc1pemtv675pw7gamz37fezv0a5q83vv28yztdvzz8fwjfdd7nc70l6qkeuv9j;0;2;30000;30000
8241;bc1q7tngad0rnfsthppvsxp8apl4267asu3fhr8kgf;75172;3;271286;196114
8242;bc1qnkkjcmvttgk5aagt4zvd40qdzzq9r20smltfhu;1370156;1;1370156;0
8243;bc1ph5tze20elr5utr0g4a9k3nk96zje89z76l998ys43272eu8r6xjq780plq;137783;9;5063931;4926148
8244;bc1qcv5y5zwx0j942r80lee57fg8pgjcd5pea76skr;1296866;1;1296866;0
8245;bc1prr9wfcacrkts44qtc4kr2h97sjz8kwkyhlvuvuxeqwggx2lu6uxq7rvqm0;2689698;455;158208613;155518915
8246;bc1plq9wsd5v4h0yvxev6kw6rlc38exy69prn8ssjmhrxemqfy6mx9jqze6t35;2426469;16;58480143;56053674
8247;bc1qt50lmh908qy7shmzqx5a8h2z2cfsn5z4lkda5k;193608;30;193608;0
8248;bc1pz5286mf977ksn2n62l9qv80lpuakt0y4tyh56rh6z0u3y0k0x4gqxv8fpw;777444;140;26871706;26094262
8249;3P17SAMS6g1yTsTGQNScFxrdJnEiX2jNAT;13961281;18;62298624;48337343
8250;bc1qr6dcyc4plykh2wgm89f09mkcw5kts46qw0f8yk;1535006;1;1535006;0
8251;bc1pc5ttqv8v6v4wqz2ws3wrdflv75f3mfv9a4dyh04gyvwa95d3l3ysuq3nke;8190;15;8190;0
8252;bc1pd3c6c6purcyztxetfcuws8t7qnvnn2csqzyv64ydtrcue9asjg0qxk77gp;12202104;298;12202104;0
8253;bc1pmdpddw6hynpswr0627dcdvudkh620s49v0c9fc3h028j4d4tl8vq4zycdz;1092;1;1092;0
8254;bc1pmjtat7fmc0cwumr7c6jzu5la3hfhzkvsfndslq3p7ne8j54ef7fqdggxm5;1000;1;1000;0
8255;bc1qwj0qqzp8mf55ta4ksy05k0xfjjtm3c40rquumhjnjkhj3wra4lcsh9x3ma;546;1;546;0
8256;bc1p5sf9qa4d9zjd62nym40zqahrs8alwjysdau3zfu9rvnv4mynd8asqxcnag;64628;32;85675;21047
8257;31yuSoYmpkV5TDxuMh2GUfchJFef4kHyus;24719817;31691;5362064733;5337344916
8258;bc1pgee5fz7vcmc0cjxjdrvk5w7fs4s7vc8yku9rdpvxkzhug5t8hsyqvc0nvw;2279857;185;28781402;26501545
8259;bc1pquz62anahzfwnqf9wagynvdp8hv7ehy2agxlgy72h0hxs058zqfqk8ksyq;25200887;105692;328914265;303713378
8260;bc1q8fj4zvlxw9v5l5zwyrndv92edr8kgv9pah9he7;4961669;1;4961669;0
8261;3P4WqXDbSLRhzo2H6MT6YFbvBKBDPLbVtQ;16616784615;955131;50001895654;33385111039
8262;bc1ppzp7c7hytpw5j6v49hndz3pfsxjplhm7mamel32kmzg7zfkxck5qdnm7mu;942872;2078;1104256233;1103313361
8263;bc1p8lkh6hyjw3chewrnt7nqrckr4d0dww8arw3etq5pnvesx6ruy7ksrcpyln;4550919;1;4550919;0
8264;bc1qvehvktnwr5e75906r3xuq2rw4gn667s279t4qc;199662;537;90403104;90203442
8265;bc1pew6s05q67m9vryme0yjnh6xhafw2sldjq35zynxjer405lruz2gsnhapew;179139124;4498;225421398;46282274
8266;bc1pd7pvhuk7lnprrl3anvssljskjawgt9pkvu08zt4avzklrfaykuyq5e0lfc;0;2;19293;19293
8267;3GNUFqTd99RbNEWzt2yBPwPTY97wLX7eic;77869;5;39929170;39851301
8268;bc1p6z9ar2ywmpv57x4vsm6yzjg0tvnavtclrjt79lp0nfhhj2eazzqsjmvz8n;14590;12;375606;361016
8269;bc1q0s6rca52mjumq8fjuz4j6ka5h9jhq57esyd40r;11362986616;33767;7032536016125;7021173029509
8270;32wyxry4HRPuNgJmKgG1Az9tYBwRNCJi1e;383376;7;822656;439280
8271;bc1qhnrgtxpjllqnr506m6rpnpfztlf9xduwe6re6g;92744;6;1024808;932064
8272;1G1CMrFGH5Xgm9TBX61s1JMAjwxqAn1P9w;69593176;236;174632680;105039504
8273;3MjCEUFXcP8DTWE6PpBpAiSqpRicWwZmyg;10085534;88;47643449;37557915
8274;bc1qx6l987znh8zpsp7chz48j44pa3qukht8q66np2trzpkyarcgnqfqe77jt0;707872;1252;1255490779;1254782907
8275;36TrvtXFamy7K4po3WXKaZTAJ7ic2x6yiT;4280323;680;564614217;560333894
8276;bc1prj8vxxdth28dusg5h6mwapd36zwq0umah3arcm465l4secyvuv4qjujfx5;5582196;1;5582196;0
8277;3CE9JBbXzWXyRHcbVZv4S2YLsooecpXtqZ;1403558;5;11069198;9665640
8278;bc1q5ufx92ky5rrtt0lxasjzy8gmrcvce942d83uc5;1848503;1;1848503;0
8279;bc1pdau76zflk2gcjjqtms9vj7r3387h9qtrzl8pg7m5k2w7t3jrzjts28yfm3;0;2;60748;60748
8280;bc1q43duw0t5wkwhk2aq7gpy30vcje52umu5c2v5dz;163786;7;962631;798845
8281;bc1qhexgyn32lcps2zrjmd6dmnryd8ccgxmjwcldc6;4517626;1;4517626;0
8282;bc1qvg2hx7x0ltrmpfxu5pe8dzdvhyfs9ak2erz32qjpeez02uh5jxasd73jrk;315068;1;315068;0
8283;bc1pfh83wswdhuyeyxkmfv5kl0dmkxmrnmuv98hk8zksplmyxxw6fj3sqca7qu;23745;20;23745;0
8284;3Aoki5QXBodKU7SNS9kUecbKdfiAcVM6wE;700000;1;700000;0
8285;bc1p0tq5p0jv6tevnjupyaq56l79rf90shhakqpzpsj0rlne4njagzfs5anwr4;1834599;91;53055406;51220807
8286;bc1p4dhz6fq2vw984vfxg9289l8elc6jn68d5ltg733j3stnwrfg3ypqfrwxmr;541635;16;3129403;2587768
8287;bc1pvdnf9tqwrj0cdv2lyzjfktjkm4sn7mqjc47mg5kgy83gy58lggls7v8jfk;8305649;282;315675053;307369404
8288;bc1pvq52ylj7jmfq2tzujvccxgdet8fq4puytwvyzpzrqkxsculhezqsqr94j0;21092;6;151092;130000
8289;bc1qmdrg8f2lku0enxy7uyumm6vn3krwuzzkxlrnl6;84970;1;84970;0
8290;bc1p88ypaq2jxaq4s5wdqg63dfgaw50jkh98fuz2rzhfhzhhldu0umgq8upjux;13000;3;32000;19000
8291;bc1quh9jm6p06nqnvgvvv733pl0g0y6ycxl0aas2t4;8652923;7574;695687971;687035048
8292;bc1qtsrhvaqcv6h5yuw84ez905h4zls5es8wsggejn;1127072;7;6166500;5039428
8293;bc1pqak8xhc5j8gcz7wfs5dny4elqqeelqrd4gx322095emp5jqzxzfsfxaky2;1735371;2867;3721734;1986363
8294;1E8UxVNfDKn1dbMJ55Q6KFV3R5rfmGYNq;1865288;8;7835224;5969936
8295;bc1qcdap5mj2rn6l9ccz7a750ytxxzfwqhszzrydq9;210432;31;210432;0
8296;1FtdsM5uUjhjBonRiyHmYJQgRZzuV6zV2N;63626;986;567225283;567161657
8297;bc1pg08566tsxs924xyyl74732net5mqt9jde6u96r9yqxjl94yskfkqmkgmwu;0;2;20000;20000
8298;bc1pyp7j53rxe9nk83g6zulnnpqrc527ulnxnneaxwd54g2ps5mqfqpqzctk92;1821;3;1821;0
8299;3EHGFwfW6UZr7xiQNsrcs72i482nGNbKxW;73190905;26974;1665721991154;1665648800249
8300;bc1pmk0fnd6j7ryz72j7c7crpve7cnd9shj9g3xpyrmw86fys9ywjq3qk8ru2a;754440;2;1534440;780000
8301;3KKq3JqqXjJGTfi8CoXmMij2QDo54h6i5o;253413;5;5682145;5428732
8302;13Ui4w425yxvHs3RKk5YFAbZ27wPZXnH6V;18242052;74;22975125;4733073
8303;bc1qws8yeyfxzykuq7tevwwxezyv3ad99emlyy9uls;29756981;83851;7712990188541;7712960431560
8304;36hUUkJPPGBLs2bpwBdDEXjJVmz2Pu1udV;806356;195;388626853;387820497
8305;bc1pfkdml7x44js6ufewspcadgvg8l5du5xc4nxq5yp5n8vwrkxxmm4sk6h8eq;330;1;330;0
8306;bc1pj4wmg934gkf2z42kcgwru9hff6l604empepn0e9zgxme83t40u3qs2hzm9;135116;58;1753065;1617949
8307;bc1qeyvf26guehspqt4l4rjj8py53ysrlxzr6yvp5e;12499;1;12499;0
8308;36DGGpmoRVgSEwujxkbSBYbAJZcqczUgkL;533288891;1214;539329205;6040314
8309;bc1qyy9gjw99lyy2xn2mus3kcpk277q3qelx230r90;268404;14;2914147;2645743
8310;bc1prjyadgwmwnxsysjjwm567rw7t26rtg7z0psk3zj49466rejppyuqp5ectf;289129;59;3251297;2962168
8311;bc1qe5a7arzeaqdu6pcwcf208prfl708z8j4ykvl7h6a4mx8hp9wh32scadtfw;25358689;2504;1959145109803;1959119751114
8312;bc1q8xj44jn9ldvf0ww65l32q2earj98kfg79nv9sn;360633;392;55044295;54683662
8313;bc1qd0atu553kpjftvpd4kl74umvunwfsg4u7ljy3z;667309;283;197356740;196689431
8314;bc1qzfx2wtyy30e24ytt54hxjxfgnf72tyl7u2r04p;13050280;19;45228788;32178508
8315;bc1q7t30y5s02a24jscyxv07yu5klcxsdnzu3k9qxr;6151009;2;13491572;7340563
8316;bc1px2f6vnht2qxa64vjdstf5hzn6m23wa9x54jpk8hqgjusafhgmkrs3s300r;0;2;17000;17000
8317;18Zkz82w8XavXFtcEA8FCy9V6zsmLgEnni;1252722027;1;1252722027;0
8318;bc1qlzy96xzejfcln5zun7g8m3cuucy8vvhwf7lml5;75608;10;14680284;14604676
8319;3BxmJokGn5SrEaGwLDdgR4J4NSMmxLj2zJ;557622;60;32238754;31681132
8320;bc1phada9pz5zzknekwslnz2xwzpv6fagv6tthharsze9zvv844s28rsmh3axz;103924;72;1712138;1608214
8321;bc1qu99u5pe4a2ppgv9znsfesflngzrph7nr5tsgmr;1857438;7;4826915;2969477
8322;bc1pvqj9nxzw5mffwgax2k0g2kpuwrfz6pq3dsy30t6qmc2e35mny2usfn3t8c;354024;18;385116;31092
8323;bc1pw9qtfphg5lfuljqvlkks2u6qjc03emxjysrcl9j4efv5akgammysk8d0yy;24082;1;24082;0
8324;bc1pgy3r4k2hf7vatrrm9ty94mgc2q4n9qsprv7f7a2v5eyhhzc2jlaq2rxlxc;117466;297;112456815;112339349
8325;3FcrWyee25q3E2b3jnHdytvVkQzarrgAqU;620579;2;1289282;668703
8326;3N5SGLCXNz68mWRQxTBS4RQ2KRRjBfqcpy;7871868;50;164893672;157021804
8327;384f7HctD7TURtoh8Si8n8eB3fHMpLTe1U;438785;1;438785;0
8328;bc1q5jdvq99zk573hwuarzntcqs7ytrc4s4sj8k2ml;501953;145;9937609;9435656
8329;3FjnZVX7jTr4JXuWNkwNu3WGJ6oJNGQ3Hi;4229884;16;9421502;5191618
8330;342SWKqrJ7ZbWJzVLtrvtzNVhrWK9xJFV3;11084327;6;41225041;30140714
8331;bc1pt8rhn6dm6amwjr3tlyzllvy4gtr7uzdenwxa2q3mz54m2pzpevzqkcm58c;114048184;8073;413994556;299946372
8332;3My9uVWMdS3ng4B5LvKD8UAi9uwLrKAgXB;12350245;52;574964468;562614223
8333;bc1pgcxdcttfns8yqfny9rgjz5qq4px4908djr427xwyr9kgjh9v888sltpx6a;500000;1;500000;0
8334;18TxkahnVvfJxZdFBjCHJYwNika9qyLuFz;3610812;20;7902392;4291580
8335;bc1pfekcs0gnd339gwu5x4kng33r4wuc8an4gg35ce345k5cr08al55shrkfuy;1337;1;1337;0
8336;34ibfQVb6NHupDSFJWG1khVScoe7ZLBsTF;3914495;16;10494405;6579910
8337;bc1ptf3f3gmahwpcurjuf7mxq4wrhz0agqj9fwurdu6shj8hwg84gprqm5uw8w;693172;97;16338819;15645647
8338;37wFx7D4QVhv5GjAXcXrobjb9nW7DPZbf7;128540;3;200665;72125
8339;bc1qrzj4lns8r0ur8d6lzae5f0yzl8mjwvdg05g46q;3131020;9;3131020;0
8340;bc1qfp4ezunleug79ky9hydmf5fqlfer65s2xatsq3;78397;1;78397;0
8341;bc1qr5fqjd8muesd7nmjjkg49n0alflpncuhk6ysla;158772;292;36351119;36192347
8342;bc1plkk4upp49m3k0ewx8ee9ledajceur9l9j6umg5xx4gt5xcl0m9zq0g7r0m;4914;6;4914;0
8343;bc1pmavk6zwy2ugr3g8a9ext2fjl32lch495m5zx2jrfttmu8jdut6esq07kdu;121329;121;172829;51500
8344;bc1pxf5lwwptc35vkg6589wugd33wpyau2nuf8jznffnk7z3udre0jgscvqg67;5793693;110;46531688;40737995
8345;bc1pp8u9k5emugdrzlaye07ysfh762hdl0jufs23hl7k0f7qn7qkl5pszlkdl3;2877623;32;16082681;13205058
8346;bc1pk40pm6avclmesjwvepjk97twdwj9wrv7kzkn9ealc687ma0jrplsz63pqr;883002;254;51184294;50301292
8347;33Wyc9XCVJDArq57zDz172hi31vo5w1f1s;91470;155;55017157;54925687
8348;bc1qvvny7w3yck9hhz767zpy9z3lrljem85rtmma54;472596;1;472596;0
8349;bc1qpz9g0fze94lwxfu7tlquch4wjsrntcvwj8rumt;141760;36;141760;0
8350;bc1q9frh6jam35z6gnus607sfyp7j3vjvn0pvrtxyg;0;12;3222760;3222760
8351;bc1qwrtry4d3fatr44l4qxjvs6rh4j8ehumzg8cp0q;51989264;9430;116865487;64876223
8352;bc1qt87m0qwdauwz9wkzlgpmfj86szduwu4dyquzak;1093400;1;1093400;0
8353;33SdsgAdvJUnFtwJs3VLmkAk5AShaj2XC3;21578290;178;438321659;416743369
8354;bc1p7ktvl0ytz4ueexhmxs4a0r6rs70j82w22un9ujse7z2zccd83jlswfj368;19535;15;19535;0
8355;bc1pqem6t3fz8nc024j2wc4t8wvaxrs6tt4hg6wfwmu85qvd5u7uzsxqg7l6r8;0;2;22000;22000
8356;bc1pyqt0ule74t450nwd7watrawp3h2sefhr6j7p4hngsa7u0y3540uqhkllgu;7407249;678;153584170;146176921
8357;bc1pns36yn72chjp5k8resmdu2kwfe2c6xsqe4637wpmwtak94772puq08u0fp;2871130;3;2881130;10000
8358;bc1phxfz3unsdw2lzps8wrvhrdlpw4txwe7jnt0m6uaxhuqptycl0lfqx6z654;1092;2;1092;0
8359;bc1qwtm5hnaes66v7xtzspft6tyy7lsserad2lyz8t;658283;1;658283;0
8360;bc1pkqpeuan0mcafe5ufaskvuldkee8f2qp7w9svt3wjjgxmz48u6scsfu4hgg;937782;1;937782;0
8361;bc1pvyl69asqggqd088h8cp495r7e4kun3cpxntvz3gr5hg780dfsrcqa9y5w7;6979814;1;6979814;0
8362;bc1q6z086mu3eqe8z8ukjxdjcyr8gwgya8jt6w854r;9391112;7;14450867;5059755
8363;bc1phm8z68jn76yky7tx7zdjkvwuu5uu7u8vxllcdlkmy7wkut52qfxqc3yt4l;102787;7;93513256;93410469
8364;bc1ppxk9dw6htkr2lvg9vc2kd3aj804nslfhq7xeeeqdr95j7qkf4plqm0aagw;1746;3;1746;0
8365;bc1ps6a5hz50vee8448nfdrz27w4jcqqsjsrc8777m5s802s6laqrjaqxjdctz;75779;24;677900;602121
8366;bc1pj84czvznynv4uyexlfda57mv2r63apmvn5vz94tuqlvgvf6u3chqlvrx2a;119329375;1186;4225879682;4106550307
8367;bc1p95r9hr6x6khk40xlsw8tlrnzzaqjrdun2p4n9n49fzm65y89hn4q4yp3re;12066288;7;43327265;31260977
8368;1NXNHZr6Pbzi3VStcgaxwEhspTWNXQ3Q4G;732775674;4021;2171350111;1438574437
8369;bc1qxaw8w0tvay34u6myj47ntezl6e378kdlkz2unp;101128;5;365106;263978
8370;bc1qq03gmnr2frqzl4fw9rq2vdznapqlfhtxjs5l40;1253529;126;140541943;139288414
8371;bc1pl35wn7k578zg55exz799m6v6pnu563wg34t7yg7jsnmxpmvw5fdscdsmvu;14495608;372;14495608;0
8372;bc1p5mrunnuyv2dv2sudxfr62akc5ehe64nsfcces27w9kpjlwry96usy56w3k;450450;330;54187852;53737402
8373;bc1qsqzkfl7ewxq8mlgwaem84cz2g9lre2d4q6aznf;14889730;1;14889730;0
8374;bc1qx8qy3nux9vqj5jyr8ldh3eh7cqw9xv2d7n9xf4;107712;3;201392;93680
8375;bc1qumenz7rk52dunm88u87q6c4p8czh2la4rfxh6e;610654;32;33970519;33359865
8376;3MgbLiMjwKKA5nULr15A1mrn7jX7oQfA3V;8097182;98;35525311;27428129
8377;bc1qka5gx0xhtwmxkqghs5m9fqhrvqrxjzwjmqhuac;373968;44;18341500;17967532
8378;3PLpN1Vpaw3tHuGBRTJqwr2gsfYAQAKvjk;1379565;277;550151752;548772187
8379;bc1pegl758swm0z0tqfmqasdjewdhyy90rflyx8ft5j0sy95tkms77ns9ygd4w;574903;78;113393639;112818736
8380;bc1p7gzlp2euf82t90mundv9clvlppjfts7nu8mvt9kuvly3zud9jj0s6jzrmp;3446103;5;9383443;5937340
8381;3GS6hv5KnrGEGVprNx4tNoFYocxKfco34o;24090021;309;1130463992;1106373971
8382;bc1pvlpy4ylw3luax6hnspsjfgvfns2svps5ehprfd7w22m7s39q0hfq9ps37d;1974964;4;3974964;2000000
8383;bc1pwur4vhqkqsu6w02aml3rsu496h35k78yh5nvsm20740234q047gsjh9ygj;2556364;68;26170647;23614283
8384;bc1qy094g8u0g52g0mus4ns5vay65l2r9nuf46dks7;101340;2;214340;113000
8385;bc1pcnv3zq5ykzu9pkmsdn64ky8lvkt39vtcqxz9ajalvgfulgn4ndjsztl7vd;25383285;48;186833690;161450405
8386;bc1qc88husc5pk2kl00aslpnj2sj7shnnt6s9dl6ud;161132;1;161132;0
8387;bc1qr6k3nlecuc643zzrepjvnwakz90q5xcecrdquf;68385;3;671060;602675
8388;bc1qgv4u6enfshwhnqkssdxnfy5u25fmchq3tv3kvy;86349;1;86349;0
8389;bc1qcuqvc5c2h9lu608n6w2hm5cw4ct623jfqleycz;0;78;30308483;30308483
8390;3BBMSXp96KsfZNTaAhAM9FDtb1nRCCngPo;1247817;104;24591183;23343366
8391;3Bqq3CRzmQb7hJ5mRvi1JTRLZ4mFn1jvKt;1146526;5;36678226;35531700
8392;bc1qgqclnalx9kcpfx2skxynmkjd6pkcp2ngckyfjp;94098;13;2443784;2349686
8393;35juSr1Gu7P1syrbtgTxvrSEtJaenFVNJE;0;104;475316486;475316486
8394;bc1pmcxmyc7d4slvtajxsdw60dmzlvwphzlc4rhzafmem2px2sqyjsqsrpjc3d;4024069;7635;3737867647;3733843578
8395;bc1pj0pxz5ltwke25cd3flrzm8rhax5mgfa54law9lg0c6dkdsru30qs40ug02;6462995;5;16029032;9566037
8396;bc1q7fch27hh2066lwm2zdk9yp7yl0ued97g6ejxws;107790;2;107790;0
8397;3PNtEspQ48AEu8mzcP2ud6tR8sUiBdnvmq;2219;6;412545;410326
8398;3P4WqXDbSLRhzo2H6MT6YFbvBKBDPLbVtQ;16624780399;955161;50009891438;33385111039
8399;3NEV1SuMf6zPDML8V4m6DmiHP8txibajFY;407667;1;407667;0
8400;bc1qmn2p20atmy27q23khrjgahknpvhr7l43narre6evuhdn6k0t845sxcp8wt;23505;1;23505;0
8401;13vk1vKDDz2RxE2GW2NtdoHdbb4kkiQNAi;156575;11;1078728;922153
8402;bc1p2fjazjnedaf3m87gdjrpx6uw4jfeyw96ktp3zs05kmdv65gahctqmsafcf;2001110;1;2001110;0
8403;bc1q7mgwyyz3h6507uqvtfjeruf60nh9ygyzwwfxxg;506451;1;506451;0
8404;1FyGVx4KTsF4bzVLYQJ5gHVUuNkDEaR5rK;503336;8;994172;490836
8405;bc1qpphsl8952pfuca8xp6m9axhhztsm90cprznp2u;36324;1;36324;0
8406;bc1q5qxxfxtm6w0fja8t5ewr55wtm7xze5fy6yl3w7;154786;1;154786;0
8407;32wyxry4HRPuNgJmKgG1Az9tYBwRNCJi1e;383376;7;822656;439280
8408;3HMrn5nEKYgsu2hHavbT6FgCt2dEdME4Y2;11440109;6;16469850;5029741
8409;3ENNh62kXSjP9uR7wb8hse7JLvMzokjbr5;1733087;7;1733087;0
8410;bc1qkks0kkfext386gucaphp5jm90uqctlc8k00k8q;12219168;514;67916976;55697808
8411;bc1qvahwjhjz8auxtrtwxxxqny982xzm5gsumpl7ejagdyhyg3p05j6q36pwj3;1100000;2;1100000;0
8412;bc1q2qc9sthtq9myahj57gektd936w97vmjfg32lnd;391231;1;391231;0
8413;bc1qmwte5fatu92m59g5sqqz0u4ra8v4kwdq046hz56gngtcjx26pzssqmkuj5;141477;1;141477;0
8414;bc1qpuuf5s8zfk623vntnc8xuradcmqnggj2jvmrdr;86051;1;86051;0
8415;bc1q8h5wtwha8pfqzufjgxwkd6phys3nspqet0hdmy;4797977;1;4797977;0
8416;3KyY7Ft1vjxwfc9hfdavZrwmRKaAxeLuDU;128006;1;128006;0
8417;bc1q4pnhy0y56s6wcnqn2hh6rsd7upjeum5t4k5rnr;1105015;19;2444305;1339290
8418;bc1qqfshfxkgvysx2472x8fyu05cwgh5x899sldfef;2578340;334;1453096159;1450517819
8419;bc1qkn8am4a653sekwn5zhlplfycy9vyn9ls0lhgt8;641593;1;641593;0
8420;32zasVYqf2Rssm76h8r7gPLS1sQAuMR5MG;60728;36;4135986;4075258
8421;bc1qnhcec9agtvuccxt83zrexfxup29l5rghwk59qw;799847985;6;799847985;0
8422;3ANidsLAjpusAoD4gAoUFPP8bXvMShN8Sx;3103322;13;24070855;20967533
8423;bc1qw34fvwxxgtfk3zfawgp5rv9ayhypuqj75z6gqahg33n2s5s5ffkqpn0dcj;1795590;1;1795590;0
8424;bc1qkwsw6k99yfhcshpxs6vew7hs20lghnkwm2hw0m;149436;1;149436;0
8425;1CXXJz4C8bc7sjCUvxcuABRuhEJByvifQd;343052;5;343052;0
8426;bc1qy73y68p90jl3ux7g5jf2d7pn2husj53ccpyycr;0;2;317828649;317828649
8427;3NdUwAU9EzzPcEuHNbzZfS5tRjDskfaa2z;1065722;1;1065722;0
8428;1CWPMH37ecwii3LAHDamUNwjQMEgNMfptT;156880;9;780370;623490
8429;bc1q7kca83xe7sx6kal6z6atwx4r4dnf946zu3gzrm;1409495;1;1409495;0
8430;bc1qgdg0qyt7hnu8353g64tetqgwfzjd4f3d92sq7w;16829292;1;16829292;0
8431;bc1q6yeh035dgefgwa8d5r3ugmwclunmlrqfmshjvz;217279;47;1637431;1420152
8432;bc1qvm3zfncllfncxhqr5cjqdhsevflgg8k66wtyxq;432254;1;432254;0
8433;bc1qsthdzc485fgy7w7c6d8nm96ptrfez8tjd4utym;2259244;1;2259244;0
8434;bc1qd70hngaw087ej3h0ws7c0ju03rnfvkw89yr9u9;170920;5;170920;0
8435;bc1qjam5zcrvxcgds3mwasc2xd9dkdankrcpw7tt9x;1231357;2;2987660;1756303
8436;bc1qzr6kclmq6t63tjupgv3e8gylszclplyczsu76z;1011023;20;7907698;6896675
8437;3EuMfooPt7A1kscL1jpMfwa5PuSdvvMcgJ;108879;42;3981693;3872814
8438;bc1qrkqds7ac2yfznajjtnf6tw33yypwgkdgqr8w00;407890155;1;407890155;0
8439;34KWvHGe6uSZw4NknCghssaQELREvNeFNg;37955840;111;786592693;748636853
8440;bc1q3sjgqxee0qszzxce93apndxq4qtzuwkf4mn98d;727485;1;727485;0
8441;bc1qtjj3t84ljyr4vzva9sw8k7g0dw9wlzcux5280w;180146;1;180146;0
8442;3H8wmocGGTMRMGgcppN45GKc4gYmEH3k5K;312910;1;312910;0
8443;bc1q4hazuhhq66f99k9xawfu8x5le6j986px3kqdcz;0;5;871838;871838
8444;bc1qjmzgzusrq6n5rp6p5h9e56xsjj2mupuvqvfzc9;48204;2;48204;0
8445;bc1qgt37n0knfes4tda6hgmcpr3dnrkplfe2hzzx9d;78367;1;78367;0
8446;39DrR7QCZakiuRcygsk4w8uoKw5jM56zm3;463411;8;1675998;1212587
8447;3LSPkQJukToFUezsVW7SBVsS9EzBWGvKZs;321911;7;1512473;1190562
8448;bc1qjqv4gvw7394lme85f3evyh5a0tzg6dl7fskxsn;0;2;557444;557444
8449;bc1qx3cqp4m7rjl5tsljgck9j4fc36q2khqwu2qj0t;44262;1;44262;0
8450;bc1qj82xg25xt3ksdmdy3m0m2strcvf6u37n0tes5j;541179;23;9452871;8911692
8451;bc1qcm0jsxfts2ralvqks63ttd87x9d82gsr6fvx0k;42460307;1;42460307;0
8452;bc1qely2h7ynnfvyvxleeug7sggk8hec0dvmcupu4h;50046;1;50046;0
8453;3JEg5jaNwmUoMqnxGiHfQeKLo4GBRd74jB;7138849;69;39699249;32560400
8454;1GJokBKscs1oFKRcKfAehtq4nKddqGSuuC;1453497;344;18094568;16641071
8455;bc1qvzjv2vf0sv3cjyjpg7gfrytk2dnts9e82ew2xs;193985;1;193985;0
8456;3Bw6J3hvUPpqF5dZM9q24VgTxHdgoVtn4A;791658;97;35636088;34844430
8457;bc1q9x4zhclyus3j8ts5sfv8fk8jj0vc7lk2xc5knv;0;782;604194762;604194762
8458;3NcUpFGvoWUzCHFsuozQsgErNJJr4x9CGA;6828292;8;7249000;420708
8459;bc1q7mvdlqju390g5tjlnh06l2qxsg6xyr8x00xk83;750251;1;750251;0
8460;1Dw3KarvtXLb1anX7JZFr8vBFZ9zR5Tft2;2818030;1;2818030;0
8461;bc1qs6r7a7kz7s0fddaxq77nazxk8pf08xcc9rpwe0;0;2;478719170;478719170
8462;bc1qhkdlr94q794v6r55ylezmne2k2wvhf2w2sfg95;94040;1;94040;0
8463;bc1q0pthe3zhqgg0uarmh23xthku2qelpz92gwy2yw;65712;1;65712;0
8464;bc1q679hemd4njxtg5j8tmnmxj7w3n0h6an4jdjxcn;6355281;76;49371912;43016631
8465;bc1q06aw4vqkcal02tg9ftpnqgj33e3a5e3kth4rhw;19288959;209;40635221;21346262
8466;bc1psmra9xmc4rdsprgvrp3vlnx8mmt0xea96hgycnncum3k0s4j8u8qlfk7ch;465891;85;15463259;14997368
8467;bc1qdyqem2e60m2mc6e4jdjj59ng6t9myjjqk4p3wm;78285;1;78285;0
8468;1DJCcLVRv8CfNY1KhgontzwsP1ZUNDqbqS;5652868;11;17330644;11677776
8469;bc1qjjnumry355zz087gwc4k383avxyjx005fqtzc9;688008;178;602010812;601322804
8470;bc1qmguyg0urjzk4l2af3d4dl73djz28mss7vr3crl;313600;1;313600;0
8471;bc1qvcgdsdrmgf5sr2dl8j2zzwldlsy5ds9y453s48;26015804;4;26015804;0
8472;bc1qq5d87tdf73tsrrmnl6v5fyqqcpm65v48478yhv;40695345;6;40695345;0
8473;1BrGx7L4vFXtBmZRZfQkzdK1nH1TWhhX5u;6194137;5;16129089;9934952
8474;bc1qakz23g78av4a5y7l4he6h3fuf9afwusvunejpr;109633320;1;109633320;0
8475;3LdPK9ecB19wNcDwL9rwRnsGv3XBPmvLwN;295366;1;295366;0
8476;3MG869utLPWFbUVFW8KgU3Q1E5ZQ69zPQZ;166474;5;641808;475334
8477;bc1qe9xz0xuvhqwugmfga9ryah9t75uz3y4faap35dywe2fl6qx5z8sqdkqrcv;109987;1;109987;0
8478;bc1qqkqn3920shwtq406znvmkxu266j56d7xtyxfq2;1346191;1;1346191;0
8479;3Dz7RzGmj7mYFqxMBRYueQoiQS9VKRdumm;561890;3;882383;320493
8480;37MpxwC7YXVCA8LjjNKdtPDADYABvkx3sQ;1462271;26;2918473;1456202
8481;1Jr1ZPv7noqyyYCoHHE3e2dbMbospermsS;9943094;12;40557256;30614162
8482;bc1qh8anm7tdr0mwy56hz3ufqnpjvnlarnsg5mvu02;217647;1;217647;0
8483;3LG8sJzFBFnxsNu8r88zFUem99WbQ8NqWz;25537223;62;59725455;34188232
8484;bc1qh5ze4x2h77l6yvczuzg9awp8wu4l2vwyur7hua;358471;1;358471;0
8485;bc1qxzfdjptuaeyujh27vvkquyyxsfaeajcug529tj;65070071;531;1745864005;1680793934
8486;3BGPd1MpqXQBHHPbApXCGuJDg4xLAGYExw;281839;1;281839;0
8487;3QksommtnZsocsQoEyyGqkqEtJ1GNToetG;13519755;99;28975370;15455615
8488;333TiMrLcTJBq6qypjh1FDGMwJT9NjCq3y;156577;1;156577;0
8489;3J1NAa7dwSQSQPEc2WoWHDs8k8UvZP2srg;17128024;611;1497878259;1480750235
8490;39juqW8bm4yyiGKME6kYSxh3AdiFDhgREJ;79495;6;168544;89049
8491;3KTQHbMGksdGf6RXq21aZwiU6ed4HzEKQi;7500000;1;7500000;0
8492;3KMdULbNXbNYs3ENK9Mqf1vAMHUmoRcuDY;11086974;23;11086974;0
8493;bc1q2g26w0anmntud0clpusy0g7746m7rdqvckwadl;6322954;41;9672545;3349591
8494;bc1qcxtrw8t7ugtln4uqnztwl9dvl37psdf8p0tjq6;73534;1;73534;0
8495;bc1q6x8gkeylxxtjthkz60689c0syfuxwny97g0jx3;3783184;127;22586081;18802897
8496;bc1qh6gykjdhjad8dejwrcgz9ly0fyq2kd93vxevex;96721981;118;2367264863;2270542882
8497;bc1q54af00wt639gpel68xj9qs85kvltum6j3y0nrv;355583;8;428914;73331
8498;1PNWhDxzALS2LMXN2qg7Z3mwKqZjRceMvC;367636;47;28076908;27709272
8499;bc1qrw5d62eme6vd36sp068max9kzlds3gfuna2dwe;171387;8;968903;797516
8500;bc1qsk2gzedw62zplv7amncx8d44y7qmmtxw6vj69x;2493618;292;668452241;665958623
8501;bc1q5ryarxp8rkzur3ed8qmf47kyde4kklkep2k3k2;721782;1;721782;0
8502;3B3TUD9ma4h86JwVyJRUVDijXXfVBEJS4r;108209;1;108209;0
8503;bc1pccpg997qj5r35jxh9dzmf2yftkdlvfjrav0fqxaxmu4qkqxtcenslp3cdg;1650;1;1650;0
8504;3E9e8njkRqHKwyhqWiXUbKW8dfJQJErCZZ;1052244;1;1052244;0
8505;32tizVein5xeCiDRvfyNoJiDHUnqhM4xBh;9464396;5;35784484;26320088
8506;bc1q26q4nfs79da5zu48rjy3a9js5k2frazla9v9zr;170723;1;170723;0
8507;bc1qz0hlvdds09vcxvs25epggu2yuyh6krkv5j6xma;280147;1;280147;0
8508;1KmsnVsSjrgaZRwcRv3basHt782RqkoaLf;222776;2;222776;0
8509;bc1qpzaf9nl9a3jfsyuysrvsmrxj03z8g7ktv6c7ml;10854494;5;10890983;36489
8510;3D1e3usjipDXJJPDYHu7hm482qAE7DiPae;50838;5;15050838;15000000
8511;3Jz6gsFS8tHsTuLRvY6SGLWBQVb6imbVWa;16035;1;16035;0
8512;bc1qqv755ygjsjqee0gnx6fr0m5pkzp2cwz7t8tn0nchuz0z0amh32msc4jtld;71300;1;71300;0
8513;3JiqTAXVN8FGPkzKY2kbkFspAQekcJtk3b;6160939;6;24596019;18435080
8514;bc1qsp38d3dxee9ew448v07yaj53r704f6fkuq9esd;391373;280;282846908;282455535
8515;bc1qfd9g29yhdcchttvd8v8yfc4hq8vaem0dcx2q9u;0;2;197420013;197420013
8516;38xxTq1PF5A1EnSCgmd9t1698FmbWeC3ax;215387;8;13334556;13119169
8517;bc1qdy2rxrnjya2ps2cc585kqd84ec6aprf4ql4m5a;684612;1;684612;0
8518;3DasyfHmSCQWqePeNq634SidWezfpWJniG;139100;1;139100;0
8519;bc1qk3g8s8cnn4k3f0gtfnkgqg5xqp2t2jfghnz2wr;22709;1;22709;0
8520;bc1qp7lf8yqkw7wvdea2v4xt4q0c7y5gy9aa3nj2vu;816304;1;816304;0
8521;bc1qz7ae3elwgv6uag5srvjr8yvurzl4uwskyzahkl;39110;1;39110;0
8522;bc1qksdrq5kdq4jpnx5h0uteyz0qjh8nepmm8mwh2r;1250382;1;1250382;0
8523;3GAapTu4UNVVpuZs1iGcmjbX4gn8DLMAoe;2237100;288;248313054;246075954
8524;bc1qmvnwh8n0lcfrj52yhsqvwsvuhqw2qxarp6rq7n;202491;2;202491;0
8525;bc1q3jmdm7jr46v44wzk887azjs5x306k7xz70m85g;563871;3;136528711;135964840
8526;17PBw349nAUSqfmLFYcUBVxq7QsMr59nut;117271;5;416387;299116
8527;bc1qejw5d2laqh5vltjjd58jq43pakul0wh0kwjk5a;97070;1;97070;0
8528;35rqLgCunP9WJ8ZZzuMdgridvt11kSKotA;576972;5;1608258;1031286
8529;bc1q7nw562zhaq0czcq0uc4yqkxtdk54h7e4ndnjfk;804838;23;21941248;21136410
8530;bc1qrqxd9xes2sxwn8wgfequvt8wh7x000ep425gd7;508993;1;508993;0
8531;bc1qmehylgqrvxk2v53c5am8qx3pet53jhc7s43wd0;53059;1;53059;0
8532;39gJFYVqzN3zADoWEFoGnuXmzwFFp5uS5i;341515;1;341515;0
8533;bc1q99pkdmtrgfru0jkeqm7sjcp6mkj5zce3hujy55;2043095;1;2043095;0
8534;16PveT1nW6BwjxZnEHVffSbnp6mLssYZmh;34853095;12;34853095;0
8535;3K9Uav3d4FcJUMKz3Urx5AvsTzsf1aDzmZ;833903;4;1311843;477940
8536;bc1qmjwdumc5zz6q65qcdcu50p2pggmu6cmu2z9q7d;834000;1;834000;0
8537;bc1q7mgvcrk88zadm4utfm5cnvxpu0kffuytehpr6q;483129;98;10529741;10046612
8538;bc1q09x2dal26va5vv2ql7pxkamgr4quw63cka4ptl0y7l6hqt4xjusspnrqcs;27950;1;27950;0
8539;3392yNiK3SQSgAnen5skjTRC1VBUDE22DC;620522;67;12516467;11895945
8540;bc1qr05lmrv690vz0rtf6crlu508nvmxklleruvlmx;968332;1;968332;0
8541;32d1Z8s3zMAsv29Th5MvVWUBoC1tshsGvE;4021616;5;10840686;6819070
8542;bc1qqdp55e30ca56c9p5ez39sttu3ym4znnqtflddn;154649;1;154649;0
8543;3D2RsvQRL7zpkA5y3EVVLarJJ7veqafPkN;13151655;2;13151655;0
8544;bc1qf20505rete5t4fqzlsv3r0amnmkqe5xp930nwu;509392;1;509392;0
8545;33niMqBisqTRbErEtQ7W9ZxaX2dUgVH1pk;6969910;1;6969910;0
8546;bc1qmpnfpxe05lk58deff69gexpa4hh62avywmhsvl;747719;1;747719;0
8547;3ChcdyiWYTg6iy3gno2mCeYcQRksFabp3K;3149919;232;269571420;266421501
8548;3PW6rDCtBeTpCSqgDHBaDGQKQ42PvJhyfF;5874340;16;27293270;21418930
8549;bc1ptgu4wzvd75u9nq9m4dc4lu7td7gcffvueewltnr2mjkk0lmgrecqq286cq;1154438;955;444315820;443161382
8550;bc1qlcjh9llp8nep0xt7ktlmn55w68atp5t2wq8uyp;0;2;444450987;444450987
8551;bc1qlx6y49qn5x3veu934krp7n32ptdf3qa24st0h2;12591;1;12591;0
8552;bc1ph6pp0hpw2h5ch38uepnqh3pdqau9y66z7tukfrj3q2ralazqn2pqaum5xp;0;8;199723;199723
8553;bc1qjw54raekp06899t620vs4xzyk6zqlymvn5nzjc;132940;5;354164;221224
8554;bc1qpq07s4jcd3sj3sl92w73s7sedll3wkqx6xma6s;29845647;1;29845647;0
8555;bc1qlluzlz4nxvj7wra8xqdryzsdkam8hs6slpqgvz;938612;3;1541860;603248
8556;bc1p2lw6texkydpx9kyh599d8fr2g6avf8mpkwgpe46r0k95lf76ztss5qly9y;330;1;330;0
8557;bc1qxedt92dmkg20eqhpqeqvxqhvn7wqhf458wdu8z;78214;1;78214;0
8558;3HWeUvLYmC4xZj1jj5iPDRk5v7Gycp7qaW;7828962;1;7828962;0
8559;bc1q59v5utmpkmg4zvs00ep7z09c5qhgyuvu3ecjlq;6342467;476;56612031;50269564
8560;bc1qlmq5x3fwqwv2smd2084q7jrs62tpqj5jalec36;5783500;1;5783500;0
8561;bc1qxsywm0h85kpr479ran4st8ck4rdw77f2dc2fda;354553431;1;354553431;0
8562;335PErjgaHrAWsmqXqq85hy7e3md26PHwF;469518;1;469518;0
8563;bc1qvtpuqlyqsrxkzmy200ydp49m9gh4vq6j44dagw;130839;1;130839;0
8564;bc1q8pmkusdds8fs47xe0my5hwjanyqpjym32vet8j;132989;1;132989;0
8565;bc1qanqmf9346zvrxs8yuxkdh4ywcwuyexdyv0qegl;13255977;23;80108525;66852548
8566;bc1puw9xf3wfswu8mel8u9nzf90vw9yzt5w07wq59vr2w8nft87md9lqx0s0nf;366806;1;366806;0
8567;bc1qp4jnwxscmh4dq9f202mnwjhyrphd5djqjsylpw;10987625;72;297187589;286199964
8568;3QxKSnSkvXJsKnbEwTCXn17n1gLZMGqQe3;59496;16;2117668;2058172
8569;bc1qvlxgpuz8n6gl6lj0h25k7x75dzx4j20lnkz2xm;208262;1;208262;0
8570;bc1q2yac2weaahr66am5de9hw44jgu9tkxwgh28c9a;401869;1;401869;0
8571;bc1q79r73au8prcxyh2dddrdadqd8wn0mm7l5mwjjs;250607;1;250607;0
8572;bc1q3ap3tpxsv2jl3ptd3x87nhqe4m9uyw0wsg44cd;510000;1;510000;0
8573;3K8v6k7UcFb4CqbXurj5WDj9aQxojuGW2L;1233003;22;16917007;15684004
8574;bc1q862l3s2vac64j9sra0ud8ag2a2lke2jrh3uqc8;333700;1;333700;0
8575;bc1qptjvc3fpk97vsx8040tyqufkjhp95jtwjz70gd;57641;1;57641;0
8576;bc1qy8p4e5j6kpmrlnw0shvm69cmm09cyp9t9kt7um;197176;1;197176;0
8577;bc1pp7q4vcwnqp92e2af8vgwj0ljtrexe08r4u25rlvqzw9jv6x06auq2ttj59;2000000;1;2000000;0
8578;bc1qvvn788xfhw4dlljsnhxlz0q8p4hj9wqhdx2a4r;0;2;281587;281587
8579;3LAcf9ddQ6RSgSrnufgup6cBLLrkS3bQfA;8734543;109;89396474;80661931
8580;3P853iTUG5L2DsJCdEs6aywqU1pjVpq1wc;29590904;752;1226206090;1196615186
8581;bc1qfvws9mpkzh47rfwljgma07tl0fcvsp23z35ruq;0;2;271516545;271516545
8582;bc1q5kn2mra5pzcj4z03jmg75m5qx80hr4eg9ke68u;0;2;425152696;425152696
8583;3Cy7pt3JunU7S9RLK2hEkibPNpDfYoppMm;6769060;6;21112994;14343934
8584;bc1qjzqts4zrlssn4jadj22r97xa8vhszn9y7m8u5k;21901;1;21901;0
8585;bc1q0v7zjqv6vrm7qeuvfajzdpq9efgqnkem6448fh;62691;1;62691;0
8586;bc1q63p7dgc6xhlam2h74szl0gupxcu0aecc0uxhy3;554305;1;554305;0
8587;3HJ1VLsaJzRVnezdQYMf8KiXopuKtwBzPi;30299;1;30299;0
8588;3KS1Sw9eb8Zkzw6binKTkJGfXdpASSfQMU;110029;8;16476382;16366353
8589;16Lzy2xH7H6NUFZhQcP16u5TCEeajSYbyT;2133171;225;7941771;5808600
8590;32x7uhAyZVsuf6B8pLDFCWaBtm714oiCCw;7228698;2;14508698;7280000
8591;39RLh7eAsYtrSAFwexbxHXQieNSKJfWnR5;1618233;27;18433860;16815627
8592;bc1qa6s849tpwc0dzhxjtzq26ps9lyf87axyj7zsqy;160684;93;46156927;45996243
8593;bc1qfsp4nruwmehgdqt0xde8yd0c3faq4exwfe7g5g;3631984;19;27555651;23923667
8594;bc1q4w68stf8fxjac86cr54tmnmxhscfm3yrprzlfl;283528;1;283528;0
8595;19bDhiFZQNeeHvHZwU1TfuWsn7c4H9QgbB;20000;5;292305;272305
8596;bc1qsdafquzkk8v86997ekdutmyj5txwzcltdk09x3;57020369;14;57020369;0
8597;bc1q5huklj09l3e8djkswrtka6glsqc3k45rjf20f4;696133;1;696133;0
8598;bc1qeutylxz3w4f3am4qphq7arwxd0twtvzel8470s;148585;1;148585;0
8599;bc1qwc25gg5wyrkrwzjhg3527a7x58cwyj8yqweayq;0;2;352475054;352475054
8600;bc1qsjey5ksfxsseqdyjv7lu2tmy3tf5yw8f9ymh6t;484969;1;484969;0
8601;14mPCntAWAAwvYLackBHmg1bw8s61vLDAm;18640;9;129964;111324
8602;bc1q5kdmyjtwsvlr2d2c3alrznxs9p8rzfptskt630;283478510;19;283528510;50000
8603;bc1qxzulwhesq43p8s674z0evcjh97vgwe5kk3jw4y;952446;1;952446;0
8604;bc1qh5ctdtrd2r6ahws2r9dxqd0dglxvwtc6t2n3du;0;2;141434739;141434739
8605;bc1p42kll686yz9y3j9fzdwmwqz9vzh4me3sdr6trzlcwfu3rd20xkxselvnuf;142328;166;13974488;13832160
8606;bc1qh59yg06y5j6t28lyxl8npgcn2xmdrenuxy5rr6;239638;3;381599;141961
8607;1LiNwMX7yzHk63NWixE76SjZFWq1XcMQ8c;262791;1;262791;0
8608;bc1qc6vgqfy356w9mqfg3mxs4a2ds25yzgt8ltgdq6;12516;1;12516;0
8609;12aYKC2kVnQhHRBicrHw5zhjvRv7q93DHj;6693197;16;6693197;0
8610;bc1qzs3v05vxndyvysctfjkehmxnk22rvq0vq03f3v;195833;1;195833;0
8611;38VSH8c51zbPHWr2t1BR4iE4DSRLQt3HGL;9097789;1;9097789;0
8612;bc1qh9pc6qde4tzjd7n367vfd7k5f3fwxm2rqjays3;18800000;1;18800000;0
8613;bc1qfzmulhhysm5dcjegm7rmgrse6fnmyfpahryfarq44ngt33x4j0tsy58nd6;156434;1;156434;0
8614;bc1qke2reygus2nmvn755fan5t0ekztjdddl07jw5y;12297599;83;354640873;342343274
8615;3MBRi9tUxotJwLou4iRUneqethxRfXdTmd;2377067;21;50329794;47952727
8616;bc1p0kp2wdvcjsp3p759mxtprpjah642puzguakxv4swjdr54meykmpq5thq9x;84931214;149;721633103;636701889
8617;bc1qkanut3zdxrrhj036msyuec0m2w5eqsx7msk4ap;75128;12;275128;200000
8618;bc1qst6hz538pku97e24ujvzv7x9mpw2elsqeuz6k2;0;2;180452212;180452212
8619;33ZS4ypxXMPwe2PxX6irSVi3uvDepVvDYM;1294289;2;1294289;0
8620;bc1qf8vhcft0e632gn2h2u993awz4p9tmdkrtg9awa;48484;1;48484;0
8621;3P4WqXDbSLRhzo2H6MT6YFbvBKBDPLbVtQ;16616784615;955131;50001895654;33385111039
8622;bc1qjdj9pf8xzj7eg6fspfr34fu4tqz7q22qxmec6j;20300000;1;20300000;0
8623;bc1pm0pyef9p9k3wraklh03ea8j6y7c447h59yepgrz22qxwjtme7f9s9csdkr;5000;3;21000;16000
8624;3HBR55o8KBS8BATDLZ3zkSYaYY29cUS74W;35117300;109;134093406;98976106
8625;bc1q56qxr4gdrcq6zgmv5v3w7ajqzz33m92k9khn4w;81902;1;81902;0
8626;bc1pnm3jt663ka6eypmj83cruv0n0s9a9jwvlk42ve6kn4rg5p2ppg3qh2y9x0;1262584;979;289614950;288352366
8627;bc1qldxkk8a4f65n56rymqrx9mrv2tlp8sc8r3pjx3;58223845;113;58223845;0
8628;bc1qcxw9ddpt6lmng9qqf7k0kvqvmdlgtdu3s0em8t;104946;1;104946;0
8629;bc1qp63vvs5d95fmxh5h79tygnt5mnarfwzpcecxkj;23516;1;23516;0
8630;bc1q4ly2f63fnj2deayhsq8cp4h2cyk2cpk32kjfql;70294753;1;70294753;0
8631;16AiiDf3tJgA4GW6mcpjDsCdjo64LBALgH;7273825;28;8358793;1084968
8632;bc1qtcw84vle0eaxaak4evsppy33qavm54968mh82h247jknywxmjqlsnv6hrd;219260;1;219260;0
8633;32yEsF1AZBQryiQ4k69brME7zqCSNDfdbz;2202394;440;170072286;167869892
8634;bc1q6ng3u2k9r79qdwla9kun42gaxqvx4g20u0wnsl;227313;1;227313;0
8635;bc1q4ahwyfkz2agr2r6tvxt2zksww0czmcsk89lpz0;5076080;1;5076080;0
8636;bc1q9ueqwrweau4wgwgqjp7qkt50axv5c4mxp2fq59;0;2;278799;278799
8637;bc1q6lmpht29l2j64e58wwlzp9uj6h3fcmanx9xcze;79262;1;79262;0
8638;bc1qndmyltcvvg6qcsx9l0tc59snkzlxzjjdwy7n55;69704;1;69704;0
8639;bc1qzvcjel9xe25577m6vwlutea8s57cwpn6rrkjr2;28536;1;28536;0
8640;1Dt5BKMnWH7GFHQPwk4saBJDBRrfDcgqDf;1957378473;7760;4010308764;2052930291
8641;bc1p6jv9zjurr4fzuuq2ayd03wspcuxpwzntg7yxd9j4qzfn2xk0k9zsda50mm;43758;10;572619;528861
8642;1HHMaMgKCb2aGaHAaiQb7NAkshmX2GykYG;345028;1;345028;0
8643;3Hp1dBxuKds357yrZF9cR8aUkrMSY2awBR;181593;1;181593;0
8644;bc1qfhdypkjpwy5a3u522fe5fgzjnua8pq6fl97x4e;7055;1;7055;0
8645;bc1q3shxdwshygnc7v4lckk2gfmyfk30j2j7yyydmw;86826;5;335864;249038
8646;bc1q4ufmawhtcgcq7da532trgfftqphwafm2jq29gl;70578;1;70578;0
8647;bc1qmf36jqagmyper0ttfy8nfhldfv9shug6e0eayd;81934;1;81934;0
8648;bc1qukl5hnvs570lu9h2mq45vnnlg9mn4pylwm872p;6286667;3;6286667;0
8649;bc1p35c90relxeekk7gzpgclm7m5pp3puehjgcxf9yl9ws4798zsun6sqlqghe;0;2;28000;28000
8650;bc1prukhmxmnjh0gj4replkn85srucm07ehk0avt99hy5f8tg3dw7tksvhtumv;5517066;11;70534402;65017336
8651;bc1qe54jy5zey2hw7snu24l8cdk29ahkucvpk8f86c;796343;2;796343;0
8652;1J5x8r8TAtU3hm9EDRqJf7SRYyECBzfCYd;7662223;83;7662223;0
8653;bc1qw8vymhmze9trfkquqrq28ttfaf4etgcqq09x6e;20895;24;742756;721861
8654;bc1qgzmw0k8ll33nn08kfsctpsr4n8lcz7eece7wh4;36068;1;36068;0
8655;bc1queaqfvurcngy6rzu5345ygf2edragn3lcgezdr;20898;6;150212;129314
8656;3AzoKR6SLSPK4bA5ZB7kMRr2Eg2J5g7WEr;295980;29;5383432;5087452
8657;17nHgRYuVYGCCXsAY2VCn3kEvpzNA1roBZ;4099274;13;5212217;1112943
8658;bc1q2fcnxe648gzy2a4eymxq0v474l4e6y5ewzm2dx;50000000;2;50000000;0
8659;1DXuyavnWc1euYEvnTVG8ssWYLeSo5Mz8T;1234602;14;1234602;0
8660;bc1q34h8ct6x7gfveuz8npnnga4d5ujmvgall7jxgr;650509;37;1427934;777425
8661;bc1q0czyfe8vs2jl0vppd2agjc7py7963uect50pne;2097160;5;5627454;3530294
8662;bc1pnyu6uk87e2l779d9jfrgv8n5vvvay50ern09kgjlgxxfz4dg2nvsv8hllr;312927;4;1818279;1505352
8663;bc1qe7dpuzu5ljtsca39g8k7jnvp0w8reetae8sh2a;605264;1;605264;0
8664;bc1qs49afu82uklcv8txca5ulkzxechlxketmtwe5w;28546;1;28546;0
8665;bc1qac5g84ehd0vtz8nfgf57pg4zttcm6wymgru5le;6572495;1;6572495;0
8666;bc1quh9jm6p06nqnvgvvv733pl0g0y6ycxl0aas2t4;8650875;7573;695685923;687035048
8667;12VxTLLn6rJzgRwXn2PqTP4qxJbEAxq3HU;252940;92;4209080;3956140
8668;3NegYYAbGwu53VxeXrCFurBUWCsz8njnJm;6830128;5;38105894;31275766
8669;bc1qvppj8l5dumjqts87qg0qr7rfwymy3v8ppzna5k;142951;1;142951;0
8670;3CScF6WDeXKMbc6RtAHLcBafvqXxXZfbfi;376207;2;376207;0
8671;3PWJmoE2ofscJZoYCkWhs6h3dLhLrhgLfu;5000000;1;5000000;0
8672;1558CyUwm2iEnZsKpC6X2rfVKsFRAuBwHi;19386;1;19386;0
8673;bc1qc7useahm3psgr3v5p4fj3aegacrlul36uypq4u;13323;1;13323;0
8674;1PDiHNxhT7jAPCkbgJ8uee4ZyD2T6vro9J;2516278;119;55647352;53131074
8675;bc1qnsnz32frq322exswlv8yh5adstvmhdkh5ll9kw;3134;1;3134;0
8676;37aZAr1HCHtns1S4zwf8VZjar4hFE4t96U;148801;1;148801;0
8677;bc1qmmnd8vws8ygpl07pr52pnsy7g8mg5fqwt84maz;216496;3;216496;0
8678;3GxiGpuneoHGXQ4fHfC6tNsLuxqsAFSzAo;761746;39;17128111;16366365
8679;32tGFMDM2iE2ESXnmqZWKVSqwMpAJRxJ2Z;78421;1;78421;0
8680;361AwTUWHMfio1AdBXzk2qUkn7wpVbMGEN;707508;189;24460027;23752519
8681;3FFhEPZZC4BHdELyxF8HstAD24Emv61YRr;299671;3;299671;0
8682;3DZ16xUmpWTwqCxtaMGHriC3Pp6UDKJhW9;1157743;88;3630943;2473200
8683;1CyNXi3KMMv3gip474TCsFFToGopezg4Lw;465610;161;56604899;56139289
8684;bc1qw69s6yr525nwzujlm2ct7j2yhsnlw7ztl0v6d3;634889;18;2814925;2180036
8685;1ENMEpCuuSayd79tBQNnKXoa8CSbnL7SJz;11105345;110;11105345;0
8686;3FBkHeBYTLU4kegbKtJD3gDmaHHsbWaWFh;1545154;39;2904418;1359264
8687;bc1payapeg8v39aw8sny7ys00tk5c4hf7lnt7zvrd6x22qar5e09ae6q50h4nr;91712;11;517363;425651
8688;3FT9n4rnGrceWHHptZyHadWng4teQfvQyH;312144;2;312144;0
8689;bc1pc08a0syc074kw5hwfypzgtltntd8cujx6myx68xamhuu9243pz4q069kse;2000000;1;2000000;0
8690;bc1qafcnevnagjyf3kl5da8g0vk0regjugkxv858zd;30057;1;30057;0
8691;bc1qy4zqg2vlf2el0gf8654062ll3ux4fuhurw8gty;14343250;1578;592675539;578332289
8692;bc1qtnr42fvp4sw533z7qcfjjgp9ecv5y2284a6lxd;104784;1;104784;0
8693;bc1q0enh6eyyjlzqh0c2t3m6mamzmuwtzw04vzcjyn;0;2;179687182;179687182
8694;bc1qjr242hcxnss4jygjlkmlqt7d3aytaj58we6rcm;6534590;3693;55031347;48496757
8695;1FsFwsAu2wbAkeUJPAa1hNjRR9XCuvsqLK;5668;261;89310070;89304402
8696;bc1qca59z2f2u4fnkkajqddakvs5see29ay9ywyqgx;81936;1;81936;0
8697;1EnRzJF7xs9CrHqEY1pCFk5XxBmrVhfKsB;353531;197;32408282;32054751
8698;bc1qxsv0rkyqrpelvgkvtv768v4ckwc0zegn5d9azx;178219;10;409470;231251
8699;bc1qz07s25hkxflj3r7qx64c46tlmm2c58l8yk8r46;1454225;3258;2096790264;2095336039
8700;1CBJFSC3ParhojVWBTFeExyB7ZvwNY8PXM;142899;109;21322427;21179528
8701;bc1qz2whwxyyqcx6shhdzh30w54npkkyhy9z4kj8m7;601009;10;601009;0
8702;bc1q84mqd80lzrdzgs22t0c59mh55m0yghs2zc9acd6ye0u9zd3e5vhsw26pch;26001;1;26001;0
8703;bc1phk7edlvpv4g58eakrf5vkt9hjwzzqrueh8n2qu6txhfkfx2nld4qs762d3;150830;268;180662;29832
8704;bc1qakdv4kjvuqmytdtcd5tmjlyzwq23wlun9xwkqz;0;2;476645213;476645213
8705;bc1q6vsxqf0eezkvaeqhyqu0zzexryzc9ehcqleqw5;104588;23;1138947;1034359
8706;bc1pwg253xzer3j5cekvgvdyjw8gn058gmn4uwmzh2xk6ryej2a33ekqjas798;706612;4;1898024;1191412
8707;32tEs4tndXukJWK4W45dF9N8AwGph4oZoQ;8103778;3;21465858;13362080
8708;bc1qp4vzml3ews298x9j7kqqyefe5r0xlhvv36p9qc;75211;4;129601;54390
8709;bc1q93qq0a7uldp90lu3x6hrg99fv0jkh8reqcnnew;199032;2;199032;0
8710;32ZqwyC8tyB3i3x72iHnosqFmRvu8P1S5T;3547926;3;42962708;39414782
8711;17zW4P2QkErwrW5jq3tagdfhxyvmqz5wCn;137918;1200;611748133;611610215
8712;1jvpwFa99pAKCULLPknKCxhgy8xY48pgb;233804;4;389728;155924
8713;bc1qj5vv7rdkdmthtmmvtadftxxv8nafpjl50y5ht2;92619;39;92619;0
8714;36LfyC1t3urZfnDFezqjiqh51R9dGr2FPM;46990;1;46990;0
8715;bc1qpn9g376p5d7cuxyra0fp79a7e4q7sly83a6msj;66695;1;66695;0
8716;bc1qs36hrskvs8jt06qh5xjuvtzayujem9z2zxaagm;1397107;6;2846277;1449170
8717;bc1qfgxf9vst6l3dcqmgq46lv0xuzhnds6u46g2xhw;13284;1;13284;0
8718;bc1qs8ku98ha2uwx0gzwfuagnvukt5gnz3nn05mk93;66635;1;66635;0
8719;bc1q7yecru05t8z0w2l2gdpz8smhv8nd62rd6acm5g;31560;1;31560;0
8720;bc1q5u0xpksssk7hqtnxm03ff3smchvxfl0dy345sv;235085;1;235085;0
8721;bc1q6yurmrkpf8tukf5we8teq3dnr7evfny0sqgfqv;81938;1;81938;0
8722;bc1qm87488aqyxvyrwep3hvmlkl5nz3lwhlngxvnpn;6028078;1;6028078;0
8723;bc1q5jdvq99zk573hwuarzntcqs7ytrc4s4sj8k2ml;501953;145;9937609;9435656
8724;13e8bP8mtoBYqDavP1wmLDy2nGCNgBeQKr;8139030;28;10815549;2676519
8725;362Et835o886XEoLDrJKUcC4PWJ4VdbUsC;342142;10;830849;488707
8726;bc1qy320gndk69smu46lppnettqlgw9y235aukunsp;983894;139;59129942;58146048
8727;bc1qqkpf8ty24kedse44qs6rge73mve5c6ezu7tjr6;15689;1;15689;0
8728;bc1qxvhjj32rx2cx77zp8s55wunu3fgzyxj7psk2pt;988334;31;5889056;4900722
8729;14PVbQYvaSvVzQ5JaWKwaxDfWkmnMZUeSw;54825;1;54825;0
8730;bc1qcj5hm24k09jlhdkk0ggrz7d79u6jxpntvk70s5;36137;1;36137;0
8731;3KohDAEeWQGGxB5YQhyz9hvaf5hfhRg9QF;33277;1;33277;0
8732;3HopoYgVuE4Xfvpfidav4egR37Cx2mEz6h;470870;2;970870;500000
8733;3B1ehAJYStpDrbPctJSGQZUyiDfgZf7kFg;133224;1;133224;0
8734;bc1pew9mspw54633kwjwrfmfrmp6m95h4syz6c4sqcap2meljwptyefquk5rdy;174954;6;456304;281350
8735;bc1qyhtay0rapjatts6msrvxcgfq2z96xs373gwwhl;349503;60;4472721;4123218
8736;bc1pglhwsv4dezwzq7qwjfwdm4l9zsmf2scquwv86lpju7dcjj3y0x2st9lyv8;3373321;152;42478009;39104688
8737;bc1qtfnw756xt9n7cx56t2fj6rljxk5yz2mcszvp0p;12662;1;12662;0
8738;bc1qkq4nqptew4lperhlawhas7syhuekzjqkwxvddp;0;2;479846360;479846360
8739;3HncWPkSi1i2U1jZnXoeKbhtfE9PDJMJ98;5529825;55;44165363;38635538
8740;bc1qsqxc2hhluttld5x8k8jz49k8pksxwc297zxfepd5dj6393mzlfjsl033sj;10000000;1;10000000;0
8741;bc1qhsl07g5ydckppqfncfvnknjzxv3g4jr2h5yldx3wnhkrnu4c0egs82hjql;104956;1;104956;0
8742;3JLDM1xAbxooPHQBQXV5FXDysCVDPwgMwy;488512688;545;647136148;158623460
8743;3LTvQmyo2X2uFx9VmJcFWRwCw2b6GrBo4T;30071;1;30071;0
8744;bc1qx0g90scpmrjhq5gnmj4v0lca5we5rd3yrmvh5m;98694;1;98694;0
8745;14u1dcPmd5DsA4tVpy4ivoBGSiTJXvnTGf;4161685;7;5552807;1391122
8746;bc1p9npryz7pz3zclp3p0pwveq9v2nq2c6x2nnk4fnj4w5dcmh8eeu3qn2rprq;546;1;546;0
8747;bc1pes7vklfg46chptmq3ad3vqtuhckgrnsqejnul53g7k296teda4uszprecf;1313486;7;4466984;3153498
8748;3GnDhdoApLaAyxyiLKX3g82SdckLFAEDbM;191817;159;7047605;6855788
8749;38YtffzmGb1UjvczHgLTDdZPSCw69NJfVa;61820527;21;148682896;86862369
8750;bc1qw2rw3qe7qx8dg78ul8gxjc84f3uj5h07me0d75;28482;1;28482;0
8751;bc1qppc8yqvcswzheq8ez3g8ejra5ul4sdqx0fx7ze;142940;1;142940;0
8752;bc1qn0h6xe42mla90qwghvp9v9h7x43vz4uvssgs9v;78418;1;78418;0
8753;3Q9tLsWWgSupogWHRRvzHaxuvqSbxQzxGL;2295986;108;161065839;158769853
8754;31wauKum9gUuM13PkRp9kKoigLZe6oMMd1;3088480;60;20556798;17468318
8755;bc1qgguguw3pxjc4ja4a7eeku8y2970ma2aqh3x54s;559813;74;11246680;10686867
8756;bc1pymr2nrtmpz2lkatyw5za75ulx3vpdnayugaxjx2nuz20ef7gfznssyje72;16572088;409;16572088;0
8757;bc1qql7yt0gjk933m8f9dzp57e42flsvk3jacsw4az;34637;1;34637;0
8758;bc1prr249zy7dwfa9sxv0zh9gp5m9dlq3d6ndpja9l30cqf250j3gftqeqzn8g;1135607;54;18516002;17380395
8759;bc1q4p7zh90crg3kaygskkkya7zyshlxrlamqrg50d;186629;17;9689401;9502772
8760;bc1qd2qsu93yka4uthqn7pqh4kqsyjvvhll9eh7uwr;43915;1;43915;0
8761;bc1q4ajjmmcrc3wzy706cz2nayfzuudu6aymxc83d5;181561;7;453001;271440
8762;bc1qtl66qp97m8843kk3gagm0pdz78g8gv2l2fk78w;1097976;1;1097976;0
8763;1MzT11nhVfGrAZW6ushA9ur8y6gyavyTM2;71064;1;71064;0
8764;bc1qysy7sc293e8qxgdwvhpc3cg8lsjyjymcv99fss;5072290;75;24972104;19899814
8765;bc1qmf70gtvc5dp3q2fh5erz5uuw9nly2rsk0yr6sn;822356;307;645164443;644342087
8766;361dCRw6pxsL41Hpqw4RAjAT2xBULyySRD;610726;55;6625175;6014449
8767;bc1qu97ldnzna7takzydk2w9gesfnga4avf96anysu;66652;1;66652;0
8768;18Lv1hv7pmeeu3JahdAKnMzufayvVnpZHz;530797;20;3665483;3134686
8769;bc1pp8mzvecd57cy2qd3au5wnwq5t59v7xndd2vzwzds6rxzy7t6k07q6c39j4;1381764;141;568088437;566706673
8770;3MbnCFMtuhLVaC45129NdRc5PhXtWRnfbR;565525;1181;315931690;315366165
8771;36uA5NRiAHyGVF6dT39yY2KgcTNwZJ1U6J;37662389;3334;427420767;389758378
8772;bc1q5me7mf6jwezkw7ljf85kygjkxg90wkqp00q53r;1200;29;32400;31200
8773;39AyWHbLD6YHJT88tM1ZDJ1AwBLD5DT2d6;1949502;731;75141879;73192377
8774;bc1qv4h3ewutqu508nnd3mk73tt0hfu5u2x4wpx4l2;473876;18;2586066;2112190
8775;bc1qgz24fen3yg3gshwcafvkqljwmaykmzlyhgsvyd;1610765;39;62496916;60886151
8776;bc1pjqdfj3czkpt2rnpgh25mdzl7gwcsd28v0fujw8pctxggjx75htpsmcj5zg;304035;6;1819787;1515752
8777;3HTbLwC6555LVcq5pXiA5SyXhzctQ3erZa;847417;35;25471481;24624064
8778;bc1pahc8flh7p44ct9lc6wfn088rxtte7yjvc5u5ymasxhh6gdtfhvuqa2l90g;0;2;22000;22000
8779;bc1q88zefagclfavkj05jm8uq0ng86puz0t6cp84d8;741031;1;741031;0
8780;bc1qjmjmqcwjh8az52ml9vwq3u9tku6vy8zdfarrs9;145449;31;145449;0
8781;bc1qvwk7km0r08ka9242wtqud33528f69q8l54awm8;178722;1;178722;0
8782;bc1qa3ykqplxmc0yuan9n0qesu9vwjmsekk3pm4mj2;78420;1;78420;0
8783;bc1qffkzyy7y0v8h3wrmy3njndpq2pffn5n5rv8pv8;184356;40;184356;0
8784;bc1qrc2c2qxne7egsshv0ax6wut085ruwe2pfp9pzcgknjcvcpt6smrs64tdus;67353;1;67353;0
8785;bc1q9k9puase3gwn8hqa3v0v2zqsavhrkg7ayzvk45;1908891;1;1908891;0
8786;3NwqA1qyspdrVYNKk41dNC5P6JNaUn2kYm;1219103;48;30049753;28830650
8787;bc1pyt8vzw0tcxmvsx94sh82es8jmyy2exx95mx940wuq7tth4dew8vs9vpcl4;14185463;2;14185463;0
8788;3GC2abehaqvYPmtTshc3BgNMoAa9j7Y2RZ;37457269;1284;1649046684;1611589415
8789;33YeaUkFCZGGj6L95oipEpT3h7fkjAjXAZ;1710332;136;79115406;77405074
8790;3PWaVo45HgQb2yz3g6PvN2ewxHF6JAzo5k;411749;1;411749;0
8791;bc1qvzcems9ygkj0jey70hl3wnvjfkwf8gktcq5kmh;61182;1;61182;0
8792;bc1p5mrunnuyv2dv2sudxfr62akc5ehe64nsfcces27w9kpjlwry96usy56w3k;450450;330;54187852;53737402
8793;bc1p2v3ljhp8kqlf5kqpmx95jn6kwelltdxqg76r7pd9wlksslfsj9jskm36ze;2000000;1;2000000;0
8794;3MVGNWPFa2Q2rshSgQpwythbtW3iub1jH4;973644;2;973644;0
8795;bc1qvgfgy6wn74vmxlq2vh6shx4saxxn2x3a43dews;512628;1;512628;0
8796;1A1zP1eP5QGefi2DMPTfTL5SLmv7DivfNa;9975752803;11565;9975752803;0
8797;bc1qmqqa90ppmq99fyqy7g08zj69wsyyt3afy7csuc;14098;1;14098;0
8798;bc1qm3ddm88962r6l6pxqgdlt5fn853tr6n6dv0hp6;0;2;478975309;478975309
8799;3KN1GRC48n6UikjAfea6vGs41kt3dCyWdR;13977202;207;205609238;191632036
8800;bc1q93jcusty263yg5wyyay7mr4ggw58c0668t3jue;7842;1;7842;0
8801;bc1qs7fg55k4ahyvelhywwetlc9k24rsj0hchhv65s;65374;2;65374;0
8802;bc1qtchyaarxnlpz492yjx2zxasqvyxd637qm57f4l76fphlnjwvtkdqhlv7j7;51426;1;51426;0
8803;bc1qwps0c8tqnrr5em9squl8m4hw7pceaaunms9w3v;391598;1;391598;0
8804;3CjeEKRRNFgjjATvNisBbesWRpJvpBGcxH;1696675;15;1696675;0
8805;bc1pkkfg5wyj464wx3cngmscfj5t5yej98ecj8zwgra9sasn5g795k6qgetq9q;8511;2;8511;0
8806;bc1pz939ycf3a0nkd6f93djzza2afh6c9w3272faq30f2we36j26u79qywknhm;143133;15;862799;719666
8807;bc1ppasplgm2jypfwc7d7ra2m9gk5c0r0l5ncw62stw40kay5gcgt5yq85hkyh;775008;2;1575008;800000
8808;bc1qcdjk44z52874ng9gs37ycklehfcm4g46ls9aqn;28533;1;28533;0
8809;bc1qjvlvuf77uk978uw86c0hmg7su6h0c2m6tac78f;158997;1;158997;0
8810;bc1qutx5rsd3umpqv6k9ed9sg4zntkp6xghsja0ffz;1312449;41;8712441;7399992
8811;3EjLtxLJvWzvv6XSRoSS2reBtCbYeGwLaN;78367;1;78367;0
8812;bc1qdd84jtqr3dryy2dqglpywewujlnz7dme92d5ry;605568;334;105101637;104496069
8813;bc1pquz62anahzfwnqf9wagynvdp8hv7ehy2agxlgy72h0hxs058zqfqk8ksyq;25219745;105698;328933123;303713378
8814;bc1qqqqqqqqqqqq64cq85kckemktpzdzqfye4c299c;5200;47;108335433;108330233
8815;16rc3AEG4kmMiM3iBZAJ2XmhhWVeV9asiJ;1339048;6;1339048;0
8816;3P4WqXDbSLRhzo2H6MT6YFbvBKBDPLbVtQ;16620050622;955158;50005161661;33385111039
8817;1JyHsPsbe8N6ntUcVXv1GgM8SD1ad8wVNA;0;86;30458338;30458338
8818;bc1q43g56kcpz5cvur9z6aj58mlnvyht06k3zn9awa;130669;2;130669;0
8819;bc1qdr6tjs4sjm9ahplcpjh7gqqun9ls0sc7xpxzww;628529;112;11818205;11189676
8820;39p71wLXPzzm1FEtDqATwXme2FFN3Zi2zg;1921537;160;6541929;4620392
8821;34pDKWwxZEfeHqw9WjMJmcsEnvAGxJ1gZk;313034;1;313034;0
8822;bc1qtwyfyymgt43ys4pahqj5k3xprdehs7slewt5cjz08psl306wrcns5n657a;3132154;1;3132154;0
8823;17PFeQW2xocwf3iiXpM6KtwQ1Tk2RN991o;10330948;30;15782321;5451373
8824;bc1qy9nw3p7lrth4wsa4f2s3mya53nc6ch7dlk3v24;40649;1;40649;0
8825;bc1qgl26gazu6nkld74hc9qfuy9tclcy63nhx0yqrv;66639;1;66639;0
8826;3KG6vYfY4yXwXyD6zLcZsRsbXVmqAAotG2;13056652;122;21807244;8750592
8827;bc1qy5pr05ca6fltqnvv3kahyzy5mtge8g7gnlutp4;66611;1;66611;0
8828;1BKVCMrpxuLqq8mbqFBX9S5587ujWHJjxr;79294;7;527388;448094
8829;bc1q2mwuh8sgpqlaxkwvv6a88dcyamkwt7vdg3cjx4;428600;1;428600;0
8830;bc1qpz40jkd9kjglrc9ngdjz3vcc7tulknhzpc00gc;506171;1;506171;0
8831;bc1qnjgrf8jy32ulclctf9vlxnnj6wv50g7xtr43dl;2285954;203;88391208;86105254
8832;bc1q5jal37smck5d5553svpa8l6mxej36q8mnj0kcp;218246;22;918237;699991
8833;1CQjMpsp2tE28HLDPgKJKMy9XKNp1HDP98;8086801;62;9530994;1444193
8834;bc1qm58urtrut4948jzwc7grsrj50prrhm9jhymqvs;19363;1;19363;0
8835;3Ac71sf1TVa2hvbcrLqvLunD5cXYEXQX7P;84483;7;340748;256265
8836;bc1qrt93kf5rj9lfcv0766k2da0r4negk66hxjld9u88ej0zkw3tzagq0afyz8;1624722;1;1624722;0
8837;bc1q5845lr7u47m5qxw6mx3ye6quvuter2lnezt039;20879;1;20879;0
8838;3JxWBp88DEGosbPQv5RD4JMWgAfYjefUgN;331936;23;624340;292404
8839;32Z6L6NWEbJ7khzrVdTYm9Tf54yTTAk4fu;66579;1;66579;0
8840;bc1qfgcpjqgj55gdnvyvvgqng5lc3e08awmqkv8h7e;74292;1;74292;0
8841;1PLFksTrQGMX7573p26ewxJNXXJ2oKZD5a;36294;1;36294;0
8842;bc1qr8sx757lwwyvcs2jethj0r9hzvxln36j09szas;49891;1;49891;0
8843;bc1qdc6t9gfzqy8cntkjck2zk0nfql0v492v2vcsh2;142716;1;142716;0
8844;1AG6xvhNFTosfwzQW11aTdq4Cee6AjqT2X;907350;3;1044115;136765
8845;bc1qwy3r9zusg8nwl6argnsumvw55zr3x9gvvqnned;1055975;3;2496916;1440941
8846;bc1qdggmxq8ajjwwarrqhnmfvqrgdv3jy47jaykzud;31334;1;31334;0
8847;bc1qzsqthr4vfxw5nyrw0prk8ygsqvc3lng9a6w9lx;37696;2;37696;0
8848;1BMbMeuWYwKd8Y8mrj1vwLn8te6fRs1Fst;75825;1;75825;0
8849;36aEHsVGfPUysfH36Dcqbngai3yfXjjdmM;62647;1;62647;0
8850;3Qq3CpAUjBpYtg5GKCB3R3WuC8V3sMtzF7;78233;1;78233;0
8851;39gouK54uCxM55e85dbicnpQYZ1dwV68zA;2725437;284;22875304;20149867
8852;bc1qh8z94uux8gqn2crfkjkrerl32lu8jgrhpysfqy;279199;11;874943;595744
8853;37MsSEwfgXsEdDREeYquxMRH9zRv7EBXih;1937816;64;26842586;24904770
8854;185pG7EyDcR9rSgGxg3daJGpDjoHUWPapj;327616;1;327616;0
8855;1GpYbGARBSmAAsKKT8vt3em4vZ656JCpUJ;420765;6;420765;0
8856;15Tv9BNk8vX9Db3WSRktr4z7J3axfkjLUW;1811014;4;1811014;0
8857;1FEmoy99cFuK76Qe4n2dmtG1rFu9QLuEpA;5780196;17;5780196;0
8858;bc1q78hwd6pm0zqd3njvfqpwkw8ztsh37lm3eavlpp;392094;63;4618438;4226344
8859;bc1qmavd63zxxjv3gzxr0hzu0qcmvurcr47nkxl98flw0w392wv30css00wz6v;106578;1;106578;0
8860;bc1qrhg3pvpc3nu60x9l4y2rzc47ang4v7lhyaga4v;551171;31;4343015;3791844
8861;3KT15nW99kxc5jh1dZfpwwiAwT2jRatmk6;800000;1;800000;0
8862;1D9tZbXadJGYmFv6XaUnDfpj2ek4pt8sMF;1716187;27;1716187;0
8863;3Jj5aaNAFEA3tQcw7irY34AWjJRbrSDWWW;2320732;363;85534413;83213681
8864;bc1qj9et9fnzu3u0p96030wz7zzw7rn2hzgnztyye7;227397;1;227397;0
8865;34Uf6D5f7pTsCSNNKmmRmLNgTJB7Vueq3z;16768;1;16768;0
8866;3Mjo84d4PukAYh3sfzD5rCNFgDB5FzZPeA;981212;31;2578382;1597170
8867;bc1q6q99h9nddq6kulxcq540qjw423uj3yjr0f97wk;31345;1;31345;0
8868;bc1q9xa0mxf8mngarg7jfqn93re62pep95kuz49zja;28543;1;28543;0
8869;bc1q6zgar5ea5gudz9m0s2zpexq8a23cqwq2z97w85;104651;71;4411922;4307271
8870;bc1qq5j7q0qxmfdy75hgx0jyyckw5y60cmch887kcp;166014;1;166014;0
8871;bc1qxkh8ug6yhdsgcxjv76a2wam6mhxhvpnzz06urw;295700;1;295700;0
8872;bc1q498jxmqdqhe4h2yjj8futw86n4pvhn2gsqp7hh;59053;1;59053;0
8873;15VGa2c8JcaxRvJv25rMPE9wT6oDv7veVg;473246;15;1959584;1486338
8874;bc1q3qsedjufr569zjwl0tkf7jx37pluzkhg34aa70;208276;1;208276;0
8875;3KaxwAu29cs6CW4sLM1RuKLkBSNFPbXro8;1197992;54;22757348;21559356
8876;bc1qklwztvwxjtrfdq9hslfghyx8n90kxcay074wkp;195950;1;195950;0
8877;3NnmZWdvgEet5niL2C4Lwr1wSb2mSDudVD;5558106;132;43995682;38437576
8878;bc1qdzcawh64n54nvppqf265znxp2gxfpx8t3cm5yj;36046;1;36046;0
8879;3CTLBZRXrN2H3iuEZU3f8viiEUS77i8CwH;66636;1;66636;0
8880;bc1quz492e5c6n939ml8z9cp2cxw03rgepmt9awc57;0;103;49741192;49741192
8881;34pxBT5as6DYYbj58HicPzeFq8C9Th8azW;36036;1;36036;0
8882;bc1q9jgly82lrc9c58w5dfudk572cnl8v0ef66uc79;2000000;1;2000000;0
8883;151y5WLEAXTd1mgxHKKRkWhxRTGvpEXxir;156690;741;369571195;369414505
8884;34GbQu9iCQk1By2hUEaMgdAfSp9MBcmX6m;36082;1;36082;0
8885;1L9rv3zm6nunpfJyqF4spSAZJAoCGWxJz8;54837;221;29017148;28962311
8886;bc1q563vuv3c6qae86p3fxmfmuercqjya5qndxm6sl;391244;1;391244;0
8887;bc1q6tt7w8yz6xkm8x6cl8uhz7yspv9dvkta0780mw;3055507;5;7438548;4383041
8888;13KnnukNJven8bKyZvwLYeqnogKahmYE1L;2610268;44;2610268;0
8889;34AKHcAtX3F9n8rNtV9RR4LVG3kEYW7DZ2;4004602;30;38392534;34387932
8890;bc1ql94d8qsffmkqxc28mvpn8p5ldy79r0x7avmtuz;3107328;1;3107328;0
8891;bc1qyzns2ezms2uwg47f8kcwf7gdmfrh7a7eq42clk;39209;1;39209;0
8892;16EB68pN4tyBVbm3GUgraUjornkdNZfVC8;2335464;173;55413796;53078332
8893;bc1qhmehx8fx2kuf7v40np5qfk7wh9ex50ywpfm427;0;120;86031261;86031261
8894;bc1qtyy452d65tqafdvxg2m8lgeaprjkfxwvehqumy;227013;1;227013;0
8895;37CsdqBdziLRkvi96xxVwsRxYZLS8Cofb4;3707512;165;12502438;8794926
8896;bc1q08d7q6f2hg3923cz6umc6evlfuwgcvvze29ahw;479095;8;479095;0
8897;bc1qjzu9c75ctfe7lkelw9nzkrsrzluw7l8edqne28;167573;2;167573;0
8898;3Jbji57rPTDz8ycForaHPfsgzcYDDLuksP;66531;17;567313;500782
8899;3AK5fqyT9zqWQtd1D6A8cch2zc74ngnrod;17875288;112;38752541;20877253
8900;1GHzmRTsS3NmuJC8dq3DrmsbLiGvV5rqZS;2844925;19;3858621;1013696
8901;bc1q752yvq4he0dyhjpc32dkt9htkq0q3cgflu7twt;136443;10;369258;232815
8902;15Ra1PfUuztZNuBxGpFdRs1bUWqyX92ZvF;18797124;114;31592404;12795280
8903;bc1qrf6lw4pay85kk5qfjpnsrff8yyy660m2xhxnqt;181565;1;181565;0
8904;15QwZi49f7BHc7wDYSutxg2Fr7DUCgcHSj;173678;1;173678;0
8905;38AgSgxZFB6r4aeZ7mZNnfbd3CLYg8mtNb;70439;1;70439;0
8906;bc1qlc08etzwkkfh7sq2pk3zfl2ly5nl0llpgsmf9j;104832;1;104832;0
8907;3K5fBfZS6dnDx56w5gcpQqMmQQtmCZ1ELv;92274;5;194735;102461
8908;bc1qeldxvympn00x6azzmmj7ucxz4tnycfuemvez5s;59051;1;59051;0
8909;345Pvr627mc76ou4QbToaohvh9iykhn2ne;28493;1;28493;0
8910;1QEkRCEukW7fujjJ9Yq4EosS9oAzCSD6v9;1018623;55;6895597;5876974
8911;bc1quejxk6ujdx7llgxe3l5xdwg3fssj82nddcp2k5;313905;1;313905;0
8912;1Az98W7ySDToX7TjKZfuNuvYUKXajyFWgv;507660;68;58606707;58099047
8913;bc1qx3mwzxrhfc74w4ff0xx7j0929p2j50svr5jqg3;234667;1;234667;0
8914;15rDNfZXnUvoA5bztS4rYi9KQYLQnRXDTf;435016;92;20715582;20280566
8915;1GdTb7c7iajSDsAfw1W7sn9tc4ATe3Jpcq;27262928;139;57633417;30370489
8916;1M5P61Z2dHSqnjbEoNouVafnP8Mn6FVvZC;58994;43;4055683;3996689
8917;bc1qdrc2dm0uwym0x87hgnnxn07vkd0sjqql5umkxx;32327;1;32327;0
8918;bc1qjtgheyljaehk4zxp7es5uthpcr2qzttrm7axre;104764;1;104764;0
8919;bc1qn6afp6uykumhw3ew68rc45gl3u64lpp0jga879;3020468;67;23014957;19994489
8920;1MXu6AaTUKxXXGK9BnA2ZYKfcFcegceh2h;16788766;85;16788766;0
8921;bc1qlnnevl76ncx4vl43ngnc8d5h7ms96zjetty3ef;33213985;2016;366024445;332810460
8922;36uQrbzVADXHQzxnAV4AVyY5Zx3EUfhBRc;422047;2;422047;0
8923;bc1q2z9jz2p8can89sm0hd6q676taak7kgayfl5vmq;515869;1;515869;0
8924;bc1q5n2ec9h6xm55jt2d8fxw4ka6tlkefgdn66advm;37638;1;37638;0
8925;bc1qwkvc6fp7t52rshz9jugg8jkrpnnchhnw6mj6d0;224649;7694;8303900439;8303675790
8926;1Ptd52goQ1PtEzn29m7R4cx4c52MkyrMoo;9312381663;52995;21140892808;11828511145
8927;bc1qr4p3s6c5ny2ld9249ychcxkr3psgj65j3ej239;295524;1;295524;0
8928;13qFCKaUkb6Ww2v6WHrv8pXJocKVtMANUt;610448;1158;391557055;390946607
8929;3KfeXTukQUt5Bg1kqodsRqrz3jKkX4D3oE;2164939;5;2537386;372447
8930;bc1q7zncpqmnuaalhux9g86kqur84p54lzczjl7d53;373125;1;373125;0
8931;348AqP9CuVmbSm7MhAuXiLpcU8egSMQ6fS;2255421;174;29359366;27103945
8932;bc1qvjsrxkxhyzkk52guprrqfaphusa8dgxgvlts66;36108;1;36108;0
8933;bc1qfuvn9qya4y82qdkhwd7ef9vqjf40skn4ygheer;25491;646;85492847;85467356
8934;bc1q9lrhlrxzm0dj5vf500jqkzugukjct9vurclhgz;4461679;473;139555697;135094018
8935;1Aks4cYcKkUoYY2VSazLBovZMx6GqxS2bx;6653660;12275;3486707430;3480053770
8936;bc1q8s3j4wmur3je6jnrlnlfu87w56smnglv6cw0wh;11730;1;11730;0
8937;1FrjuGi5tKFb2k8DrUypEcgVh5srEu9w9H;17185;62;964450;947265
8938;bc1qnhtg7k492xz2ss6hzmrmutkweurln6syeftm08;81820;1;81820;0
8939;bc1q09fa96mgyahxvpstc0v9v6d7sttqvv84cw2aly;46870;1;46870;0
8940;bc1q9mxpf6r0nuq98kgul7jmcu7tlfvrkdujvvqr95;142489;1;142489;0
8941;bc1qytsz6q8vjqz7feruyu02faae9t2prr6mvygtfv;184862;1;184862;0
8942;bc1qgcguczqd4nqsjmykxdteegc2e267yq5k8hagrg;1308898;51;4822869;3513971
8943;3MUmT9rknSiMywE22tffSsSRh8m8qLcwMp;900277;160;5791388;4891111
8944;37LAywSZUV38NqkGn1yrW1RzPyBvdayeSf;112699;1;112699;0
8945;bc1qvmnsh53dv7993ff6skcs6vtn4e7l93n6uj2tw8;824026;4;1063255;239229
8946;bc1qgnry7cl5unk74fx9h8qn98mkk2mn32lsylz4m0;431428;50;1984065;1552637
8947;bc1q5qwg5jllnuvgl359mgpj5j44h6lh7cjg3grsj2;11430319;517;808549776;797119457
8948;bc1qyz4tpsf5tjd6pa2xh0tdtcztnzd55p70xvk3gf;142838;1;142838;0
8949;1KegkezWWwpXr1sabQSDSxyfhJQSAVhWN6;5379296;68;5379296;0
8950;bc1qc8e93m3lenrwgzz23xp9sgml8tdw8dntk0lqwp;65157;1;65157;0
8951;bc1qvqgftuuqqhwg40zx9aajuatf4cnpvgz2rr2803;242414;15;1331423;1089009
8952;1G85s1scvyeBK7K4qWeqUBC6LaS194U4Hp;1074461;23;2199980;1125519
8953;bc1qv6vn3kf875v8qctla2vdx20fjv8rw0vpps8j5x;46962;84;3818371;3771409
8954;bc1qgvt5p79ejps5jct76xh2fn0v9wxr6ha2devndd;181564;1;181564;0
8955;321Cscmtf3EAugjUvZJh81qACr5Rd6DsK1;603052;1;603052;0
8956;1NAV8HxrmhAMxGzhxupJV2QTa6SrQ9c3u3;0;4;3143314;3143314
8957;bc1qjpll2e36fnvv0k54u8eqva5lwff03m4uzqtkwm;214836;1;214836;0
8958;bc1qppc3r2xxwgl5az84plwj3m8alxpwl00jzs3d78;296213;1;296213;0
8959;bc1qeuy9mzs7jq348hc2h9suyt8vhqwjp0g39jr34q;0;2;402755;402755
8960;bc1qw8hd69za8ah0znuda8ulkyrl2st6u9urpkndfv;150318;1;150318;0
8961;3Mcygr6T1wjycG53r2qZJ8WngVF2qvJso4;0;2;1499741;1499741
8962;bc1qhjfd3e7vgnn5fjnqdcwvugskr7u7mwundzg208;45186;1;45186;0
8963;14NcU2CnvaXBD5LazjRWotoXz8xE5jhL9j;218625;12;1313474;1094849
8964;3JLDM1xAbxooPHQBQXV5FXDysCVDPwgMwy;488512688;545;647136148;158623460
8965;bc1q23rervfjqy5h4mhknux8jf8lxdp3qcq0jjjfnw;756973;1;756973;0
8966;bc1q75pa7pf6da8d7ztceusxzy5mvprj9g6pzpx8fm;81931;1;81931;0
8967;bc1qtwrhl88u3dw4a6a36hvkwjjn06rce59l5lgxpl;1519479;1;1519479;0
8968;bc1q6t22mrjsr9z3f3da8k5yff3x8hdfx56y07ty3x;261794;9;536082;274288
8969;16fNvyepMv94t4wMYQUvZPJMk8drmmvKgs;30913456;222;37068162;6154706
8970;1BS1QGxEMJUo56YoJMy3EZUXuvSfuUjVQN;17223663;84;19547779;2324116
8971;bc1qnfjxzyukzcmkz5vhc3ahzc42f64v2tczaxp3ve;142935;9;1721047;1578112
8972;bc1q4f00tyh5a9gw694a7r2cac9lsz8c4gfq8uju7z;142774;1;142774;0
8973;3596vQrLmrA3JdjbHeQu852ZmFwXxnKMxj;51817;1;51817;0
8974;bc1q6wltpm0sdj2mkpwz7yp8xmupuwxdakvpr3wuxf;46714;1;46714;0
8975;bc1qx7yhnlp7ken6crmgdc9ngfcc0n5zkzfa9px5e5;86012;1;86012;0
8976;bc1qjqg28735fph4t3nwrnnrfmzp4vn0gcdrf75r8v;36110;1;36110;0
8977;bc1qgw5rzsr605jawvywt8z037vh38nn7qw6ew5u5x6ryw9gkuud76tq4jqmml;74288;1;74288;0
8978;bc1qtgav343wkpwfshv3efl3tl0m69scru5wx522wp;135069;343;69845958;69710889
8979;bc1q7kxzq6trjpgt7qypgqqpjyadqhcrynx79eutzz;41523;16;293333;251810
8980;3NM7VWR8dkX516Az5KVq6QmhHvvdnPjq23;7819;1;7819;0
8981;17xufiNg7TwF4e5RdCq8Yf9Guk6P9WA7Hw;52875;1;52875;0
8982;bc1qfy4m8xhlv3ahnwyphf6dspn358wlrqe4h5qqlw;576342;7;1662939;1086597
8983;3ASuwMxGbpracom43cpuJFCiLJrQiqDyBP;1751761;19;13620138;11868377
8984;bc1q903mmv6ukqdsnxg4tdu22rg5fd2mp5q5yl9s44;77614;1;77614;0
8985;36X3Ud5rXubhymPF6pgaNcfp9EQwg99vNh;503223;13;969274;466051
8986;1PLZ8X5KkGWja27Daq5XdQ8iTAFxBifkJT;1170340;36;4543444;3373104
8987;1DfauQoaTXfhTmetscq7G9d2SUg26UEj8e;104654;1;104654;0
8988;bc1q0yww5zt44nwazc5u65wx9cdg2960g7qcz0gcv7;66591;1;66591;0
8989;bc1qvgm34c5g0fp5q9768vuta2m05fl0mhdgah803e;325884;39;16191706;15865822
8990;1Jj7potkGVDtEtGkq6aY359vtX5ZSXH1Qq;469668;1057;1154603190;1154133522
8991;bc1qcpsl9wlz9vgn9rx3cxqzrcm588pxgjy037cqje;66466;1;66466;0
8992;32rwFNrS7sLyzBBrZFEcc5sKwJyazALAfV;513083;10;848094;335011
8993;1KT46DdCKJ6QgGBy9qiodP2TYa6LkH26kK;909629;49;52386729;51477100
8994;3GgsEV9zFWHJjTovJgLkVNXHNop2VCMv76;1343445;41;5253053;3909608
8995;3PK71YShypHnStLEsncKPFVvzxbti1Lkfa;464199;5;517845;53646
8996;1HXz4xXiWUMPM8rV2wQMu8UBUb9Dwznvr4;20976;1;20976;0
8997;bc1qaspvraxf36hqqvver6ymdtdefevn80pv4dgkee;104792;1;104792;0
8998;38YSRXfCCUDfLajoUNQmRtskeY8RSBJX5X;654405;2;654405;0
8999;3B5wwdtT2HrPzqgmMhALToFn2sUJqbrzHB;62673;1;62673;0
9000;1FNdHCPE7bLWjAmterc6Y8NCZN6X8dhqa;37820304;175;40145955;2325651
9001;bc1qme6jkk4hge2pyld57tzqdrxmpzq9z4jsesepxf;36099;30;835443;799344
9002;bc1qngqmfhewqzdmmwgxggstc7ws89lmyqkvg02ccq;156640;3;299604;142964
9003;1PuX1kMHY4wJMU1fXhrYxHCbK7Zuj1gt3i;3327901;17;6260295;2932394
9004;bc1qayf9ma7deledpqxsxn6appfges32urdn5hg8vp;74287;1;74287;0
9005;bc1qc3hfvqdgysd7lp70kwte3nvdg78hnyrd6psz8c;155671;35;4262754;4107083
9006;bc1qtp9dvntumzar5dzaf7sqly2mjjhs7xkhwzqut8;606014;28;1300446;694432
9007;35zHXbwtvcPXXqyL1gKYLVWeKS1aNpimZR;16534269;6;16534269;0
9008;bc1qjkphsls4nxk7jr5pary8wz9tqc4mtqh2skgv7a;953289;37;18432721;17479432
9009;17h4Deexu2sMWb22Dx81jambMsvRAGpqDg;37815786;143;45026372;7210586
9010;1G2SVZMJHQvNUU2c8PQ8d5EAxQhQWiteaS;2753115;14;2753115;0
9011;bc1qzkgyhcryfzeurx4tu0crn5lc3axt7vnt4ux9uc;31303;1;31303;0
9012;bc1qy3d754xc32sl4kpwkwd64n2agpr0lqeeqh02ql;65088;1;65088;0
9013;3JKonEzFkbCCuhZCiSumvfD9wbbkMLr5Bv;344307;2;344307;0
9014;bc1qtceam9galu5c09fvs6zee5ed0umuadkhgx6s3e;81818;1;81818;0
9015;bc1qg6thjlvtdy9t0lk0cdvf744l95wnj4lgxkngcu;51417;1;51417;0
9016;bc1qqssns097p8em85jkv3uwm85yuynpmyjtqmcwcc;74201;1;74201;0
9017;1GZzNVTRc9oh8yyfHfaU1waNoJdqJZ36F3;30170917;125;229161362;198990445
9018;bc1qsy9mdze0d46vz08fn6nd8fpn9rwsdasg8rymfy;78629;1;78629;0
9019;34tHaXNrECprqqaV3zywQRPxapTPDeyWjN;24698790;3;24698790;0
9020;bc1q4kz3wfnyhd32rq2wwhv28afwkdnmu8fu6y98rs;65063;1;65063;0
9021;37MrnWSqdY6KmC2qWGHH6iL7KH6xPat1Qp;429683;18;19272162;18842479
9022;bc1qd7lg7cnl3n8thvp7dd9s238w5agwgmkwemu5na;230390;2;230390;0
9023;bc1q2q30draff3gz59l0kyrc400symuchuuf0448jf;373485;23;2783940;2410455
9024;bc1qkc2vd84pyhym7n3l7yglyvsv4v356kfjl6c8wz;327348;1;327348;0
9025;bc1qlu8hvnz686dak06y4s7mulrpj9n0q5jt2yuscn;5653;1;5653;0
9026;bc1qwa3sgnaz67j5kx0ljq207qqyufts23z78ewl8j;126048;1;126048;0
9027;3N4NN7H8FB9mwcAxNw3SF6RQaM1hJyHxPz;142664;78;6959623;6816959
9028;bc1qwp55sfhyya64n2exz99qctxw0jwns7d0vjjjas;81917;1;81917;0
9029;1NEEpYhy7qoqb4gU2wqwrxDLQL26pNiMTL;2280949;17;2280949;0
9030;bc1qhufd080nkvrtwmthr3s0ecrvk657t8q3jca8tv;167582;1;167582;0
9031;bc1qdcwuluhwh6v70qnampzhe7ee43vyzytvzf044r;3440168;6;3440168;0
9032;bc1qyw8h2fzd5khyp82259k6ahvgl5uazuqjp096ax;76055;7;165367;89312
9033;13MYpdGn32L3GPmaM4s5aKFeyaLtmzRR8c;20733;4720;1598236227;1598215494
9034;16Hyb9FYRPC613MaxL7zc7s9UsGT722C4A;596878;40;3324706;2727828
9035;bc1qfg7eryr8use2n6j4p6zpttxmwm5lc5rlmgaj2f;179514144;1;179514144;0
9036;1JmGZEECWDZHwe6jArWwYeGn5TXkU51g1T;5657728;29;6870275;1212547
9037;1F2dGbWH5kaZVYHtsGUJwdPQvHcTa6Hgxa;142508;1;142508;0
9038;bc1q6w7eg3jssfsdr7jf3eqdscpsqd78dqunnn6ppr;65691;1;65691;0
9039;33Qcy1ddnctdwx6HNgFX22ZBiknFgGiHT2;66686;1;66686;0
9040;18CQGKsH5wCk1ccD5WvSHBzkyqTq9Qbhgs;78195;12;758648;680453
9041;bc1qp5snp2afyfh0wvqls4gazpdrt09qmhvxj6t096y5kmskkggswrsq6wptna;89433;1;89433;0
9042;bc1q06vcumncuddhyc2zavrmvv68kzr0ayf3xeq575;93810;1;93810;0
9043;bc1qjjfx8h3lkj6xyrpslyrl2yuvw7sg78ys82ugt0;1007181;110;11776647;10769466
9044;1HfeFyNcpeoPmPNSzx83GynMBEaBDsRJxB;240653;6;3097314;2856661
9045;bc1q49mg3v38k836f3kxtgj8z24j2twattmsjp3qkj;130586;1;130586;0
9046;bc1qgrxrzfkfeamv0p5jctjrmzdf3rp24kmvxug2aq;678287;1;678287;0
9047;1DreSuP5KUDf6QFzw66jRudrE3nH8JiU3a;219650;1;219650;0
9048;bc1qcphm9fc5550mxkgyp06g4kt40csms4wmz8hvv0;125897;4;147860;21963
9049;3FLyhsShwt2diDnPCgs3d5hQsNc7KnauDU;314141;47;1530477;1216336
9050;bc1qp0za352ut3w9un78wwxu02ssy03s84dxr3uv0r;1665700;26;3249545;1583845
9051;15RVRabjzweZFHqNkmmYFiDcgY19NH3Tfp;1168808;120;45830473;44661665
9052;3PKxA5DwhX2P58Gg1XPiYV9kW9xV8Vqx84;9487822;81;61883511;52395689
9053;3QoLhHTuAgRpxH255QyYn7Ws7xxFsYehUN;2906718;174;109534767;106628049
9054;32N9gDFjDrrKPy2UFbZ5G4Sy5qVGicd7Qm;450187;15;18729267;18279080
9055;3BhLS1EW4JEjnF66DQxYaoVeYiq56RvKmr;1861679;1391;195922664;194060985
9056;1LagtorV4mY4s4cPvtxME4mamsBaTeL2VF;1478542;19;1478542;0
9057;3J9ofJbsREuJZgzgrJ1bW1whUAjdrjUb6r;38076;16;310807;272731
9058;38u48er6Nt8jCgLjRLZyJoKhd3Cou2gZZS;862279;5;862279;0
9059;1Jo7617f8PCUzYUJb7fVvTXALMRYLD6DjG;36129;8;476649;440520
9060;3BpNBJAqaK577FmZrWrQFLgPhJh4xKQa4n;54948;1;54948;0
9061;bc1q9qy5dvv4865xazcmhfjtj8n9fwttf5wffeham9;55885;1;55885;0
9062;3F7yKb1FQyYh2NKbcQDgQuujzNdZAj61Dd;1030053;9;2790552;1760499
9063;bc1q8dxzaasvqjg9qrxxr7nyf0c2j7wfnayrwhtdp8;797992;1;797992;0
9064;bc1qmj6y058p2yrygn5f57ajpu90arap8d0nvdhxx7;20073;1;20073;0
9065;bc1qj5c6nuvx4cjqnvnsy3p7qeq3dp5jm7j0jy8847;33483204;174;277868060;244384856
9066;bc1qn2umk8gqpc25j2fkpzjw8g6y96enxa4jayzxvf;36049;1;36049;0
9067;3Jhz11CNTcxocicMkaQY5rMfRi1zQDt9ay;19958145;191;494207189;474249044
9068;bc1p2p02rqgd8vp4pctrwdsmcjjq239tyqc2cu0lg0u58rxhuwwe2fqsgmn5he;42400;1;42400;0
9069;bc1pxw96mal8qhtlp5y6ltfcszr2j3sqp909xpj3l03me6fth7z6sslsj230ht;1379392;4;3013831;1634439
9070;3CnrAwD4gxZnfTbQovNBYTT387qtCA9pNq;156839;11;913380;756541
9071;bc1pafk00fc29njhkfhgatklukn4cz6wj4pt0rz862edsz9gg3547u5ql5xctp;106330;120;5977985;5871655
9072;bc1qzvcl9hyncnmactv679mj49luegq5cfhmlkmvsk;387697;1;387697;0
9073;bc1pfkttkduhkq387jscltjq7z58w2ljqh8t234pnf2hnweztmrw7y7qkgm7jx;24292;1;24292;0
9074;bc1pp8mhw4n207tuls4vpfyk8hcjk4vzys40h8rdkvewx80cx6e22wlqe58ul6;3545900;2;7145900;3600000
9075;bc1q67tssq59y2t4q9m330dpcade3u4kshccpg2erk;1681289;1;1681289;0
9076;3CncAwqzhyVVUxX8cmVMUTfbXMfAJJ4DRr;3367035;27;3367035;0
9077;bc1qjcyfghgde6yzl4e4zuf4qx702dntv0k6k7can6;78402;5;308821;230419
9078;3EzRTxJmnXnbK44EuhUEYyLq5v3drqiPFg;109735;2;259718;149983
9079;bc1p0fz5uve67pmd0cysaauhjhv49uu43pzysg0df9t3q5yegtkexuts0wwusn;10000;1;10000;0
9080;16qXkQoTnnNiMfWCK1iEd6nELHCvKmJeZL;1185910;14;1766555;580645
9081;bc1q4lmk299darwde7elrzmxny8yj679suv39sa7lz;1331234;133;24644222;23312988
9082;bc1ppxfstr0gftchw4w0p6z0e8ddshx335fpgrpvvn7gvc23x77etkwqpa9yks;699738;1;699738;0
9083;bc1pvnx3ac7skhay9m8a4g6wumj5ue8qm4m95x5qz76cxvt2y3ewe9js7q3yjj;34846;1;34846;0
9084;bc1pjfwprqgr429xy0jgzm36wuz3m3z4jy0k9rgw3yhthva70sulgccsa0rkh4;17348592;324;17348592;0
9085;3Njf3orB44sPMeGMLwqDTPXKdcEs4sCEm6;8270694;23;47504155;39233461
9086;bc1qdvcsscelzuyljdy6k4nhghq84uwszmzuqsq64e;2325632;1;2325632;0
9087;3Ckk1U4eAMLUrQ6n9SBrzYKAG1UbvrBCh5;100651769;44;575518007;474866238
9088;bc1ppnk3druv33570wnmfevu2hadw0zl5yga7jkq4w3wu0zhtced9kpq2vkrt7;726522;7;1841098;1114576
9089;bc1qw7ueqc86g3z74sufwqqv9ydlxeqqhqap2z2w9x;0;2;65336711;65336711
9090;bc1qweqrvz3mkjdr9699sze6977hrncju7lpzaj2pw;20895;1;20895;0
9091;bc1qp0p2jaqx9vtxmqxz5za6j5gt3hdzf68ttne4gr;164288;38;3179202;3014914
9092;bc1q8a3j7ch92tzuz5aqzrpv86ayn4zkr2w03yjkxj;45671081;663;404149304;358478223
9093;bc1q3t7mn8pvnsz6ux2vkepj28p5j7k56tfxj6v0pl;4129668;1;4129668;0
9094;1Pq7M1mcjygVXqLptpJz3Z1stxQrLpV7Tz;1017418;9;2589159;1571741
9095;3D3tKDuN1ASXfexkMvVXAtrnF8PRAGT42S;13283765;42;44660267;31376502
9096;36zR7o83yxz6iRr8BVTkVSS67fGy9Yhg5J;239181;25;8782248;8543067
9097;bc1pwjna8h2epv73aa4atmqfztm9mj25f957vdemprn7ezukygwcrz3sm5xk49;10626512;298;10626512;0
9098;bc1qapfu6545cd6flv3hsxhkn0pkku8ac3kf4qtp3d;280714507;25711;25511629403885;25511348689378
9099;bc1p7hxern3px48ea6cc0nyp3cz7r6uefl9tfygs8wz7darejzfqvtqq72z02s;235919;2;235919;0
9100;bc1p799ezgt9skk59srcky5xztg6dx62p4mn4l0mwdfz5n7mkrlm5fwqmyj247;24492;1;24492;0
9101;bc1qqzkrkk4msakj3jvd2gwwgvu3s8paegrs2d5pa4;158291;1;158291;0
9102;bc1p97tzhadxh5ns7k3jldk5lq7auuhlxnp90rrt84xqwcq2qyal3s7sfjy2uc;12683944;307;12683944;0
9103;bc1ppt2u809wwe2757kjukhp9jjtamx5evgv92rrypncyeuklndjsatqsgc8l2;41967740;3054;3059938491;3017970751
9104;bc1qsl7nkd69vqzjhyjps4wa2zxx2lutjcugg9qkp3;1574081;35;70304999;68730918
9105;bc1ps6kqmal64m7203v9ucxttzlxkrmun2y42knqkwad652nx2hfvt7qx4sv0v;1867400;2;3767400;1900000
9106;bc1qcnfm3pc4wynuvag4fuvywc2wspza0flgkj96gu;89252;1;89252;0
9107;bc1pl9mpp0huxezh387dwz4jn56njyg66zxe27gyls8ak2v8c5qxfrnsnmlwxc;3098381;13;12792027;9693646
9108;16m1awPiLU7EaeBHKAJem4GEhWRcue6FP3;4827542;316;82793782;77966240
9109;1Hy2LiYRB76Uuut2d9p4sCtjY97L4q8Qdh;8983980;37;8983980;0
9110;3QNaUxXzgxSxKk8haHpNzh8wCHfM5Q91VN;486200566;1638;1018509628552;1018023427986
9111;bc1pahuqlm9ahn32k0dva95y8gtznwy3nwp69a6s9yskx4s09apku6pqw2l9cu;721983;9;1990573;1268590
9112;bc1q43yysls0pfudw622u67j4hflwr58ylpfxdpzjq;88513;1;88513;0
9113;bc1qj9r0nu9v98q7xf7hx9rw9ejqv93kuv99z83hwmxf2je64kn4kgzqjs4gf5;66595;1;66595;0
9114;325egPTYV1t9rK1EGeqpsLDd1rs7saYS9u;16830925;208;1240221773;1223390848
9115;3NfWSy3WGcVFNuZAMAPFr1Cc1ZMinsmsoJ;501251;177;16275685;15774434
9116;bc1py5npeaaclyzcp70uhmthz9y26exkgrc2zjh2wqx6vxzagmyakuwswyvwru;237478;3;860709;623231
9117;39xxV4Q3PXLaSkjFkT1CPboQmkn5ayqA1y;1107145;25;10745465;9638320
9118;bc1pemgkjyamhm5ajmragxll42rqpv6ngxfmytl75kcgg06c9jp79s2sshq2lp;82922;31;3778514;3695592
9119;1BdQPLUV8AsRbZeLGSXkVGov7VrTbUoCHA;152098;2;152098;0
9120;bc1pm7pgq56qsewmjksqkzw2renwxtq0ks7ttcqgs762gu7y0msjrx3qrpdvpt;4427159;989;4427159;0
9121;bc1p77whffve5q79akr6hgqt4ffst9ekvyxczwmng0ahdzax6rejllvq5pcuyp;0;5;133764;133764
9122;bc1qvs2hts5u0mk06ayecd3m85ps5w5emuxtlxeg9x;46051077;9579;104483425;58432348
9123;3MamxY6WzrNVvPANfCAbZu8ywnF5n9kJRG;1373803;200;31980735;30606932
9124;bc1q9zlvxwr9njkh8r79nm4cm3vnt74wz0glenu7tc;12636;1;12636;0
9125;bc1qf56q2twm364tzmj66wlhny8xm09y77k5kn6npt;158454;1;158454;0
9126;17xxHdMz8ZBtGy9zRGcv6ioFqNQwn7SGit;1002435;47;71453351;70450916
9127;bc1q48kmhs4s8zyafj6stat9vxkncxwvhzd3fd3wh7;45988;1;45988;0
9128;bc1qrg4w02ynuqv4uh0y3wfe4fqqvves72vecj97jz;36634;20;3515306;3478672
9129;1Cn1bdebKQdQ3CdZpE1XyRmoYGQpVeijbf;82837;2;82837;0
9130;3BszBAcMBAHqqwsrc5UdBE2Mq21mi9hXdj;4785793;738;35583832;30798039
9131;bc1qjr242hcxnss4jygjlkmlqt7d3aytaj58we6rcm;6533210;3692;55029967;48496757
9132;bc1pjzwuhqprkhtspmd7jdgd9f3jt2mqrh6d5374ev2v9w5hxzh5hzkqgwgvgl;73398;111;246380;172982
9133;bc1pj668n0aqwg5kl75ntp7mxrudes2qfzpdj9wk8lfcpdvjrrzefkkselgm4g;188945;6;1986238;1797293
9134;bc1q59dj6a295gulwk0nly74vtw0nmdkpkm6rj86cu;748454;80;4806191;4057737
9135;32qnGHgL6zkStqAXcMCFD5ckJmLYrfSxKx;3885403;132;69194608;65309205
9136;bc1qykh5adgn502ypu4zhsl3u6ptpguglv5p0zev8u;94063;1;94063;0
9137;bc1q89m3dh36y0r5snzljeecfvlc3zal827f9qxc4a;78515;4;585679716;585601201
9138;1HmvUbcneDSzVwHD7bToavqEgaGZoWhnGU;156547;1;156547;0
9139;bc1pa6uuqm6eyyy03njgzvku6s22kpgr29k5t83gmp26pguf6y3gq5yq2596q6;942200;1;942200;0
9140;bc1pla47dnj99f7zjs30axxuqhwsekn4cktp7wlwkwqhhyertpqsqpmqpvmlrr;0;2;21000;21000
9141;1KFmHVkWqLRULqgsfGYKuWdesg3LREEuRi;108000;3;278000;170000
9142;bc1qxdp4fpgtt5ctg3c9m6z72cec6q423j4z03ner4;176714;1;176714;0
9143;bc1qa6rf3q0mwnjcqgjhutsxdnnpy8n48axjz5gjwq;57169;1;57169;0
9144;bc1pt970plvz3rnqxx9qhwm5srf2gruyhgsnps9hzx6y05nfyljl9nwq4advay;49754;1;49754;0
9145;3B6BYGtUHLXCewieqREPNta3s4gdsDshcK;10341481;3;26730054;16388573
9146;bc1qua68vj46g55hjmddkdpv42udlmxvt5ah7jk4t6;624858;1;624858;0
9147;bc1p683y2y08yylfl5gqqnr4xdj59scfqwx85y7e7htk9uu6t5p3cu4qw97ned;25324622;37;190771510;165446888
9148;35WSU7q9uRRpZ5gyZzAEekmJJYNevdqfx5;584640;42;48540542;47955902
9149;bc1pjlwwn2uzykpsefwpa0f637440wmc0q5uc7araxz3t6yqdwhttmeq4q4gzf;21055;7;471701;450646
9150;bc1p9srxdqx7u4u48ahj4s5gd3x5m932zm4fc4a4ds5ncm580nh864jqm37k26;117435384;7882;409869482;292434098
9151;bc1qtfuwsqh8jtx5hn5chqqnu3d9emuycuqlwl45nf;51352;1;51352;0
9152;bc1qgxqqwd2mm3m0r2e7q5ze8ae6z7rtkxx0p3cfmr;6000000;1;6000000;0
9153;bc1pvwrrx3cdj0ln22ufwx2hzkvlvpfc8nxdtu2t2pjddd8p8ky2cupslafjwf;2918003;4;3593003;675000
9154;bc1q06r8878cghjnvzvd52fhrtfas3gvrtvcn86clj;142743;1;142743;0
9155;bc1p06eytcu5f27d9q6cpkezvwkcj0kv247nfrp920v2zzx4gs40tdfqel2zwk;723218;12;2089498;1366280
9156;32qWoxLUNiSpzVVwkiwDBmvqsj2MgSi7tJ;570120;10;3472983;2902863
9157;bc1pxpcjtflxmg4ffjdp9m9dpalqj6awg9r5s67dk0d33y696sneuufqeyj5mq;1641352;6;6016392;4375040
9158;bc1pe56v4ea2aaj7hsyvgs0cjyz2hjcpr7nywcwwxkjlr990jh84gekqyee7m0;853290;42;1776231;922941
9159;bc1qjr2adjd0unt9v6e6w5f59q7vzsyq4urmv92kdp;5633;1;5633;0
9160;bc1ph0a9xtam8we3p76lskxgndh283rgmspcsed9s7n62ltnztz7lvsq8gvvmk;303987;46;25073536;24769549
9161;12mQQefFXRG2kQ71CTEEhja2xQ6DKujTpi;286295;38;11373518;11087223
9162;3GicBq6p5ZjM6k37Dm6GbAsvyUYar5Cviz;63464;1;63464;0
9163;bc1q0hwjqtv7u0nzye2xplqu4s09rym5cvef342rrf;233945;13;1912355;1678410
9164;bc1pv6qrn7aq27xwfyqfmq7ga47z7njahse4y6jpv5jcxjxvtlr90zqseu8ytg;2184;6;771345;769161
9165;bc1pmtdggt3xsraucfjq79gvf3hn36rayyumgpj0ksauucc26f7pan7sum8f30;3585491;19;18057919;14472428
9166;1EjPe9PdvGWm7dTUvpunA3dwnwUUDmHbeK;4556604;23;7249541;2692937
9167;bc1pt8rhn6dm6amwjr3tlyzllvy4gtr7uzdenwxa2q3mz54m2pzpevzqkcm58c;113916671;8069;413863043;299946372
9168;bc1pt394hqc56ll7f3uz0qfatnwr7ve3j2vn4spgn6p0wa84un5gqnjsscl26j;546;1;546;0
9169;bc1qdyllk0mn95ca2j6msrl0tqxf5uxrx843dx67ce;19217389;501;655683247;636465858
9170;1Coffee1jV4gB5gaXfHgSHDz9xx9QSECVW;100000;39;46275835;46175835
9171;bc1pkz4987s0ydj0y4zauxc4fmknthkds9xwat3kdjsw3u2s83h2dc6snlr4uq;98188;1;98188;0
9172;bc1qr7l4xe5ysha9d9w48at9xe3vk8aayg2p9rmmmw;57841;1;57841;0
9173;38gYb29yd5WVRMueyG7crxVaiZhdTVN8oU;172257;1;172257;0
9174;38UBi1sake8p69NfU2QhDMP1X32n9jwoRE;1157210;8;9833311;8676101
9175;bc1prvrfjz2guud4zvwhd5a3mp8q0u6kddspp689sghkv8x2syc3xfrqteqcft;2730;5;2730;0
9176;bc1q9f806le8f9jdnz4du5a24l7ejj0pltvpq8yyhr;125636;1;125636;0
9177;bc1qn6h35mzwntq0yjeqt348pxgk2tdhpglj7gu0uf;0;2;279815;279815
9178;bc1pwcv3mjct8pw5mx0cdz5fmcvwqwx4du2x925hr2mmxspg8v5qp0nq3r3gj3;24524;1;24524;0
9179;bc1qldsyequ37uryq9hzwgmtvhznmup5w42czdvkdc;200000;1;200000;0
9180;3HeUZs6N1qHYjXm3PEsoGRiZ3t3CuwNJDb;170516;5;2242240;2071724
9181;bc1p2ngwvhp83xaytsn9cnfprgywvz395u7su8rpam52v8h6l2239cmqmxergn;0;2;41000;41000
9182;bc1q9y87nl84f5vjdp5ffehwheruktgthww3jyvpgw;66572;11;4117592;4051020
9183;bc1p68n8t8n6s8ju6jr4ggu4su9ry4aawlx9d22rk8f60ffavx0mnprsusa95j;1638;3;1638;0
9184;1BXJNvKp5MzqDaUoNACP8Tb1wzN9wXUNzJ;2698216;11;2698216;0
9185;bc1pk7sgpqr4fqknzmppurp89ud9dr7gd66g20x4uhzlahz4x89zq3esdx4006;977626;76;20658957;19681331
9186;bc1p6ffh964d9uzse7w67retktgg9ffh9jdl77waucy9pqxrgcjznlds5ql0eq;0;2;385000;385000
9187;bc1p88uzngmm8c32eq48s957ehg7p73tmusm4s0j60k6nx2cwcgn3ukqyffl0n;1000;15;327000;326000
9188;bc1pjekyzgm9krf63j0czypd4fkcsex2vy9y4a04luax5hr9p0zqcjyqyccq0p;2112370;44;33923302;31810932
9189;bc1pymr2nrtmpz2lkatyw5za75ulx3vpdnayugaxjx2nuz20ef7gfznssyje72;11777488;308;11777488;0
9190;187QVFD8pYZWjYKWFcxcvZcyrPwsfmvCdW;188579;70;24761262;24572683
9191;bc1pdeef3nfqkeez2n27w70nrkd2xezsxxj4lj3ddexxkwn65dq3hc9s953chv;726977;12;2105420;1378443
9192;3MBrBJTnAef3fUjKB5hcjpf5NdqujrsHLm;78306;3;275597;197291
9193;bc1p7a8jsazrp6a0kt6a79dz5shtz8jz04ks9g3z07ue7fkwhnu34q2sxvspnr;0;2;13575;13575
9194;1MUiDps2G8C2gYnKAT8UxSqJvuQ5igTsjC;100000;1;100000;0
9195;bc1qqjfw67khxd30nmngx476u8ev0jntq3ghgcemcw;235948;1;235948;0
9196;1Hrb3BG7Zr5M9ZkXcP8TKNMLYoeuqAT26i;47031;1;47031;0
9197;bc1pnzug2ufvdltvq464e2e0673faex42hkqa7fpnpuxw55tlqgauzusut057j;293806;56;10906759;10612953
9198;3KLVh9ufeE4PNVse6DdZLj3aLnj6nqPmGa;23482;1;23482;0
9199;bc1p08s7p25gk39ytlz0merw80j3zne4s7n0zeqwu04wcuhm6xwvpdpqsggw4a;24928;1;24928;0
9200;bc1qp5rx6g49ehc0xzjl8g4halw73xrrvr7c2vaepg;66590;4;107548;40958
9201;bc1qy7p6upcdtgrky383xmfcns68kyq4sjzxaex9z5;143626;1;143626;0
9202;bc1qql7dsdevk3wtkw25402pl54pd9lsghdtdpxz7x;203767348;153;1598225534;1394458186
9203;32GQBWZ7NRmuNigLrmjWjKMvyPKG66JVoF;3400000;31;40010582;36610582
9204;362cL1oppHJpW3E9zjg8svhxoUccdrK9ri;99171;1;99171;0
9205;bc1q66dn3y49wezzgrr6vqju6gg567vugq6e2al3w7;661382;3;1536382;875000
9206;3PHy7nYA8CiPhYnwSbFkzkEvefiUeTHkxH;1435774;4;4514498;3078724
9207;bc1pwrx739gm5he5nvlv0nvvdyndj5chnpp9nku4w8fuztq0su73s2lsdd9ujj;3276;6;3276;0
9208;bc1pcqms2fr4ytkjda0svyrn56h0glpzq64mflerae9ku38rjluxusxqa954sh;9833904;311;9833904;0
9209;bc1q3r0drsvlpcn78su8y6aklth3lq6est4488kctn;309016;207;401985509;401676493
9210;bc1qy06d6f8k9a7ksrawr52hfuy6wx363xaumsyz8w;156894;1;156894;0
9211;bc1pktndndgx740ep4ekp7aggk6unrha239hhm5aazqn23aw9h35zd7swz2dnv;2304356;1060;134308939;132004583
9212;bc1qfdek6v038p37n8c7drncjchutjpsjwqm32lqjlce04dq2skvmkrskghwtg;167094;1;167094;0
9213;bc1qfwd2ketlgekcn3tq4t6lctfx9ld2j6udjnnhfh;70557;1;70557;0
9214;bc1pn7n0zaq7g9ley9aujgqzf0s5l9fgck7lxt8p3znx3xhvfxkg8p4syk4nk7;3399;75;102699;99300
9215;bc1qah9qsvuky2l79nr3hxcc2umkzv8usg3fxcuu3l;65284321;1;65284321;0
9216;377KGQFiLctLh1egGU8szmoJhT7jZNrHu9;31280;11;2269653;2238373
9217;329dmRYYUyPD6JzXLp5d5Uk16UfXTDu3LV;615636;59;51660878;51045242
9218;3GzpoLY9UsniG9Nb18Ftk6MfKadd1cK2U3;349168;4;6881372;6532204
9219;bc1pm0mgjg87ykycntasncpx78w4gevd0hd8ykpz539kylm9waasuwaq67pn24;55874;66;609437;553563
9220;bc1psws52683rdpa38su4nrkec6t4smgczdcz0kqm2g524mtkkeucflsufsyvr;974477;2;1474477;500000
9221;bc1q8flte67wuckufh85hpxwcep6k7mgursm9kqm2t;307765;4;2092505;1784740
9222;1MzKrrvyiohjYHV7aCn3BAFUqmpmM136oR;260416;15;4989296;4728880
9223;bc1pugdxg3j27dsaezv5w5wunk0r5x2vxrxw9sgauugr7ylghtdpr8squm5anl;726935;12;2155510;1428575
9224;bc1qzxvtjp5s99a5a2jd4z3u9y8hg07y9lpd723xvy;43798;1;43798;0
9225;bc1qap68qgltz7s3pessj0fyncsk5j5kwldcrlxz8h;18949;3;594524;575575
9226;bc1p6wa9ef6jmwx2mppdu87ldrp9xv63e6q9k2y6v82265hyl6sdfs0qzlrktd;10170992;288;10170992;0
9227;bc1pd3c6c6purcyztxetfcuws8t7qnvnn2csqzyv64ydtrcue9asjg0qxk77gp;13107928;315;13107928;0
9228;bc1phwv2dx28medh7lrcgukkm8r55r00mrgc22uj2eshyrs72nexq9cqzxp4y7;11922264;313;11922264;0
9229;bc1pdjlxt7v4572fqkrlzdsx986l6zjtvl9s7ymazc4cv3rpxgqz3wlqhc76uz;115274274;7901;412262768;296988494
9230;1NCBvuxHDb71myaECCDsHMirGS6emhopwT;6652774;46;6652774;0
9231;39YdL2cvC2mChn7mBt3pWGwtJkfk5UojJW;3381225;23;3381225;0
9232;bc1qnt0vjzgfuulpm4z924s2zpgwwldm0ze92dk0qw;2353476;23;23532618;21179142
9233;bc1py3u4pk4wdc59cnk64fa5ewpam2gnmm7pvu8n7ma6y8rurc9gp87qg73ykw;5241749;207;22776724;17534975
9234;bc1qt9tvhkn5chllrs7yc0freqfdepxvfjfdr944v8;5870606;1;5870606;0
9235;16di3yAgXAKPsTgi2y4vGGw4XaaPuXUCFc;2618313;27;3346796;728483
9236;bc1pquz62anahzfwnqf9wagynvdp8hv7ehy2agxlgy72h0hxs058zqfqk8ksyq;25172627;105683;328886005;303713378
9237;bc1qgfgmr3mkupgsucysxgypm60dzf56tktyw4hgj3;219397;1;219397;0
9238;bc1prdfkuqhm9uc4hz9nctelka4rwjch2gk7ykqzr43f2wmlstuw3sjskquwvs;1000;1;1000;0
9239;bc1q6yrdyxgjqw4ca455jjz57tm6yjpxe7hle5w35l;972902;1;972902;0
9240;bc1qguzk63exy7h5uygg8m2tcenca094a8t464jfyvrmr0s6wkt74wls3zr5m3;285145689;898;454459689;169314000
9241;bc1p8rwcejx6djedrgvulct4eq32txlwv7fcmejzwy0kkualqtl53lus8q03pe;227092;1;227092;0
9242;3AVc3KCqE9gb7P6azcYtRtDiX7RqbbW44e;1358610;110;50506349;49147739
9243;bc1p9srxdqx7u4u48ahj4s5gd3x5m932zm4fc4a4ds5ncm580nh864jqm37k26;117435384;7882;409869482;292434098
9244;bc1q30ulp9kwvatuzrlukjezzvr4nks67lv720wjg8;3049756;54;24746992;21697236
9245;bc1qvswl527s3vq8dvc46y2wg3lyalm7tr5adpcffa;1000;1;1000;0
9246;bc1p07snax7s6tack5ug2kq9vc2k62q8jnfwnfpk8s9wyd2v5d4ltwaqeh9ekj;14345793;626;287968658;273622865
9247;bc1pyyms2ssr0hagy5j50r5n689e6ye0626v3c98j5fw0jk6tz3vrgts7nt56g;20232718;9661;3048468104;3028235386
